Sno,ID,Candidate,Constituency,Party,Criminal Case,Education,Total Assets,Liabilities,Net Assets
1,148,Kaushal Yadav,NAWADA,JD(U),8,Post Graduate,154566136,2604969,151961167
2,6912,(Kuppal)G.Devadoss,CHENNAI SOUTH,IND,0,8th Pass,3630000,850000,2780000
3,1906,A Biju,ALATHUR,IND,0,8th Pass,564425,175000,389425
4,8,A N Radhakrishnan,ERNAKULAM,BJP,0,Graduate,7813475,0,7813475
5,4337,A Nelson,SIVAGANGA,IND,0,12th Pass,37322,0,37322
6,901,A Pandian,ANDAMAN & NICOBAR ISLANDS,AIFB,0,12th Pass,859410,350000,509410
7,1105,A Prasad,KOLAR,IND,0,10th Pass,840000,0,840000
8,340,A Sampath,ATTINGAL,CPI(M),1,Doctorate,17791149,1421392,16369757
9,7501,A Thavamani,MADURAI,BSP,0,Illiterate,51000,0,51000
10,173,A Vijayaraghavan,KOZHIKODE,CPI(M),0,Graduate Professional,5757792,152305,5605487
11,397,A. Devadas,BELLARY,SUCI(C),0,10th Pass,1154658,0,1154658
12,6929,A. Irudayadass,CHENNAI SOUTH,IND,0,Graduate,551640,0,551640
13,6913,A. Jaiganesh,CHENNAI SOUTH,Lok Satta Party,0,Graduate,5855905,0,5855905
14,336,A. Josekutty,KOLLAM,IND,0,10th Pass,545117,224328,320789
15,6943,A. Magesh,CHENNAI SOUTH,IND,0,Graduate,6894841,66500,6828341
16,1850,A. P. Shamseer,VADAKARA,IND,0,Literate,55620,0,55620
17,117,A. Raghunath Varma,BERHAMPUR,IND,0,Post Graduate,270800,0,270800
18,4341,A. Shadhick Batcha,TIRUCHIRAPPALLI,IND,0,Post Graduate,752760,700000,52760
19,3955,A.Arunmozhithevan,CUDDALORE,AIADMK,9,Graduate Professional,15765250,0,15765250
20,4048,A.Baskar,CUDDALORE,IND,0,10th Pass,1100000,0,1100000
21,6284,A.Ganesan,ARANI,BSP,0,8th Pass,2110000,0,2110000
22,6356,A.Govindasamy,KALLAKURICHI,IND,0,8th Pass,1891000,300000,1591000
23,5202,A.Hamid Sh. Habib,DHULE,IND,3,8th Pass,63500,0,63500
24,993,A.K. Aggarwal,NORTH EAST DELHI,Agar Jan Party,1,10th Pass,14058166,0,14058166
25,5381,A.K. Mohan,DURG,AITC,0,10th Pass,290000,0,290000
26,6292,A.K.Moorthy,ARANI,Pattali Makkal Katchi,0,Post Graduate,55271210,17008423,38262787
27,2206,A.K.Parashurama Kotemallur,DAVANAGERE,BSP,0,12th Pass,215000,0,215000
28,6357,A.K.Perumal,KALLAKURICHI,JMM,0,Post Graduate,5302255,0,5302255
29,700,A.K.Salahudeen,KOLLAM,SDPI,1,12th Pass,6562365,0,6562365
30,4041,A.K.Sheikdavood,TIRUPPUR,IND,0,Graduate,0,0,0
31,7496,A.Kannan,MADURAI,IND,0,8th Pass,262590,0,262590
32,183,A.Krishnappa,TUMKUR,JD(S),0,Graduate,701833242,175031509,526801733
33,5583,A.M.H. Nazeem,PONDICHERRY,DMK,3,12th Pass,5930000,60000,5870000
34,1847,A.M.Smitha,VADAKARA,CPI(ML) Red star,0,Graduate,22000,0,22000
35,6300,A.Mahadevan,ARANI,IND,0,12th Pass,577000,0,577000
36,7434,A.Mogheeth Khan,TIRUPPUR,IND,0,Graduate,3253500,1475000,1778500
37,2612,A.P. Ahamad,HASSAN,BSP,0,Illiterate,1100000,500000,600000
38,7432,A.Ponnusamy,TIRUPPUR,IND,0,Literate,1581000,0,1581000
39,1222,A.R. Krishna Murthy,CHAMARAJANAGAR,BJP,0,Post Graduate,41281286,2886427,38394859
40,5470,A.Ramesh,VILUPPURAM,IND,0,10th Pass,350000,0,350000
41,2571,A.S.Dsilva,TUMKUR,AAP,0,Graduate,33229897,0,33229897
42,6358,A.Shajahan,KALLAKURICHI,IND,0,Graduate Professional,4402000,325000,4077000
43,1081,A.T. Dadakhalandar,DAVANAGERE,IND,0,10th Pass,36042,19623,16419
44,1951,A.V.Thamarakshan,ALAPPUZHA,Revolutionary Socialist Party of Kerala (B),1,Post Graduate,10641399,0,10641399
45,7503,"Aaron Rashid, J.M.",THENI,INC,0,12th Pass,649632943,8318576,641314367
46,2818,Aasutosh Verma,GIRIDIH,AITC,0,Graduate Professional,384828136,46546450,338281686
47,5949,Abbas Hussain Shaikh,MUMBAI SOUTH CENTRAL,SP,3,10th Pass,7967355,258960,7708395
48,250,Abbas Mothalappara,KASARAGOD,AITC,0,10th Pass,102000,0,102000
49,4693,Abdul Ahad Mir,ANANTNAG,IND,0,12th Pass,17950000,0,17950000
50,983,Abdul Amir Amiro,CHANDNI CHOWK,IND,0,5th Pass,4122551,0,4122551
51,2630,Abdul Azeem,BANGALORE NORTH,JD(S),0,Post Graduate,158909760,0,158909760
52,3451,Abdul Aziz,NAGAUR,BSP,0,Graduate,2400000,0,2400000
53,2386,Abdul Aziz Bhartiya,JAIPUR,Rashtriya Ulama Council,0,Graduate,67000,0,67000
54,5929,Abdul Basit Ibrahim Faith,MUMBAI SOUTH,IND,0,Graduate,888656,0,888656
55,212,Abdul Hafeez Abdul Aziz,BULDHANA,BSP,0,12th Pass,425000,225000,200000
56,360,Abdul Hameed,BIDAR,Welfare Party of India,0,Post Graduate,15287118,0,15287118
57,258,Abdul Jabbar K K,KANNUR,SDPI,4,10th Pass,3403545,0,3403545
58,171,Abdul Jaleel,WAYANAD,SDPI,0,Graduate,8813205,0,8813205
59,1923,Abdul Kareem,CHALAKUDY,IND,0,10th Pass,2746000,0,2746000
60,4847,Abdul Khaleque,MALDAHA UTTAR,AIUDF,0,Graduate,4367584,980000,3387584
61,460,Abdul Latif,GURGAON,IND,0,5th Pass,50000,0,50000
62,5916,Abdul Latif Abdul Kadir Shaikh,MUMBAI SOUTH,IND,3,8th Pass,3393500,0,3393500
63,880,Abdul Majid Chouhan,JAMMU,IND,0,10th Pass,2600000,0,2600000
64,2265,Abdul Mannan Barbhuiya,SILCHAR,AAP,0,Graduate,1042000,900000,142000
65,3827,Abdul Mannan Hossain,MURSHIDABAD,INC,1,Graduate,13846286,0,13846286
66,908,Abdul Muneer,LAKSHADWEEP,CPI(M),0,Post Graduate,1395365,0,1395365
67,3997,Abdul Rahim,HAZARIBAGH,Bahujan Mukti Party,0,Graduate,1800000,0,1800000
68,5236,Abdul Rahman,ARARIA,BSP,0,Literate,813848,0,813848
69,7403,"Abdul Rahman, B.",VELLORE,IND,0,10th Pass,1036500,0,1036500
70,7396,"Abdul Rahman, M.",VELLORE,IUML,0,Post Graduate,46864136,9836275,37027861
71,7402,"Abdul Rahman, N.",VELLORE,IND,0,10th Pass,530000,0,530000
72,7120,"Abdul Rahman, R.",PERAMBALUR,IND,0,10th Pass,8165500,340000,7825500
73,4141,Abdul Safiq Khan,RAIPUR,IND,0,10th Pass,582300,0,582300
74,1212,Abdul Salam N U,KASARAGOD,SDPI,1,Post Graduate,3620329,1182188,2438141
75,6973,"Abdul Salam, A.",COIMBATORE,IND,0,5th Pass,1768600,700000,1068600
76,990,Abdul Sami Salmani,NORTH EAST DELHI,BSP,0,Others,4331561,160000,4171561
77,3921,Abdul Tahir (Bablu - Advocate),BHOPAL,IND,0,Graduate Professional,2573572,1600,2571972
78,1540,Abdul Wafati Ansari Urf Yuvraj Tailors,REWA,Samata Party,0,10th Pass,1131000,1200000,-69000
79,4290,Abdul Wahid I,SALEM,IND,0,Post Graduate,1800,0,1800
80,4110,Abdur Rahaman,KATIHAR,Bharatiya Momin Front,0,12th Pass,627100,35000,592100
81,1883,Abdurahiman Vadakkathinakath,PONNANI,IND,0,8th Pass,5488050,0,5488050
82,1885,Abdurahiman Varikottil,PONNANI,IND,0,Literate,13110077,0,13110077
83,1884,Abdurahiman Vayarakath,PONNANI,IND,0,Literate,3037410,375000,2662410
84,4355,Abdus Sadek Sarkar,BALURGHAT,AIUDF,2,Graduate Professional,10907085,3064329,7842756
85,3823,Abdus Sayeed,JANGIPUR,SUCI(C),0,12th Pass,1204412,0,1204412
86,2800,Abha Pandey,MAHASAMUND,Chhattisgarh Swabhiman Manch,0,8th Pass,5708000,150000,5558000
87,5628,Abhay Subrao Kulkarni,THANE,IND,0,8th Pass,2000,0,2000
88,3362,Abhijit Anil Apte,MAVAL,IND,0,12th Pass,462306,0,462306
89,4831,Abhijit Mukherjee,JANGIPUR,INC,0,Graduate Professional,63014502,15160000,47854502
90,5629,Abhijit Ramesh Panse,THANE,MNS,1,Graduate,6995050,5800000,1195050
91,4834,Abhijit Sarkar,JANGIPUR,IND,0,5th Pass,92600,0,92600
92,3643,Abhijit Shriram Hegshetye,RATNAGIRI SINDHUDURG,AAP,0,Post Graduate,20692366,4273594,16418772
93,3,Abhimod,PALAKKAD,IND,0,Post Graduate,2908779,370000,2538779
94,2316,Abhinesh Maharshi,CHURU,BSP,0,Post Graduate,38238575,4130000,34108575
95,107,Abhishek Singh,RAJNANDGAON,BJP,0,Graduate Professional,44093207,0,44093207
96,253,Aboobacker Siddique,KASARAGOD,IND,0,8th Pass,38000,0,38000
97,1896,Aboobakker Sidique,PALAKKAD,AITC,0,Illiterate,47004,0,47004
98,1855,Abraham Benhur,WAYANAD,IND,0,Post Graduate,9999242,1421961,8577281
99,1507,Abrar Ahmad Mahmud Khan,YAVATMAL-WASHIM,Welfare Party of India,0,Others,6299991,700000,5599991
100,5836,Abrar Beg Sarvar Beg Mirza,JALGAON,Republican Party of India,0,8th Pass,85000,0,85000
101,7218,Abu Farhan Azmi,MUMBAI NORTH CENTRAL,SP,0,12th Pass,637688791,15872212,621816579
102,4363,Abu Hasem Kahn Chowdhury,MALDAHA DAKSHIN,INC,0,Doctorate,11560825,654320,10906505
103,5046,Abu Naseem Khan,MAINPURI,Peace Party,0,12th Pass,5225000,160000,5065000
104,4475,Abu Qaiser,BHAGALPUR,JD(U),1,Graduate,45138014,1700000,43438014
105,4427,Abul Awal,BARPETA,SP,0,12th Pass,1224844,379980,844864
106,4015,Abul Hasan,RANCHI,IND,0,Post Graduate,165500,0,165500
107,4360,Abul Hasnat Khan,MALDAHA DAKSHIN,CPI(M),0,Post Graduate,10785663,0,10785663
108,277,Abullais.T.P,PONNANI,IND,0,12th Pass,6692346,0,6692346
109,3194,Acharya Pramod Krishnam,SAMBHAL,INC,0,Post Graduate,49900443,0,49900443
110,1151,Achutananda Nag,BOLANGIR,Ambedkarite Party of India,0,Graduate Professional,208500,0,208500
111,5190,Ad. Dr. Kolekar Anita Balasaheb,BHIWANDI,Prabuddha Republican Party,0,Doctorate,450000,0,450000
112,7622,Ad. Mahesh Vitthalrao Kharat,JALNA,IND,0,Post Graduate,123000,0,123000
113,5957,Ad. Tanaji Sukdeo Jaibhave,NASHIK,CPI(M),0,Graduate Professional,7279479,2369620,4909859
114,616,Adagooru H Vishwanath,MYSORE,INC,0,Graduate Professional,30187177,0,30187177
115,3391,Adhalrao Shivaji Dattatrey,SHIRUR,SHS,10,Post Graduate,253598315,61810866,191787449
116,1015,Aditya Narayan,NAWADA,IND,0,Graduate,15770000,0,15770000
117,5931,Aditya Rajan Shirodkar,MUMBAI SOUTH CENTRAL,MNS,6,Graduate,22850061,5811022,17039039
118,315,Adsul Anandrao Vithoba,AMRAVATI,SHS,1,Graduate,32596257,1587104,31009153
119,3649,Adv Dipak Dattaram Nevgi,RATNAGIRI SINDHUDURG,Socialist Party (India),0,Post Graduate,13431575,92000,13339575
120,1909,Adv. A. Jayaram,THRISSUR,BSP,0,Graduate Professional,24702613,628000,24074613
121,3328,Adv. Ajay Sitaram Karande Patil,PARBHANI,SP,0,Post Graduate,9510000,330000,9180000
122,780,Adv. Bandya Sane Alias Bandu Sampatrao Sane,AMRAVATI,IND,0,Post Graduate,31300,0,31300
123,1213,Adv. Basheer Alady,KASARAGOD,BSP,0,Post Graduate,785138,0,785138
124,1976,Adv. Chirayinkeezhu Gopinathan,ATTINGAL,RPI(A),0,Graduate Professional,920662,100000,820662
125,3310,Adv. Deelip Kulkarni,NANDED,IND,0,Graduate Professional,2990000,50000,2940000
126,3022,Adv. Jawahar Leonardo Dias,SOUTH GOA,Goemcarancho Otrec Astro,1,Post Graduate,564223740,484000,563739740
127,3658,Adv. K. D. Shinde,SANGLI,JD(S),0,Post Graduate,4387851,600000,3787851
128,1975,Adv. M. R. Sarin,ATTINGAL,JD(U),0,Graduate Professional,790325,87000,703325
129,3404,Adv. Mahendra Dadasaheb Shinde,SHIRDI,BSP,0,Doctorate,52137,90000,-37863
130,286,Adv. N.Sreeprakash,MALAPPURAM,BJP,0,Graduate Professional,6781097,317500,6463597
131,1989,Adv. Narendra Keshav Sawaikar,SOUTH GOA,BJP,0,Graduate Professional,6260382,0,6260382
132,1858,Adv. P. P. A. Sageer,WAYANAD,AAP,0,Graduate Professional,4539401,57788,4481613
133,2487,Adv. Peelipose Thomas,PATHANAMTHITTA,IND,1,Graduate Professional,5648161,928336,4719825
134,2508,Adv. Perurkada Harikumar,THIRUVANANTHAPURAM,SHS,4,Graduate Professional,2511500,0,2511500
135,931,Adv. Prabhakar Mahaguji Dadmal,GADCHIROLI-CHIMUR,RPI,0,Post Graduate,560000,0,560000
136,1986,Adv. Raju Mangeshkar,SOUTH GOA,CPI,1,Graduate Professional,4904426,0,4904426
137,1381,Adv. Ravindra Dnyandeo Bhojane,BULDHANA,Aambedakarite Party of India,0,Graduate Professional,119757,0,119757
138,3694,Adv. Sanjeev Sidram Sadafule,SOLAPUR,BSP,0,Graduate Professional,2397559,625000,1772559
139,3568,Adv. Savita Balkrishna Shinde,MADHA,AAP,0,Graduate Professional,2737166,0,2737166
140,3593,Adv. Shailendra Rameshwar Yavalkar,OSMANABAD,SP,0,Graduate Professional,22243300,1125000,21118300
141,3664,Adv. Varsha Madgulkar,SATARA,IND,0,Graduate Professional,13052635,8706000,4346635
142,169,Adv.A.N.Shamseer,VADAKARA,CPI(M),0,Graduate Professional,1330825,0,1330825
143,694,Adv.Bindhu Krishna,ATTINGAL,INC,2,Post Graduate,3764729,853967,2910762
144,1464,Adv.Dadasaheb Alias Dhanu Bhikaji Walthare,BHANDARA-GONDIYA,IND,0,Graduate Professional,5395083,0,5395083
145,706,Adv.Dean Kuriakose,IDUKKI,INC,1,Not Given,314050,411719,-97669
146,712,Adv.Joice George,IDUKKI,IND,4,Graduate Professional,17396207,9417720,7978487
147,323,Adv.M.A.Bindu,ALAPPUZHA,SUCI(C),0,Graduate Professional,3543000,0,3543000
148,703,Adv.P.K.Jayakrishnan,MAVELIKKARA,BSP,0,Post Graduate,15410000,400000,15010000
149,959,Adv.P.Sudheer,MAVELIKKARA,BJP,8,Graduate Professional,329804,0,329804
150,699,Adv.S.Prahladan,KOLLAM,BSP,0,Graduate Professional,21645000,0,21645000
151,5843,Adv.Shinde Ashok Dagdu,JALGAON,Prabuddha Republican Party,0,Post Graduate,50000,0,50000
152,2578,Adv.Shivajirao Shivaramji Moghe,YAVATMAL-WASHIM,INC,2,Graduate Professional,42689718,11315807,31373911
153,7256,Adv.Sobji Devalya Gavit,NANDURBAR,IND,0,Graduate Professional,10100000,80000,10020000
154,3569,Adv.Subhash Balasaheb Patil (Anna),MADHA,Bahujan Mukti Party,1,Post Graduate,8581681,1502262,7079419
155,3873,Aghav Jayprakash Sitaram,BEED,IND,3,10th Pass,151000,0,151000
156,7078,Agoram. K,MAYILADUTHURAI,Pattali Makkal Katchi,8,Graduate,6097180,3045000,3052180
157,5867,Agrawal Kunjbihari Jugalkishor,JALNA,SP,4,Graduate,50158221,272883,49885338
158,5147,Ahamad Aziz Ahamad Mateen,AURANGABAD,IND,0,8th Pass,240000,0,240000
159,2093,Aherwan Dharmender Rawat,FARIDABAD,IND,0,12th Pass,6109500,335000,5774500
160,926,Ahir Hansraj Gangaram,CHANDRAPUR,BJP,11,10th Pass,15548000,99500,15448500
161,4714,Ahmad Hussain Ansari,DHANBAD,Jharkhand Disom Party,0,Graduate Professional,11286622,0,11286622
162,1508,Ahmad Parvez Iqbal Ahmad Nur Mohammad,YAVATMAL-WASHIM,SP,1,Graduate,3957500,0,3957500
163,2081,Ahshan Ali,GURGAON,IND,0,Graduate,2090000,0,2090000
164,5939,Aiyyar Ganesh Rangayya,MUMBAI SOUTH CENTRAL,BSP,0,Graduate Professional,34200185,2650000,31550185
165,4434,Ajad Ali,GAUHATI,IND,0,Others,1271997,536237,735760
166,150,Ajad Geeta Prasad Sharma,NAWADA,IND,0,12th Pass,7080000,0,7080000
167,2531,Ajaj Julmoin Khan (Ajaj Khan),NAGPUR,IND,1,12th Pass,137000,0,137000
168,729,Ajay Arjun Singh,SATNA,INC,2,Post Graduate,254876883,13845072,241031811
169,2320,Ajay Kumar,CHURU,IND,0,Post Graduate,4926438,0,4926438
170,3107,Ajay Kumar,KHERI,BJP,2,Graduate Professional,26505977,10000000,16505977
171,2847,Ajay Kumar,JAMSHEDPUR,JVM(P),7,Graduate Professional,124349901,6979341,117370560
172,3312,Ajay Kumar Behera,JAGATSINGHPUR,CPI,0,Post Graduate,5137088,0,5137088
173,4695,Ajay Kumar Dubey,DHANBAD,INC,0,12th Pass,7484762,0,7484762
174,969,Ajay Kumar Khemka,CHANDNI CHOWK,Kalyankari Jantantrik Party,0,Graduate,4724526,625000,4099526
175,1109,Ajay Kumar Panjabrao Hingankar,AKOLA,AAP,0,Graduate,8035000,700000,7335000
176,2361,Ajay Kumar Sharma,JAIPUR RURAL,Jago Party,0,Graduate,4550119,0,4550119
177,495,Ajay Maken,NEW DELHI,INC,1,Post Graduate,61098675,500000,60598675
178,4281,Ajay Pal Singh,ETAWAH,BSP,1,Post Graduate,150110000,0,150110000
179,5367,Ajay Pali,BILASPUR,IND,0,Literate,480000,179344,300656
180,1528,Ajay Pratap Singh,SATNA,IND,0,12th Pass,900000,0,900000
181,5224,Ajay Rawat,DHAR,BSP,0,12th Pass,64000,0,64000
182,6082,Ajay Shah Makrai,BETUL,INC,0,Post Graduate,47558071,1246200,46311871
183,591,Ajay Singla,CHANDIGARH,IND,2,10th Pass,9877806,0,9877806
184,3623,Ajay Vasant Paithankar,PUNE,IND,0,Graduate,14080500,237000,13843500
185,4135,Ajay Verma,RAIPUR,Chhattisgarh Swabhiman Manch,0,Others,38835962,0,38835962
186,1831,Ajaykumar Sarnaik,BAGALKOT,INC,0,Graduate,501321313,100587230,400734083
187,2344,Ajaypal,SIKAR,IND,0,10th Pass,3295920,100000,3195920
188,1650,Ajaypal,BAGHPAT,IND,0,8th Pass,5790000,0,5790000
189,3646,Ajinkya Dhondu Gawade,RATNAGIRI SINDHUDURG,IND,0,Graduate,2058757,243784,1814973
190,5829,Ajit Bhika Pawar,DINDORI,IND,0,Graduate,95500,0,95500
191,637,Ajit Joy,THIRUVANANTHAPURAM,AAP,0,Post Graduate,37145768,3500000,33645768
192,4185,Ajit Kumar Jain (Patwa) Dharti Pakad,INDORE,IND,0,8th Pass,0,0,0
193,3996,Ajit Kumar Singh,HAZARIBAGH,AITC,0,12th Pass,6000000,912823,5087177
194,3079,Ajit Pal Singh,BADAUN,Peace Party,0,Graduate,8900000,0,8900000
195,2797,Ajit Pramod Kumar Jogi,MAHASAMUND,INC,1,Graduate Professional,61583410,1500000,60083410
196,671,Ajit Singh,BAGHPAT,RLD,0,Post Graduate,169254660,0,169254660
197,1964,Ajith Kumar K K,PATHANAMTHITTA,IND,1,Graduate,663000,342000,321000
198,2411,Ajmat Ali,KOTA,Bharatiya Yuva Shakti,0,8th Pass,193438,0,193438
199,2493,Akar Dhoj Limbu,SIKKIM,INC,0,Graduate Professional,5504900,0,5504900
200,4084,Akash Gupta,MORENA,IND,0,Graduate,505042,0,505042
201,3181,Akbar Husain,RAMPUR,BSP,0,10th Pass,62120983,3790727,58330256
202,2077,Akbar Kasmi,GURGAON,Rashtriya Ulama Council,0,Others,1592000,0,1592000
203,3182,Akbar Masood,RAMPUR,IND,0,Post Graduate,2513782,0,2513782
204,1012,Akhei Achumi,NAGALAND,Socialist Party (India),0,Graduate,3122000,0,3122000
205,5240,Akhil Bhartiya Sharma,BANKA,IND,0,Graduate Professional,50000,0,50000
206,2954,Akhilesh,GWALIOR,CPI(M),1,Graduate,184700,0,184700
207,4112,Akhtarul Iman,KISHANGANJ,JD(U),1,Post Graduate,4907533,820788,4086745
208,4696,Aklu Ram Mahto,DHANBAD,SP,0,Post Graduate,1747750,0,1747750
209,3064,Akmal Khan Urf Chaman,BADAUN,BSP,0,Literate,14679858,1510000,13169858
210,4389,Akshay Yadav,FIROZABAD,SP,0,Graduate,100883304,59377,100823927
211,4339,Al Sivagnanam,SIVAGANGA,IND,0,5th Pass,69480,0,69480
212,6310,Alagiri.S,CUDDALORE,INC,0,Graduate,17918014,51740512,-33822498
213,7574,Alagumalai.V.,TENKASI,IND,0,12th Pass,470000,0,470000
214,7507,"Alagusundaram, K.",THENI,MDMK,1,Graduate Professional,3085000,254000,2831000
215,1901,Albin M U,ALATHUR,IND,0,12th Pass,900,0,900
216,1988,Aleixo Reginaldo Lourenco,SOUTH GOA,INC,0,12th Pass,31453008,905729,30547279
217,967,Aleyamma Varghese,PATHANAMTHITTA,AITC,0,10th Pass,22800000,4200000,18600000
218,5382,Alfraid Vikas Luis,DURG,IND,0,Graduate,136000,0,136000
219,1846,Ali Akbar,VADAKARA,AAP,0,12th Pass,4448946,2674831,1774115
220,995,Ali Husan,NORTH EAST DELHI,IND,0,5th Pass,1047500,0,1047500
221,4875,Ali Hussain,DHUBRI,IND,0,Graduate,114136,0,114136
222,832,Ali Kishor Patnaik,BERHAMPUR,CPI(M),1,Graduate,7450333,0,7450333
223,5241,Alimuddin Ansari,BANKA,IND,0,Others,352000,0,352000
224,4489,Alimuddin Ansari,KISHANGANJ,AAP,0,10th Pass,5210680,0,5210680
225,7163,Allapichai .E,RAMANATHAPURAM,IND,0,Graduate,13660000,0,13660000
226,4196,Alok Agarwal,KHANDWA,AAP,2,Graduate Professional,12871,0,12871
227,4417,Alok Nandan,MAINPURI,IND,0,Post Graduate,8647900,0,8647900
228,2907,Alok Sanjar,BHOPAL,BJP,0,Graduate Professional,14594066,300000,14294066
229,2950,Alok Sharma,GWALIOR,BSP,0,8th Pass,20454704,0,20454704
230,6974,"Alphonesraj, M.",COIMBATORE,IND,0,5th Pass,261500,0,261500
231,3661,Altaf Abdulgani Shikalgar,SATARA,Bahujan Mukti Party,0,8th Pass,5727145,227144,5500001
232,3302,Altaf Ahamad Iqbal Ahmad,NANDED,IUML,0,Graduate,4462742,571000,3891742
233,968,Altaf Husain,CHANDNI CHOWK,Bhartiya Janta Dal (Integrated),0,12th Pass,4790000,0,4790000
234,3594,Altaf Husain Yenegure,OSMANABAD,IND,0,Graduate,1690000,0,1690000
235,851,Alur M.G. Swamy,DAVANAGERE,IND,0,Graduate,36920000,150000,36770000
236,7562,Alwarsamy Karthikeyan.L,THOOTHUKKUDI,IND,0,Post Graduate,480000,0,480000
237,2793,Amal Say Sori,KANKER,IND,0,Graduate,362500,400000,-37500
238,4500,Aman Kumar Samajsevi,SUPAUL,BSP,0,12th Pass,5728000,0,5728000
239,4007,Amanullah,RANCHI,AAP,0,Post Graduate,2391132,126000,2265132
240,5088,Amar Chand Pohiya,BHARATPUR,Rajasthan Vikas Party,0,10th Pass,2076000,23000,2053000
241,4130,Amar Nath Pandey,KORBA,AAP,2,Graduate Professional,3656000,393000,3263000
242,4935,Amar Singh,AKBARPUR,Janvadi Party(Socialist),0,10th Pass,1701500,250000,1451500
243,4988,Amar Singh,FATEHPUR SIKRI,RLD,0,Graduate Professional,966849798,0,966849798
244,4931,Amar Singh,AGRA,IND,0,12th Pass,247000,0,247000
245,2288,Amar Singh,GANGANAGAR,Bahujan Mukti Party,0,10th Pass,1230000,586706,643294
246,4215,Amar Singh Patel,VIDISHA,BSP,0,12th Pass,311829,27310,284519
247,2343,Amara Ram,SIKAR,CPI(M),0,Post Graduate,4681929,774000,3907929
248,592,Amarjit Kaur,CHANDIGARH,IND,0,8th Pass,7020000,500000,6520000
249,1142,Amarnath Pradhan,SAMBALPUR,INC,0,Post Graduate,56069048,0,56069048
250,4494,Amarnath Tiwari,PURNIA,INC,1,Graduate,43329826,6731845,36597981
251,1011,Amarson Sankhil,OUTER MANIPUR,IND,0,Post Graduate,857093,0,857093
252,1210,Ambalathara Kunhikrishnan,KASARAGOD,AAP,0,10th Pass,245690,0,245690
253,214,Ambedkar Prakash Yashwant,AKOLA,Bharipa Bahujan Mahasangh,3,Graduate Professional,35716840,1400000,34316840
254,4315,Ambendkari Hasnooram Ambendkari,FATEHPUR SIKRI,IND,0,Literate,262200,120000,142200
255,3013,Ambesh Kumari,TIKAMGARH,SP,1,Doctorate,15710045,3255734,12454311
256,3734,Ambrose D,BANGALORE CENTRAL,IND,0,Post Graduate,575,0,575
257,7161,Amirthalingam .U,RAMANATHAPURAM,IND,0,8th Pass,1460000,370000,1090000
258,2970,Amit Bhatnagar,KHAJURAHO,AAP,0,Post Graduate,2136231,0,2136231
259,3137,Amit Kumar,MORADABAD,Bahujan Mukti Party,0,Post Graduate,446061,0,446061
260,1000,Amit Kumar Sharma,NORTH EAST DELHI,IND,0,Graduate,1710000,0,1710000
261,4016,Amit Kumar Singh,RANCHI,IND,0,12th Pass,1169044,9000,1160044
262,1798,Amita Singh Jaat,ALIGARH,Sarva Samaj Kalyan Party,0,Post Graduate,3865000,0,3865000
263,2873,Amitabh Choudhary,RANCHI,JVM(P),0,Graduate Professional,17931854,1095618,16836236
264,3261,Amiya Kanta Mallick,JAJPUR,BJP,0,10th Pass,10680000,5130000,5550000
265,5206,Amrishbhai Rasiklal Patel,DHULE,INC,21,8th Pass,504197656,142934079,361263577
266,4642,Amrit Tirkey,RAIGARH,IND,0,8th Pass,2711000,0,2711000
267,24,Anand Kumar,NORTH EAST DELHI,AAP,0,Doctorate,29255377,72369,29183008
268,5249,Anand Kumar Jain,BHAGALPUR,IND,0,Graduate Professional,6172660,0,6172660
269,4154,Anand Mahato,DHANBAD,Marxist Co-Ordination,1,Graduate,6155932,0,6155932
270,3981,Anand Mishra,BILASPUR,AAP,0,Post Graduate,4685783,1440000,3245783
271,5879,Anand Prakash Pranjape,KALYAN,NCP,4,Post Graduate,35920212,3379297,32540915
272,3763,Ananda G,CHAMARAJANAGAR,IND,0,Others,130000,0,130000
273,2602,Ananda Gatty,DAKSHINA KANNADA,IND,0,Graduate Professional,5328850,450000,4878850
274,794,Ananda Kumar Samal,SAMBALPUR,AAP,0,Post Graduate,169838,123121,46717
275,7231,Ananda Sakharam Bhalerao,MUMBAI NORTH EAST,IND,0,10th Pass,157386,0,157386
276,6954,"Anandan Alias Kavignar Ananthamaalai, S",CHIDAMBARAM,IND,0,12th Pass,275000,0,275000
277,2180,Anandaraj Dokka,DHARWAD,IND,0,8th Pass,220000,0,220000
278,7561,"Anandharaj, M.",THOOTHUKKUDI,IND,0,Others,40000,0,40000
279,6319,Anandharajan.S,CUDDALORE,IND,0,Post Graduate,64850,17652,47198
280,4030,Anandkumar.K,DHARMAPURI,IND,0,Not Given,1039000,0,1039000
281,2808,Anandram Sahu,RAJNANDGAON,BSP,0,8th Pass,6680680,300000,6380680
282,2924,Anant Lal Basor,DAMOH,IND,0,10th Pass,9014000,0,9014000
283,96,Anant Nayak,KEONJHAR,BJP,0,12th Pass,5241777,875448,4366329
284,189,Ananth Kumar,BANGALORE SOUTH,BJP,0,Graduate Professional,45224706,2883233,42341473
285,398,Anantkumar Hegde,UTTARA KANNADA,BJP,0,12th Pass,32367360,15139611,17227749
286,5436,Anbalagan D,TIRUVANNAMALAI,IND,0,Graduate Professional,436200,0,436200
287,7443,Anbalagan.M,TIRUCHIRAPPALLI,IND,0,10th Pass,1276450,190000,1086450
288,6878,Anbazhagan .G,CHENNAI NORTH,IND,0,Post Graduate,1070799,0,1070799
289,7124,"Anbil Thangamani, K.",PERAMBALUR,IND,0,Post Graduate,6300000,0,6300000
290,6995,Anbumani Ramadoss,DHARMAPURI,Pattali Makkal Katchi,8,Graduate Professional,314378451,41941065,272437386
291,6991,Anbumani.G,DHARMAPURI,IND,0,12th Pass,1301000,0,1301000
292,6975,Anbuselvan.,COIMBATORE,IND,0,Graduate Professional,5831644,2900000,2931644
293,4208,Aneeta Hindoliya,UJJAIN,AAP,0,Post Graduate,5760417,1564210,4196207
294,2849,Angad Mahato,JAMSHEDPUR,Amra Bangalee,1,10th Pass,4005014,0,4005014
295,6993,Anguraj.P,DHARMAPURI,IND,0,12th Pass,3257000,241000,3016000
296,4923,Anil,AGRA,Bharatiya Kisan Parivartan Party,0,Literate,305538,0,305538
297,2057,Anil,ROHTAK,Rashtriya Bahujan Hitay Party,0,10th Pass,1520000,0,1520000
298,1996,Anil,KURUKSHETRA,IND,0,5th Pass,18036000,0,18036000
299,1639,Anil,MEERUT,IND,0,12th Pass,1594367,104944,1489423
300,4882,Anil Bhagawati,GAUHATI,IND,2,Doctorate,4619004,229300,4389704
301,3490,Anil Jaysing Ghanvat,AHMEDNAGAR,IND,6,Graduate,33340000,163597,33176403
302,3898,Anil Khajuria,UDHAMPUR,IND,0,Graduate Professional,25000,0,25000
303,1928,Anil Kumar,ERNAKULAM,IND,0,8th Pass,72000,0,72000
304,2366,Anil Kumar,JAIPUR RURAL,AAP,0,10th Pass,2992554,201420,2791134
305,1619,Anil Kumar,MUZAFFARNAGAR,Bahujan Mukti Party,0,Graduate Professional,4662600,518000,4144600
306,2769,Anil Kumar,PATNA SAHIB,IND,0,Post Graduate,199542,0,199542
307,2042,Anil Kumar,SONIPAT,Rashtriya Bahujan Hitay Party,0,10th Pass,10875000,0,10875000
308,640,Anil Kumar,THIRUVANANTHAPURAM,IND,0,12th Pass,40000,0,40000
309,1651,Anil Kumar,BAGHPAT,Peace Party,4,12th Pass,55427000,7522794,47904206
310,5005,Anil Kumar,FATEHPUR SIKRI,IND,0,Graduate,1412100,0,1412100
311,2784,Anil Kumar Gupta,UDHAMPUR,IND,0,Graduate,51621298,1717547,49903751
312,5266,Anil Kumar Mahto,PURNIA,Janvadi Party(Socialist),0,10th Pass,681406,0,681406
313,695,Anil Kumar N S,ATTINGAL,BSP,1,12th Pass,433000,0,433000
314,1240,Anil Kumar Oraon,CHATRA,IND,0,10th Pass,3490000,25000,3465000
315,3073,Anil Kumar Sharma,BADAUN,Labour Party of India (V.V. Prasad),0,Graduate Professional,4900000,0,4900000
316,2370,Anil Kumar Sharma,JAIPUR,Jago Party,0,Graduate,75100,0,75100
317,2677,Anil Kumar Sharma,JAHANABAD,JD(U),1,Doctorate,8498803720,1095393904,7403409816
318,603,Anil M.R,SHIMOGA,IND,0,Others,774819,1252161,-477342
319,5884,Anil Motiram More,KALYAN,Bahujan Mukti Party,0,Graduate Professional,2828101,158609,2669492
320,4207,Anil Pale,UJJAIN,Bahujan Sangharshh Dal,0,Graduate Professional,507000,250000,257000
321,3373,Anil Shirole,PUNE,BJP,2,Graduate,227615279,4781007,222834272
322,4932,Anil Shukla Varsi,AKBARPUR,BSP,2,Graduate,32740272,11284827,21455445
323,4191,Anil Trivedi,INDORE,AAP,0,Post Graduate,14718234,0,14718234
324,4618,Anil Umre,RAIPUR,Ambedkarite Party of India,0,12th Pass,11000,0,11000
325,305,Anilkumar R,KOTTAYAM,AAP,0,Post Graduate,1686239,360000,1326239
326,3156,Anis Ahamad Khan,PILIBHIT,BSP,0,Graduate,32411744,0,32411744
327,1942,Anish Mariyil,IDUKKI,IND,0,12th Pass,8569000,0,8569000
328,4256,Anita,AGRA,Vanchitsamaj Insaaf Party,0,10th Pass,489000,0,489000
329,2893,Anita Hitendra Chaudhary,BHIND,SP,0,Graduate,15514000,10000,15504000
330,3416,Anita Jain,AJMER,IND,0,Graduate Professional,4700000,0,4700000
331,584,Anita Mondal,ANDAMAN & NICOBAR ISLANDS,AITC,1,Graduate,5471073,6000,5465073
332,1440,Anita Nagdigambar Tekam,NAGPUR,IND,0,8th Pass,10500,0,10500
333,719,Anitha Prathap,ERNAKULAM,AAP,0,Graduate Professional,203330000,0,203330000
334,1454,Anjali Anish Damania,NAGPUR,AAP,0,Graduate Professional,193161591,1399670,191761921
335,5105,Anjali Chaudhary,DAUSA,IND,0,Post Graduate,750000,0,750000
336,4512,Anjana Udai Lal,JALORE,INC,0,12th Pass,658610000,202559600,456050400
337,4014,Anjani Pandey,RANCHI,IND,0,Graduate Professional,25000,0,25000
338,4311,Anju,FARRUKHABAD,Bhartiya Shakti Chetna Party,0,Graduate Professional,989068,0,989068
339,4230,Anju Devi Dhanka,DAUSA,IND,0,Graduate,6022739,2800000,3222739
340,1729,Anju Urf Muskan,BULANDSHAHR,RLD,0,12th Pass,2995000,1656134,1338866
341,1340,Anjuman Agnihotri,NEW DELHI,IND,0,12th Pass,930631,169975,760656
342,1620,Ankur,MUZAFFARNAGAR,IND,0,12th Pass,7425346,0,7425346
343,5150,Ankush Munjaji Tupsamundre,AURANGABAD,IND,0,Literate,5110000,1942,5108058
344,1405,Ankush Vijayrao Nawale,WARDHA,SP,0,Graduate Professional,1551000,72000,1479000
345,5461,Annadurai A,TIRUVANNAMALAI,IND,0,Illiterate,200000,0,200000
346,5460,Annadurai B,TIRUVANNAMALAI,IND,0,Not Given,220000,0,220000
347,5449,Annadurai C N,TIRUVANNAMALAI,DMK,0,Graduate,116791971,48430837,68361134
348,7160,Annamalai .S,RAMANATHAPURAM,IND,0,Post Graduate,7080000,1300000,5780000
349,1924,Annamma Joy,CHALAKUDY,AITC,0,Graduate,6397000,2040000,4357000
350,4971,Anokhey,FARRUKHABAD,IND,0,12th Pass,10149863,0,10149863
351,2983,Anoop Mishra,MORENA,BJP,0,12th Pass,110523112,6878160,103644952
352,2988,Anoop Nagar,MORENA,IND,0,Literate,420000,0,420000
353,2862,Anosh Ekka,KHUNTI,Jharkhand Party,3,10th Pass,36766971,4224902,32542069
354,4429,Anowar Hussain,DHUBRI,AGP,0,Graduate,828710,0,828710
355,5186,Ansari Jahid Mukhtar,BHIWANDI,Bahujan Mukti Party,1,12th Pass,3844989,0,3844989
356,5183,Ansari Jalaluddin Moinuddin,BHIWANDI,AAP,0,Others,5896347,0,5896347
357,5184,Ansari Mumtaz Abdul Satar,BHIWANDI,BSP,0,8th Pass,255000,0,255000
358,5196,Ansari Nihal Ah Md Harun,DHULE,AAP,0,10th Pass,36566800,6000000,30566800
359,4974,Anshu Mahan,FARRUKHABAD,IND,0,Literate,1702500,0,1702500
360,4402,Anshul Verma,HARDOI,BJP,0,Post Graduate,30385000,0,30385000
361,3229,Anta Alok Baskey,MAYURBHANJ,AJSUP,0,Graduate,8604192,600000,8004192
362,7021,Anthony Muthu,KANNIYAKUMARI,CPI(ML)L,10,Post Graduate,8468000,0,8468000
363,964,Anto Antony,PATHANAMTHITTA,INC,0,Graduate,5410884,4211050,1199834
364,764,Anubha Munjare,BALAGHAT,SP,5,Post Graduate,36108915,2167687,33941228
365,757,Anuj Ganga Singh Patta,MANDLA,GGP,0,Graduate,4480097,2220000,2260097
366,4420,Anuj Kumar Garg,MATHURA,AAP,0,Post Graduate,71875216,7343000,64532216
367,514,Anup Phukon,DIBRUGARH,AGP,0,Post Graduate,4737100,3549764,1187336
368,2043,Anup Sing Dahiya,SONIPAT,Rashtriya Jatigat Aarakshan Virodhi Party,0,10th Pass,13153500,152500,13001000
369,3311,Anupama Sethy,JAGATSINGHPUR,AAP,0,Post Graduate,525564,10000,515564
370,4970,Anurag Rajput,FARRUKHABAD,IND,0,12th Pass,1585000,0,1585000
371,3294,Anwar,TUMKUR,IND,0,Graduate,2886450,0,2886450
372,7439,Anwar Deen.S,TIRUCHIRAPPALLI,Samata Party,1,Literate,427101,0,427101
373,2944,Anwar Khan,GUNA,IND,0,10th Pass,77000,0,77000
374,2973,Anwar Khan,KHAJURAHO,IND,0,10th Pass,901857,0,901857
375,1875,Anwar Shakeel Omar,MALAPPURAM,IND,0,Post Graduate,4809396,0,4809396
376,7152,Anwhar Raajhaa.A,RAMANATHAPURAM,AIADMK,0,Graduate,33582876,2700000,30882876
377,3278,Aparajita Mohanty,CUTTACK,INC,0,Graduate,27791663,7903022,19888641
378,1634,Aphajal,MEERUT,IND,1,8th Pass,425000,0,425000
379,1936,Appanchira Ponnappan,IDUKKI,BSP,0,10th Pass,7611000,0,7611000
380,1819,Appasaheb Kurane,CHIKKODI,Sarva Janata Party,0,12th Pass,348900,0,348900
381,3203,Aqeel Ahmad,SAMBHAL,IND,0,12th Pass,6180000,0,6180000
382,3190,Aqeel Ur Rehman Khan,SAMBHAL,BSP,0,Post Graduate,32724982,2506410,30218572
383,1219,Arakera Shivanagouda Nayak,RAICHUR,BJP,1,Graduate,45433720,7544250,37889470
384,7456,Arangarajan.M,THANJAVUR,BSP,0,12th Pass,10373421,3400000,6973421
385,7158,Arasakumar B.T.,RAMANATHAPURAM,Desiya Forward Bloc,4,Post Graduate,81788578,19687720,62100858
386,3808,Aravind Premanand,MANDYA,IND,0,Graduate Professional,662000,0,662000
387,7476,Arimazham Thiyagi Subramanian Muthuraja M,SIVAGANGA,IND,0,10th Pass,482295,0,482295
388,4031,Arivazhagan.P,DHARMAPURI,IND,0,12th Pass,3149700,1300000,1849700
389,6992,Arivudainambi.M,DHARMAPURI,IND,0,Post Graduate,7145500,1260000,5885500
390,2475,Arjan Puri,BARMER,IND,0,Literate,386000,0,386000
391,7186,Arjun Balu Arde,MUMBAI NORTH,Ambedkarite Party of India,0,10th Pass,1526630,0,1526630
392,3251,Arjun Charan Mallik,BHADRAK,BSP,0,Graduate Professional,7817500,0,7817500
393,3246,Arjun Charan Sethi,BHADRAK,BJD,0,Post Graduate,6730000,2424000,4306000
394,7195,Arjun Chaudhary,MUMBAI NORTH,IND,0,8th Pass,3081000,0,3081000
395,3869,Arjun Hanmanta Nimbalkar,BEED,IND,0,10th Pass,225000,19000,206000
396,4171,Arjun Prasad Singh,RAJMAHAL,AJSUP,0,Post Graduate,35193984,0,35193984
397,2304,Arjun Ram Meghwal,BIKANER,BJP,0,Post Graduate,18142863,1216408,16926455
398,466,Arjun Singh Thakur,BASTAR,Ambedkarite Party of India,0,Post Graduate,46885000,250000,46635000
399,2693,Arjun Thakur,JAHANABAD,IND,0,Post Graduate,1212500,0,1212500
400,1160,Arjuna Bhatara,NABARANGPUR,Odisha Jan Morcha,0,Graduate,4137000,815000,3322000
401,2449,Arjunlal Meena,UDAIPUR,BJP,0,Post Graduate,17049951,8195866,8854085
402,7251,Arjunsing Divansing Vasave,NANDURBAR,Bharipa Bahujan Mahasangh,0,Graduate,233000,0,233000
403,815,Arka Keshari Deo,KALAHANDI,BJD,0,Graduate,69822063,831688,68990375
404,3157,Arman Khan,PILIBHIT,IND,0,Graduate Professional,91775,40000,51775
405,537,Armerington Kharshiing,SHILLONG,AAP,0,Not Given,10547837,211214,10336623
406,4887,Aroon Barooa,MANGALDOI,Regional Democratic Secular Congress,0,Post Graduate,732083,0,732083
407,4828,Arpita Ghosh,BALURGHAT,AITC,0,Graduate,544790,0,544790
408,4017,Arsad Ayub,RANCHI,IND,1,10th Pass,5746855,0,5746855
409,3059,Arshadurraza Khan,AONLA,IND,0,Post Graduate,3973500,0,3973500
410,4131,Arti Singh,RAIGARH,INC,0,Post Graduate,6306588,558727,5747861
411,2984,Arujn Singh (Pappu Kushwah),MORENA,Rashtriya Samanta Dal,0,8th Pass,2006618,0,2006618
412,7371,Arul Anbarasu,SRIPERUMBUDUR,INC,2,Post Graduate,45125593,27706387,17419206
413,5445,Aruljothi A,TIRUVANNAMALAI,IND,0,Graduate,125000,18000,107000
414,5456,Arumugam C,TIRUVANNAMALAI,SP,0,12th Pass,2175777,0,2175777
415,5693,Arumugam M,SALEM,IND,0,10th Pass,11075983,0,11075983
416,5455,Arumugam R,TIRUVANNAMALAI,IND,0,10th Pass,1533000,0,1533000
417,7081,Arumugam. C,MAYILADUTHURAI,IND,0,8th Pass,789651,112500,677151
418,3377,Arun Bhatia,PUNE,Peoples Guardian,1,Post Graduate,842515000,8000000,834515000
419,3647,Arun Harishchandra Manjrekar,RATNAGIRI SINDHUDURG,IND,0,10th Pass,3745087,26000,3719087
420,2008,Arun Kumar,HISAR,IND,0,12th Pass,13095700,320000,12775700
421,410,Arun Kumar,AMBALA,CPI,0,Graduate Professional,450000,0,450000
422,1794,Arun Kumar Agarwal,DARJEELING,IND,0,12th Pass,29039342,0,29039342
423,165,Arun Kumar Bhowmik,TRIPURA WEST,SUCI(C),0,Graduate,2443828,145939,2297889
424,4672,Arun Kumar Joshi,DURG,IND,0,Others,45500,0,45500
425,2839,Arun Kumar Mishra,HAZARIBAGH,JVM(P),0,Graduate,55808583,23803410,32005173
426,5074,Arun Kumar Roopak,ALWAR,Naya Daur Party,0,Others,171000,0,171000
427,4744,Arun Marandi,RAJMAHAL,BSP,0,Graduate,365700,0,365700
428,2542,Arun Nagorao Gajbhiye,BHANDARA-GONDIYA,IND,0,Graduate,1295000,8382,1286618
429,4193,Arun Subhash Chandra Yadav,KHANDWA,INC,2,Graduate,318304270,59900980,258403290
430,1362,Arun Thakur,EAST DELHI,Samyak Parivartan Party,0,12th Pass,1081500,0,1081500
431,6265,"Arun, N.",ARAKKONAM,IND,0,Doctorate,10435836,2093000,8342836
432,5432,Arunachalam P,TIRUVANNAMALAI,IND,0,Graduate,879897,0,879897
433,7442,Arunachalam.A,TIRUCHIRAPPALLI,IND,0,Post Graduate,570200,0,570200
434,613,Arunakumara,MANDYA,IND,0,8th Pass,225000,0,225000
435,2254,Arunangshu Bhattacharjee,SILCHAR,SUCI(C),0,Post Graduate,873605,666567,207038
436,6864,Arundhathi Jaiganesh (A) S.Jaiganesh,CHENNAI CENTRAL,IND,0,10th Pass,0,0,0
437,244,Arunoday Saha,TRIPURA WEST,INC,0,Doctorate,33892463,0,33892463
438,138,Arup Kumar Mahanta,KALIABOR,CPI(ML)L,0,Graduate,458613,0,458613
439,1653,Arvind,BAGHPAT,IND,0,12th Pass,410000,100,409900
440,1590,Arvind Dongre,CHHINDWARA,Bahujan Mukti Party,0,10th Pass,4084000,0,4084000
441,3109,Arvind Giri,KHERI,BSP,20,Graduate Professional,26196212,1471211,24725001
442,4937,Arvind Kumar,AKBARPUR,AAP,0,Graduate Professional,13672038,0,13672038
443,205,Arvind Kumar Sharma,KARNAL,INC,0,Post Graduate,35428444,15584114,19844330
444,1404,Arvind Shamrao Lillore,WARDHA,IND,0,Others,144186,0,144186
445,2034,Arvind Tiwari,KARNAL,IND,0,Doctorate,160000,0,160000
446,3138,Asarpat Singh,NAGINA,IND,0,12th Pass,600528,0,600528
447,7512,"Asath, M.M.",THENI,IND,0,5th Pass,1862664,530000,1332664
448,2406,Asfak Ali,KOTA,IND,0,8th Pass,1050000,0,1050000
449,1545,Asha Singh,SIDHI,Rashtriya Apna Dal,0,10th Pass,67500,0,67500
450,3624,Ashapak Shaikh,PUNE,IND,1,8th Pass,110000,0,110000
451,2513,Ashatai Abhyankar Amravati,AMRAVATI,IND,0,Graduate,3450000,1360000,2090000
452,1814,Ashfaq Ahmed Madaki,CHIKKODI,AAP,0,Post Graduate,419204,0,419204
453,440,Ashish,KARNAL,AIFB,0,Graduate,2077000,1100000,977000
454,1238,Ashish Bhushan Pathak,CHATRA,IND,0,Post Graduate,3530500,0,3530500
455,29,Ashish Khetan,NEW DELHI,AAP,0,Post Graduate,17172618,3005294,14167324
456,2711,Ashish Ranjan Sinha,NALANDA,INC,0,Graduate,94210202,0,94210202
457,3115,Ashok,KHERI,AAP,0,Graduate Professional,392000,580000,-188000
458,4814,Ashok,UJJAIN,IND,0,12th Pass,70000,0,70000
459,3329,Ashok Babarao (Ambhore) Dudhgaonkar,PARBHANI,Ambedkar National Congress,0,12th Pass,50000,0,50000
460,3872,Ashok Bhagoji Thorat,BEED,IND,0,Not Given,50000,0,50000
461,2078,Ashok Bhardwaj,GURGAON,National Janhit Congress (AB),0,Graduate Professional,239374641,3790167,235584474
462,787,Ashok Bisi,BARGARH,CPI,2,Graduate Professional,644707,15000,629707
463,2416,Ashok Chandna,BHILWARA,INC,1,Graduate,141642689,89589191,52053498
464,3871,Ashok Dhondiba Sonwane,BEED,IND,0,8th Pass,0,0,0
465,3650,Ashok Dnanu Mane(Bhau),SANGLI,IND,0,12th Pass,527584,39000,488584
466,7217,Ashok Kisan Lokhande,MUMBAI NORTH CENTRAL,Republican Party of India,0,8th Pass,1274084,600000,674084
467,3970,Ashok Ku Bhagat,KATIHAR,IND,1,Literate,1196345,0,1196345
468,393,Ashok Kumar,GAYA,JMM,0,Post Graduate,1843000,0,1843000
469,128,Ashok Kumar,SATNA,IND,0,Graduate,289957,0,289957
470,621,Ashok Kumar,NAWADA,Rajnaitik Vikalp Party,1,Literate,3116000,0,3116000
471,570,Ashok Kumar,JAMMU,BSP,0,10th Pass,4435000,350000,4085000
472,2403,Ashok Kumar,KOTA,BSP,0,5th Pass,421000,0,421000
473,4481,Ashok Kumar,KATIHAR,IND,0,12th Pass,94891,0,94891
474,4325,Ashok Kumar,FATEHPUR SIKRI,Gareeb Adami Party,0,10th Pass,1061000,0,1061000
475,4921,Ashok Kumar,AGRA,IND,0,10th Pass,5900000,0,5900000
476,4414,Ashok Kumar,MAINPURI,IND,0,10th Pass,7695000,150000,7545000
477,5114,Ashok Kumar,KARAULI-DHOLPUR,IND,0,10th Pass,1565000,0,1565000
478,4279,Ashok Kumar Doharey,ETAWAH,BJP,0,Graduate,12252688,0,12252688
479,2400,Ashok Kumar Jain,KOTA,AAP,0,Graduate Professional,30617000,333466,30283534
480,131,Ashok Kumar Masih,BALAGHAT,CPI,0,5th Pass,184000,0,184000
481,1141,Ashok Kumar Panda,SAMBALPUR,IND,0,Graduate,5947626,853925,5093701
482,2238,Ashok Kumar Sharma,JAMMU,IND,0,Graduate,6156613,215602,5941011
483,2044,Ashok Kumar Vashishth,SONIPAT,RPI(A),0,10th Pass,1501000,0,1501000
484,7068,Ashok Kumar.A,KRISHNAGIRI,IND,0,8th Pass,349000,0,349000
485,7060,Ashok Kumar.K,KRISHNAGIRI,AIADMK,3,10th Pass,1176436,0,1176436
486,689,Ashok Mahadeorao Nete,GADCHIROLI-CHIMUR,BJP,0,12th Pass,12125676,5830550,6295126
487,792,Ashok Mittal,BARGARH,AITC,0,10th Pass,0,0,0
488,2915,Ashok Pawar,BHOPAL,Samata Samadhan Party,1,12th Pass,4808000,600000,4208000
489,3338,Ashok Pradhan,PURI,CPI(ML)L,2,Graduate Professional,2006000,300000,1706000
490,2646,Ashok Ram,ARRAH,IND,0,12th Pass,71051,0,71051
491,1259,Ashok Ram,PALAMAU,IND,0,10th Pass,3099116,0,3099116
492,3340,Ashok Sahu,PURI,BJP,1,Post Graduate,55639509,0,55639509
493,5630,Ashok Shankar Jadhav,THANE,Bahujan Mukti Party,0,Graduate Professional,19550000,970000,18580000
494,3392,Ashok Shirpati Khandebharad,SHIRUR,MNS,2,Graduate,11569911,1781742,9788169
495,2953,Ashok Singh,GWALIOR,INC,0,Graduate,288174756,77611615,210563141
496,418,Ashok Tanwar,SIRSA,INC,1,Doctorate,72777188,11222039,61555149
497,5844,Ashok Tarachand Patil,JALGAON,IND,0,Literate,4501297,0,4501297
498,5606,Ashok Tryambak Ingale,RAVER,IND,0,5th Pass,391000,0,391000
499,924,Ashok Vithoba Khandale,CHANDRAPUR,RPI,0,Graduate,10956000,1000000,9956000
500,7617,Ashok Vitthal Sonwane,JALNA,IND,1,Graduate,821000,700000,121000
501,3677,Ashok Waman Gaikwad,SATARA,RPI(A),3,12th Pass,13608263,857836,12750427
502,4941,Ashok Yadav,AKBARPUR,IND,0,Others,11178000,0,11178000
503,3810,Ashraf,MANDYA,IND,0,10th Pass,7310000,0,7310000
504,3113,Ashraf Ali,KHERI,Peace Party,1,Graduate Professional,141782,18710,123072
505,490,Ashutosh,CHANDNI CHOWK,AAP,3,Post Graduate,81121758,11140787,69980971
506,22,Ashutosh Mudgil,CHANDNI CHOWK,IND,0,8th Pass,453921,0,453921
507,1038,Ashwani Malhotra,KURUKSHETRA,AITC,0,10th Pass,1284743,0,1284743
508,2272,Ashweng J. Rengma,AUTONOMOUS DISTRICT,JMM,0,10th Pass,960000,0,960000
509,1052,Ashwini Kumar,KARNAL,BJP,6,Graduate,698638135,153937858,544700277
510,2656,Ashwini Kumar Choubey,BUXAR,BJP,0,Graduate,22094499,1923552,20170947
511,4691,Asif Jeelani,ANANTNAG,AIFB,0,Post Graduate,300000,0,300000
512,4078,Asif Khan,GWALIOR,IND,0,5th Pass,491000,0,491000
513,1579,Asif Khan,BALAGHAT,Minorities Democratic Party,0,10th Pass,180000,0,180000
514,4378,Asim Kumar Das,MURSHIDABAD,IND,0,Post Graduate,474723,0,474723
515,5952,Aslam Hanif Khot,MUMBAI SOUTH CENTRAL,Peace Party,0,8th Pass,782000,0,782000
516,2419,Aslam Shekh Advocate,BHILWARA,IND,0,Post Graduate,7290000,0,7290000
517,5883,Asmita Pushkar Puranik,KALYAN,IND,0,12th Pass,1391585,0,1391585
518,3260,Asok Das,JAJPUR,INC,0,Post Graduate,14693759,5579589,9114170
519,1578,Asra Anjum Farooqui,BALAGHAT,RPI(A),0,Graduate,450000,0,450000
520,7444,Asraf Ali.M,TIRUCHIRAPPALLI,IND,0,5th Pass,1736907,510000,1226907
521,4003,Asrita Tuti,KHUNTI,IND,0,Post Graduate,3398931,560769,2838162
522,1167,Aswini Kumar Padhy,BERHAMPUR,BSP,0,Graduate Professional,392889,32000,360889
523,438,Atam Parkash,HISAR,IND,0,Post Graduate,13665554,0,13665554
524,352,Ateeque Ahmad Mohd. Badiujjama,NAGPUR,IND,2,10th Pass,14360527,7606,14352921
525,1113,Athawaley Sanjay Hiramanji,AMRAVATI,IND,1,Graduate,1120000,268900,851100
526,4673,Atmaram Sahu,DURG,SUCI(C),0,Post Graduate,777014,0,777014
527,1848,Attuveppil Kunhikkannan,VADAKARA,IND,0,5th Pass,452079,19000,433079
528,1487,Atul Ashok Munginwar,CHANDRAPUR,IND,1,12th Pass,3400000,740000,2660000
529,4391,Atul Chaturvedi,FIROZABAD,INC,0,Post Graduate,27115000,42300,27072700
530,1638,Atul Khodawal,MEERUT,IND,0,Illiterate,61500,0,61500
531,3072,Atul Kumar,BADAUN,IND,0,Graduate,2156941,593817,1563124
532,3002,Atul Mishra,SAGAR,AAP,1,Graduate Professional,4823372,173000,4650372
533,3535,Atul Prasannakumar Dighe,KOLHAPUR,Bharipa Bahujan Mahasangh,3,Post Graduate,15499770,0,15499770
534,6862,Auditor Gopinarayanan,CHENNAI CENTRAL,Makkal Manadu Katchi,0,Others,13736350,0,13736350
535,7614,Autade Vilas Keshavrao,JALNA,INC,1,12th Pass,130505302,1056950,129448352
536,5956,Avhad Mahesh Zunjar,NASHIK,AIFB,0,10th Pass,0,0,0
537,2749,Avinash Kumar,PATALIPUTRA,Bharatiya Jan Kranti Dal (Democratic),0,Post Graduate,1520412,56797,1463615
538,3870,Avinash Namdev Wankhede,BEED,IND,2,Graduate Professional,745000,309000,436000
539,2971,Avnish Tiwari,KHAJURAHO,SHS,0,Graduate Professional,2918424,946893,1971531
540,1272,Avtar Singh Bhadana,FARIDABAD,INC,1,8th Pass,112529244,0,112529244
541,3496,Awade Kallappa Baburao,HATKANANGLE,INC,0,10th Pass,157503816,22322097,135181719
542,2733,Awadh Kumar,NALANDA,IND,0,Graduate,6189466,0,6189466
543,3901,Ayare Rajendra Lahu,RATNAGIRI SINDHUDURG,BSP,0,Post Graduate,1252000,200000,1052000
544,2972,Ayendr Kumar Sharma,KHAJURAHO,IND,0,Graduate,340000,0,340000
545,3082,Ayesha Islam,BAREILLY,SP,0,Graduate,26491794,4514160,21977634
546,7380,"Ayodhi, L.( Dr).",SRIPERUMBUDUR,IND,0,Doctorate,7719824,745000,6974824
547,3454,Ayub Khan,NAGAUR,SP,0,8th Pass,6579000,100000,6479000
548,7560,Ayyadurai. S,THOOTHUKKUDI,BSP,3,Post Graduate,2914000,649000,2265000
549,7162,Ayyappan .S,RAMANATHAPURAM,IND,0,Not Given,620000,110000,510000
550,5071,Azad Husain,ALWAR,BSP,0,12th Pass,27566246,2125000,25441246
551,3622,Azam Vakil Maniyar,PUNE,IND,0,5th Pass,284000,0,284000
552,7164,Azhagu Meena .A,RAMANATHAPURAM,IND,0,Post Graduate,9651,5500,4151
553,7219,Azimuddin Khan,MUMBAI NORTH CENTRAL,The Lok Party of India,1,Graduate,873404,0,873404
554,6000,Aziz Abdul Kadir Mukadam,RAIGAD,SP,0,5th Pass,4228000,0,4228000
555,4091,Azmal Hussain,DHUBRI,AAP,0,12th Pass,14635426,0,14635426
556,3767,B N Gopalagowda,CHIKKBALLAPUR,IND,0,Graduate Professional,73000,0,73000
557,1895,B Padmanabhan,PALAKKAD,AAP,0,Graduate,1573288,0,1573288
558,2162,B Sreeramulu,BELLARY,BJP,8,Graduate,151392844,4050947,147341897
559,6848,B. Ambeth Venkatesh,CHENNAI CENTRAL,IND,0,Illiterate,116000,0,116000
560,2216,B. Dharmappa,SHIMOGA,JD(U),0,Graduate Professional,13450336,700000,12750336
561,849,B. Gnana Prakash,DAVANAGERE,IND,0,Graduate,2665000,0,2665000
562,288,B. Gopalakrishnan,CHALAKUDY,BJP,2,Graduate Professional,5014237,644405,4369832
563,6939,B. Kumar Sri Sri,CHENNAI SOUTH,IND,0,Not Given,50000,0,50000
564,1097,B. R. Govindaiah,BANGALORE SOUTH,IND,0,12th Pass,4067500,23000,4044500
565,3732,B.K. Narayana-Swamy,BANGALORE CENTRAL,IND,0,10th Pass,3000,0,3000
566,2220,B.K. Shashi Kumar,SHIMOGA,Karunaadu Party,0,10th Pass,61000,0,61000
567,3783,B.M.Jayadev Mathad,HAVERI,IND,3,Graduate,3050000,300000,2750000
568,3804,B.Manohar Hanumantappa,KOPPAL,IND,0,10th Pass,2035000,0,2035000
569,1225,B.N. Bachhegouda,CHIKKBALLAPUR,BJP,0,Graduate Professional,475228512,83632650,391595862
570,1085,B.N.Chandrappa,CHITRADURGA,INC,0,Post Graduate,48303759,13800000,34503759
571,2894,B.S. Thaneswariya,BHIND,Bahujan Mukti Party,0,Post Graduate,597002,0,597002
572,399,B.S. Yeddyurappa,SHIMOGA,BJP,9,12th Pass,69746267,500000,69246267
573,842,B.T.Lalitha Naik,GULBARGA,AAP,0,8th Pass,6006253,0,6006253
574,2120,B.V.Nayak,RAICHUR,INC,0,Graduate Professional,73502466,0,73502466
575,3788,B.V.Venkatagiriyappa,KOLAR,IND,0,Graduate,100000,320000,-220000
576,3726,B.V.Venkateshappa,BANGALORE CENTRAL,IND,0,10th Pass,16105000,0,16105000
577,606,B.Venkatesha,TUMKUR,Karunaadu Party,0,Graduate Professional,6941000,4400000,2541000
578,3841,B.Vikraman,MADURAI,CPI(M),0,10th Pass,2591109,0,2591109
579,2307,Baadshah,ALIGARH,Peace Party,0,8th Pass,62260000,500000,61760000
580,7460,Baalu.T.R,THANJAVUR,DMK,0,Graduate,201555306,11054616,190500690
581,4785,Baba Abdul Hamid,KHANDWA,IND,0,Not Given,28285000,0,28285000
582,4413,Baba Hardev Singh,MAINPURI,AAP,0,Doctorate,9994500,0,9994500
583,3331,Baban (Anna) Muley,PARBHANI,Bahujan Mukti Party,0,12th Pass,907000,400000,507000
584,7621,Babasaheb Patil Shinde,JALNA,IND,0,10th Pass,351070,98300,252770
585,4383,Bablu Soren,RAIGANJ,Jharkhand Disom Party,0,12th Pass,260290,0,260290
586,4819,Babu Lal,VIDISHA,Samata Samadhan Party,0,8th Pass,260700,0,260700
587,2482,Babu Lal,BARMER,IND,0,8th Pass,569104,15000,554104
588,4726,Babu Lal Soren,DUMKA,AITC,0,Literate,575800,0,575800
589,6873,Babu Mailan .A,CHENNAI NORTH,Lok Satta Party,0,Graduate Professional,4319709,940000,3379709
590,2629,Babu Mathew,BANGALORE NORTH,AAP,0,Post Graduate,94852273,494702,94357571
591,2430,Babu Meghwal,CHITTORGARH,IND,0,Literate,417102,0,417102
592,1306,Babu Singh Dukhiya,WEST DELHI,IND,1,Graduate,1851000,0,1851000
593,4316,Babulal,FATEHPUR SIKRI,BJP,3,12th Pass,73028848,16390000,56638848
594,5118,Babulal Jangid,TONK-SAWAI MADHOPUR,IND,1,10th Pass,68800,0,68800
595,4730,Babulal Marandi,DUMKA,JVM(P),0,Graduate,6974656,0,6974656
596,176,Babupasha,BIDAR,IND,0,Not Given,12500,50000,-37500
597,1451,Baburao Damaduji Meshram,NAGPUR,IND,0,12th Pass,3810000,200000,3610000
598,4206,Babusingh,RATLAM,BSP,0,8th Pass,1170000,0,1170000
599,4376,Badaruddoza Khan,MURSHIDABAD,CPI(M),0,Graduate,2758610,0,2758610
600,4000,Badri Gope,HAZARIBAGH,IND,0,5th Pass,1756000,0,1756000
601,4088,Badruddin Ajmal,DHUBRI,AIUDF,1,Others,432748134,0,432748134
602,3917,Badshah Khan,BHOPAL,Naya Daur Party,0,8th Pass,255000,0,255000
603,6326,Bagatsingh Palanichamy M,DINDIGUL,BSP,1,8th Pass,1625034,0,1625034
604,4162,Baghrai Soren,DUMKA,IND,0,Graduate Professional,765000,0,765000
605,374,Bagi Kumar Verma,AURANGABAD,JD(U),0,Graduate,32766379,1600000,31166379
606,803,Bagi Lakra,SUNDARGARH,BSP,1,Graduate Professional,1925530,88983,1836547
607,5834,Bagul Vedu Tanaji,JALGAON,BSP,0,Literate,960000,0,960000
608,5841,Bahadur Ragib Ahamed,JALGAON,SP,0,Post Graduate,278918,0,278918
609,6839,Bahadur Ram,SURGUJA,IND,0,8th Pass,182000,0,182000
610,4225,Bahadur Singh,BHARATPUR,BJP,0,Literate,19142363,1333100,17809263
611,456,Bahadur Singh,BHIWANI-MAHENDRAGARH,INLD,0,5th Pass,182580199,8699200,173880999
612,577,Bahadur Singh Chowdhary,JAMMU,SP,0,Graduate,1431120,298000,1133120
613,4008,Bahadur Uraon,RANCHI,CPI(ML)L,1,10th Pass,992464,600000,392464
614,3315,Baidhar Mallick,JAGATSINGHPUR,BJP,1,Graduate,6027197,700000,5327197
615,2637,Baijnath Yadav,ARRAH,Bahujan Mukti Party,0,5th Pass,6060167,350000,5710167
616,223,Baikuntha Dhangada Majhi,KALAHANDI,Kalinga Sena,0,10th Pass,20000,0,20000
617,1575,Baishakhoo Maravi,MANDLA,Bhartiya Satya Sangharsh Party,0,5th Pass,0,0,0
618,5126,Bajarang Lal,TONK-SAWAI MADHOPUR,Rashtriya Ahinsa Manch,0,10th Pass,120000,0,120000
619,4643,Bajarang Sidar,RAIGARH,IND,0,12th Pass,398200,12000,386200
620,3396,Bajare Sitaram Namdeo (Baba),SHIRUR,Bahujan Mukti Party,0,Graduate,13978791,0,13978791
621,4269,Bajrang Prasad,AKBARPUR,Samtawadi Republican Party,0,Graduate,1834806,0,1834806
622,5915,Bala Dagadu Nandgaonkar,MUMBAI SOUTH,MNS,8,10th Pass,77108523,1921378,75187145
623,7450,Bala Krishnan.K,TIRUCHIRAPPALLI,IND,0,12th Pass,67267,0,67267
624,7033,Bala Subramanian T.,KANNIYAKUMARI,IND,1,Post Graduate,1490000,0,1490000
625,816,Balabhadra Majhi,NABARANGPUR,BJD,0,Graduate,52977088,705404,52271684
626,3550,Balaji Dnyanoba Kamble,LATUR,SP,0,Post Graduate,2860000,0,2860000
627,6892,Balaji. E,CHENNAI NORTH,IND,0,Post Graduate,1076500,180000,896500
628,7174,Balakrishnan .S.S.,RAMANATHAPURAM,IND,1,Not Given,4355000,500000,3855000
629,7480,Balakrishnan P,SIVAGANGA,IND,0,5th Pass,38400,0,38400
630,7013,"Balamurugan, R",KANCHEEPURAM,IND,0,Others,63000,0,63000
631,7363,Balamurugan.B,TIRUVALLUR,AAP,0,Post Graduate,7900951,220000,7680951
632,7112,"Balan, P.P.",NILGIRIS,IND,0,Post Graduate,0,0,0
633,1152,Balaram Hota,KALAHANDI,CPI(ML)L,0,Others,1150,0,1150
634,5151,Balasaheb Asaram Sarate,AURANGABAD,IND,0,Post Graduate,5849936,1955530,3894406
635,3681,Balasaheb Dashrath Bagul,SHIRDI,IND,0,Literate,483000,0,483000
636,1377,Balasaheb Shankar Darade,BULDHANA,IND,0,Post Graduate,2334214,331493,2002721
637,5152,Balasaheb Vitthal Aware,AURANGABAD,IND,0,10th Pass,1831343,16000,1815343
638,6329,Balasubramani.R,DINDIGUL,Ulzaipali Makkal Katchy,0,12th Pass,1511000,0,1511000
639,3916,Balbhadra Mishra,BHOPAL,Bhartiya Jan Yug Party,0,8th Pass,1802210,350000,1452210
640,2145,Balbheem,BIDAR,IND,0,Graduate,415000,0,415000
641,1044,Balbir Singh Saini,KURUKSHETRA,INLD,0,Graduate,42261869,4284205,37977664
642,2392,Baldar,JHALAWAR-BARAN,IND,0,8th Pass,2935000,150000,2785000
643,5383,Baldau Prasad Sahu,DURG,IND,0,8th Pass,114412,0,114412
644,4502,Baldau Prasad Sahu,BILASPUR,IND,0,Graduate,320500,0,320500
645,4001,Baldeo Ganjhu,HAZARIBAGH,IND,2,10th Pass,450746,0,450746
646,4514,Baldeo Maravi,SURGUJA,GGP,0,10th Pass,7132000,0,7132000
647,366,Baleshwar Bharti,SASARAM,BSP,0,10th Pass,273200,0,273200
648,5262,Baleshwar Marandi,KATIHAR,JMM,0,Graduate,465871,0,465871
649,3580,Baliram Sukhdev More,MADHA,IND,0,Others,1202111,375345,826766
650,5979,Baliram Sukur Jadhav,PALGHAR,Bahujan Vikas Aaghadi,1,8th Pass,20841211,2292937,18548274
651,2019,Baljeet,HISAR,IND,0,Graduate,410700,0,410700
652,3025,Balkrishna Salgaonkar,SOUTH GOA,IND,0,Illiterate,311650,0,311650
653,2291,Balraj Bawari,GANGANAGAR,IND,0,10th Pass,573000,0,573000
654,972,Balram Bari,CHANDNI CHOWK,IND,0,8th Pass,2980000,0,2980000
655,4021,Balram Kumar Bedia,RANCHI,IND,0,12th Pass,5287989,125000,5162989
656,7472,Balu S,SIVAGANGA,Tamil Nadu Makkal Congress,0,8th Pass,323000,0,323000
657,2020,Balwan Singh,HISAR,IND,0,12th Pass,3560500,300000,3260500
658,1234,Balwant Kumar,CHATRA,Jharkhand Party,1,Graduate,9514000,0,9514000
659,1998,Balwant Singh,SIRSA,Bharatiya Sant Mat Party,0,10th Pass,1053000,0,1053000
660,2292,Balwant Singh Hariyala,GANGANAGAR,Bharatiya Sant Mat Party,0,10th Pass,1053000,0,1053000
661,2961,Balwant Singh Kushwah Advocate,GWALIOR,SP,0,Graduate Professional,3200000,80000,3120000
662,417,Balwinder Kaur,KURUKSHETRA,AAP,0,10th Pass,17852106,1196325,16655781
663,1178,Banamali Majhi,KORAPUT,Ambedkarite Party of India,0,Post Graduate,48000,0,48000
664,4439,Bandana Barman Baruah,GAUHATI,SP,0,Graduate,2087486,0,2087486
665,2135,Bandeppa,BIDAR,JD(S),0,Graduate Professional,73218291,3333600,69884691
666,3659,Bandgar Nanaso Balaso,SANGLI,BSP,0,8th Pass,2743505,14000,2729505
667,2879,Bandhu Tirkey,RANCHI,AITC,7,Graduate,1832121,1261689,570432
668,1767,Bangshi Badan Barman,COOCHBEHAR,IND,5,Graduate,7528892,0,7528892
669,2537,Banjare Babulal Sundarlal,NAGPUR,IND,0,10th Pass,51017,0,51017
670,3817,Bannur Kumar,MYSORE,IND,0,Graduate,7250000,0,7250000
671,4793,Bano Bee,MANDSOUR,Bharatiya Minorities Suraksha Mahasangh,0,Illiterate,34000,0,34000
672,4796,Banshilal Patidar,MANDSOUR,Bahujan Sangharshh Dal,1,5th Pass,3564058,2035000,1529058
673,3899,Bansi Lal,UDHAMPUR,IND,0,8th Pass,6730000,200000,6530000
674,3632,Bansode Chayya Tukaram,PUNE,IND,0,8th Pass,309000,0,309000
675,3547,Bansode Dattatray Gunderao,LATUR,INC,0,Post Graduate,4006396,787720,3218676
676,7236,Bansode Dilip Bapu,MUMBAI NORTH EAST,IND,0,10th Pass,50000,0,50000
677,3564,Bansode Kundan Fulchand,MADHA,BSP,0,5th Pass,410000,30000,380000
678,5153,Bansode Udhav Govardhan,AURANGABAD,IND,0,Graduate,615000,600000,15000
679,5154,Banswal Mannalal Premchand,AURANGABAD,Prabuddha Republican Party,0,Not Given,65000,0,65000
680,1462,Bante Jitendra Ramaji,BHANDARA-GONDIYA,IND,0,12th Pass,510000,0,510000
681,475,Banwari Saw,CHATRA,CPI,0,Literate,5765202,553000,5212202
682,4745,Barnard Hembrom,RAJMAHAL,Rashtriya Krantikari Samajwadi Party,0,12th Pass,8001008,0,8001008
683,3356,Barne Shrirang Chandu,MAVAL,SHS,2,8th Pass,665047926,11799786,653248140
684,3359,Barne Shrirang Chimaji,MAVAL,JD(U),0,Literate,953049,0,953049
685,4863,Barun Karmakar,BARPETA,IND,0,12th Pass,713000,0,713000
686,2870,Basant Kumar Longa,KHUNTI,JVM(P),0,Graduate,5442300,0,5442300
687,497,Basant Panwar,NORTH WEST DELHI,BSP,0,8th Pass,2162778,27500,2135278
688,1165,Basanta Kumar Pradhan,KANDHAMAL,IND,0,12th Pass,150000,0,150000
689,1821,Basappa Kallappa Hanchanal,CHIKKODI,IND,0,12th Pass,15991000,270000,15721000
690,2179,Basavanteppa Honnappa Hullatti,HAVERI,Sarva Janata Party,0,Graduate Professional,0,0,0
691,1185,Basavaraj,KOPPAL,INC,0,10th Pass,38334476,2144769,36189707
692,1080,Basavaraj K.J,DAVANAGERE,AAP,0,Graduate,974000,30000,944000
693,2524,Basavegowda,BANGALORE RURAL,RPI(A),0,Graduate,447000,74000,373000
694,2529,Bashir Khan Ramzan Khan,NAGPUR,Minorities Democratic Party,0,Graduate,7839000,52000,7787000
695,800,Basil Ekka,SUNDARGARH,AAP,0,10th Pass,333388,1000000,-666612
696,5437,Baskaran M R,TIRUVANNAMALAI,BSP,0,8th Pass,3002000,79000,2923000
697,3389,Basu Mog,TRIPURA EAST,IND,0,10th Pass,1911085,0,1911085
698,3219,Basudeb Naik,KEONJHAR,IND,2,10th Pass,27042432,2090125,24952307
699,3785,Beeda Srinivas N,KOLAR,IND,0,Literate,1356000,600000,756000
700,3127,Begum Noor Bano Urf Mehtab,MORADABAD,INC,0,10th Pass,78531612,0,78531612
701,5882,Belamkar Milind Chandrakant,KALYAN,Lok Bharati,0,10th Pass,13238000,4000000,9238000
702,7017,Bellarmin A.V.,KANNIYAKUMARI,CPI(M),1,Post Graduate,8419973,329228,8090745
703,4441,Benedict Alok Areng,GAUHATI,IND,1,10th Pass,565000,20000,545000
704,2511,Benet Babu Benjamin,THIRUVANANTHAPURAM,IND,0,10th Pass,3503683,0,3503683
705,632,Bennet Abraham,THIRUVANANTHAPURAM,CPI,1,Post Graduate,34112353,0,34112353
706,4806,Bhadiya,RATLAM,IND,1,Illiterate,1901000,50000,1851000
707,4860,Bhadreswar Barman,BARPETA,IND,0,12th Pass,251000,0,251000
708,2811,Bhagat Ram Soni,RAJNANDGAON,Chhattisgarh Swabhiman Manch,0,12th Pass,8742244,0,8742244
709,1553,Bhagawati Charan Pandey(Neelu),SIDHI,IND,0,Graduate,3425500,100000,3325500
710,2898,Bhagirath Prasad,BHIND,BJP,0,Doctorate,21240286,3687610,17552676
711,2352,Bhagirath Singh,SIKAR,Akhil Bharat Hindu Mahasabha,0,Post Graduate,258000,0,258000
712,2124,Bhagvantappa,RAICHUR,Lok Satta Party,0,Illiterate,609998,66000,543998
713,3019,Bhagwan Das,TIKAMGARH,IND,0,10th Pass,656000,0,656000
714,3140,Bhagwan Dass Rathor,NAGINA,Mahan Dal,0,Graduate Professional,9219083,0,9219083
715,1835,Bhagwan Kambale,BIJAPUR,RPI(A),0,5th Pass,906668,150000,756668
716,2141,Bhagwanth,BIDAR,BJP,0,Graduate Professional,56559290,16829000,39730290
717,3881,Bhagwat Harihar Taware,BEED,IND,0,Graduate,0,0,0
718,1793,Bhaichung Bhutia,DARJEELING,AITC,0,10th Pass,184406721,7746438,176660283
719,39,Bhairaw Dayal Singh,KARAKAT,IND,0,Post Graduate,16847000,0,16847000
720,4780,Bhaiyalal Uikey,KHANDWA,GGP,0,Literate,3265000,500000,2765000
721,814,Bhakta Charan Das,KALAHANDI,INC,1,Graduate Professional,11516583,3875982,7640601
722,5203,Bhamare Subhash Ramrao,DHULE,BJP,0,Graduate Professional,125833320,660757,125172563
723,3326,Bhambale Vijay Manikrao,PARBHANI,NCP,3,10th Pass,14944093,1895188,13048905
724,2335,Bhan Singh,JHUNJHUNU,Bharatiya Sant Mat Party,0,10th Pass,452500,0,452500
725,5596,Bhande Dashrath Motiram,RAVER,BSP,1,Post Graduate,34810892,0,34810892
726,2441,Bhanji Bhai,BANSWARA,JD(U),0,8th Pass,15752404,250000,15502404
727,5631,Bhanudas Dhotare,THANE,IND,0,12th Pass,2500000,0,2500000
728,5155,Bhanudas Ramdas Sarode,AURANGABAD,IND,0,Not Given,0,0,0
729,3809,Bhanuprakash.K.L,MANDYA,IND,0,Post Graduate,3828500,0,3828500
730,2300,Bhanwar Lal,BIKANER,BSP,0,10th Pass,3840000,980000,2860000
731,2440,Bhanwar Lal,CHITTORGARH,IND,0,10th Pass,1155000,0,1155000
732,2461,Bhanwar Lal Mali,RAJSAMAND,IND,0,8th Pass,2671280,171200,2500080
733,3420,Bhanwar Lal Soni,AJMER,IND,0,8th Pass,1650000,0,1650000
734,3433,Bhanwar Lal Waghela,JALORE,IND,0,12th Pass,233675,0,233675
735,3456,Bhanwar Singh Rathore,NAGAUR,AITC,0,Graduate,42000,0,42000
736,4815,Bhanwarlal,UJJAIN,Jai Maha Bharath Party,0,10th Pass,32904,0,32904
737,2289,Bhanwarlal Meghwal,GANGANAGAR,INC,0,Post Graduate,24098177,255803,23842374
738,3360,Bhapkar Maruti Sahebrao,MAVAL,AAP,18,12th Pass,14386607,195500,14191107
739,5127,Bhar Singh,TONK-SAWAI MADHOPUR,Socialist Party (India),0,5th Pass,211000,0,211000
740,1187,Bharadhawaja,KOPPAL,CPI(ML)L,0,Others,430000,0,430000
741,4674,Bharat Bhusan Pandey,DURG,CPI(ML) Red Star,1,12th Pass,7402516,50000,7352516
742,2638,Bharat Bhushan Pandey,ARRAH,Akhil Bharatiya Jan Sangh,0,Doctorate,1757000,0,1757000
743,3560,Bharat Damodar Londhe,LATUR,IND,0,Graduate,279000,20000,259000
744,3551,Bharat Maroti Kadam,LATUR,Ambedkarite Party of India,0,10th Pass,6906,0,6906
745,2999,Bharat Sen Advocate,SAGAR,IND,0,Graduate Professional,205966,0,205966
746,3839,Bharathi Kannamma,MADURAI,IND,0,Graduate,105000,0,105000
747,7075,Bharathi Mohan R.K,MAYILADUTHURAI,AIADMK,1,12th Pass,7378589,969756,6408833
748,7375,"Bharathi, K. Thiru",SRIPERUMBUDUR,CPI(ML)L,0,Post Graduate,1108295,40000,1068295
749,7385,Bharathidasan R. Thiru.,SRIPERUMBUDUR,IND,0,Post Graduate,435535,0,435535
750,4266,Bharti Devi Pasi,AKBARPUR,IND,0,Graduate Professional,9262010,0,9262010
751,3276,Bhartruhari Mahatab,CUTTACK,BJD,0,Post Graduate,88834098,0,88834098
752,3714,Bhaskar Chandra Mohanty,PURI,BSP,0,Graduate Professional,8215000,0,8215000
753,2809,Bhaskar Dwivedi,RAJNANDGAON,AAP,0,Post Graduate,12708752,4814872,7893880
754,320,Bhaskar Marotrao Neware,WARDHA,IND,0,Post Graduate,132798,0,132798
755,717,Bhaskaran K V,ERNAKULAM,IND,1,Graduate,4640900,350000,4290900
756,3403,Bhausaheb Rajaram Wakchaure,SHIRDI,INC,1,Doctorate,73540816,9030001,64510815
757,6940,Bhavani Janakiram,CHENNAI SOUTH,IND,0,Post Graduate,425000,350000,75000
758,316,Bhavna Bhavesh Wasnik,AMRAVATI,AAP,0,Post Graduate,12289332,880320,11409012
759,2546,Bheemappa Dhoolappa Ajjodi,BAGALKOT,IND,0,Post Graduate,192646,31200,161446
760,4804,Bheru Singh Damor,RATLAM,JD(U),0,10th Pass,1304200,107000,1197200
761,5228,Bherulal Imliyar,DHAR,Bahujan Mukti Party,0,12th Pass,504167,21000,483167
762,1067,Bhimaraya,RAICHUR,AAP,0,10th Pass,2885000,65000,2820000
763,3366,Bhimrao Anna Kadale,MAVAL,IND,0,10th Pass,1770000,0,1770000
764,3701,Bhise Krishna Nagnath,SOLAPUR,IND,0,10th Pass,511665,0,511665
765,3465,Bhojraj,PALI,BSP,0,Others,18480000,0,18480000
766,2710,Bhola Sao,NALANDA,Krantikari Vikas Dal,0,Literate,140000,0,140000
767,7239,Bhole Pushpa Milind,MUMBAI NORTH WEST,BSP,2,Graduate Professional,59238640,4242867,54995773
768,3592,Bhosale Revan Vishwanath,OSMANABAD,JD(S),0,Post Graduate,11357709,1688121,9669588
769,3728,Bhovi Rama C.B.K,BANGALORE CENTRAL,IND,0,8th Pass,101000,0,101000
770,2496,Bhriguram Reang,TRIPURA EAST,AITC,0,12th Pass,1132884,31473,1101411
771,2334,Bhudar Mal,JHUNJHUNU,AITC,0,Post Graduate,12290000,100000,12190000
772,5960,Bhujbal Chhagan Chandrakant,NASHIK,NCP,1,10th Pass,217559536,350000,217209536
773,2834,Bhuneshwar Prasad Mehta,HAZARIBAGH,CPI,1,12th Pass,10483915,0,10483915
774,385,Bhuneswar Das,GAYA,Rashtriya Ahinsa Manch,0,Literate,1829000,0,1829000
775,1312,Bhup Singh,NORTH WEST DELHI,IND,0,Graduate Professional,61711,0,61711
776,136,Bhupen Kumar Borah,TEZPUR,INC,0,Post Graduate,26084515,3350225,22734290
777,5053,Bhupendra Kumar Dhangar,MATHURA,Rashtriya Shoshit Samamj Party,0,12th Pass,215500,0,215500
778,4754,Bhupendra Singh Uikey,BETUL,IND,0,Post Graduate,50000,0,50000
779,2051,Bhupeshwar Dayal,SONIPAT,IND,0,Graduate Professional,3058174,0,3058174
780,196,Bhupinder Kumar,AMBALA,IND,0,10th Pass,120000,0,120000
781,1021,Bhura Ram,AMBALA,IND,0,Not Given,26119165,0,26119165
782,3972,Bibhaker Jha,KATIHAR,AAP,1,Graduate,373035,0,373035
783,3314,Bibhu Prasad Tarai,JAGATSINGHPUR,INC,0,Post Graduate,5756318,799000,4957318
784,3241,Bichitra Nanda Das,BALASORE,BSP,1,Post Graduate,5325200,0,5325200
785,3665,Bichukale Abhijit Vamanrao,SATARA,IND,0,Graduate,60397,0,60397
786,3784,Bidaragaddi V.B,HAVERI,IND,0,Graduate,22810000,1150000,21660000
787,2824,Bideshi Mahto,GIRIDIH,Jharkhand Disom Party,0,Graduate,6928610,0,6928610
788,836,Bidhan Chandra Panda,BERHAMPUR,Samata Kranti Dal,0,10th Pass,3551085,950000,2601085
789,4453,Bidya Nand Paswan,ARARIA,Bahujan Mukti Party,0,12th Pass,856973,7000,849973
790,809,Bighna Raj Panda,KALAHANDI,Samruddha Odisha,1,12th Pass,764550,58637,705913
791,3349,Bijay Mohanty,BHUBANESWAR,INC,0,Others,17367991,0,17367991
792,828,Bijaya Kumar Mahapatro,ASKA,BSP,0,10th Pass,50000,0,50000
793,2050,Bijender Kumar,SONIPAT,IND,0,10th Pass,1650000,0,1650000
794,680,Bijendra Singh,ALIGARH,INC,2,Graduate,12292000,2201014,10090986
795,1785,Bijoy Chandra Barman,JALPAIGURI,AITC,0,Post Graduate,9396430,797019,8599411
796,527,Bijoy Kr. Tiru,KALIABOR,AIUDF,0,Graduate,5238298,0,5238298
797,139,Bijoy Krishna Handique,JORHAT,INC,0,Post Graduate,43378685,0,43378685
798,2263,Bijoy Krishna Nath,SILCHAR,AGP,0,Graduate,11038641,0,11038641
799,6867,Biju Chacko,CHENNAI NORTH,INC,0,Graduate Professional,53691343,516000,53175343
800,1945,Biju Joseph,IDUKKI,IND,0,10th Pass,1867208,0,1867208
801,3281,Bikash Das,CUTTACK,AAP,0,Doctorate,19920752,4700000,15220752
802,1163,Bilasini Nayak,KANDHAMAL,Aama Odisha Party,0,10th Pass,691500,0,691500
803,312,Bilkan Bara,ALIPURDUARS,Samajwadi Jan Parishad,0,Graduate Professional,9069500,62000,9007500
804,4835,Bimal Mardi,MALDAHA DAKSHIN,Jharkhand Disom Party,0,Graduate,160000,0,160000
805,4352,Bimalendu Sarkar,BALURGHAT,RSP,0,Post Graduate,9149229,0,9149229
806,4238,Bimla Devi Meena,DAUSA,IND,0,Graduate,19869123,800000,19069123
807,3275,Binapani Das,CUTTACK,SUCI(C),0,12th Pass,127124,0,127124
808,161,Binay Debbarma,TRIPURA WEST,Indigenous Peoples Front of Tripura,1,Graduate Professional,520000,0,520000
809,1881,Bindu M.K.,PONNANI,IND,0,8th Pass,318706,33000,285706
810,42,Binod Gogoi,KALIABOR,IND,0,Graduate,3600000,0,3600000
811,624,Binod Kumar Das,JAMUI,AAP,1,12th Pass,252600,0,252600
812,5278,Binod Kumar Sahu,SUPAUL,IND,0,Graduate,1535000,50000,1485000
813,4715,Binod Singh,DHANBAD,IND,0,10th Pass,963000,0,963000
814,980,Bir Singh Soni,CHANDNI CHOWK,IND,0,12th Pass,1030100,0,1030100
815,2271,Biren Singh Engti,AUTONOMOUS DISTRICT,INC,0,Post Graduate,35367390,0,35367390
816,1777,Birendra Bara (Oraon),ALIPURDUARS,BJP,0,Graduate,115340,0,115340
817,484,Birendra Bhagat,LOHARDAGA,JVM(P),0,10th Pass,2911000,0,2911000
818,4022,Birendra Kumar Jaiswal,RANCHI,IND,0,10th Pass,10201398,1698482,8502916
819,4435,Birendra Prasad Baishya,GAUHATI,AGP,0,Post Graduate,15564483,1790999,13773484
820,127,Birendra Singh,SATNA,IND,0,12th Pass,2451500,100000,2351500
821,7213,Birje Hemant Anant,MUMBAI NORTH CENTRAL,AIFB,0,Graduate,60430000,0,60430000
822,3644,Birje Yashwant Anant,RATNAGIRI SINDHUDURG,Bahujan Mukti Party,0,Post Graduate,3278000,0,3278000
823,4619,Bishat Kurre,RAIPUR,CPI(ML)L,0,8th Pass,6767000,0,6767000
824,4009,Bisheshwar Mahto,RANCHI,Samata Party,0,10th Pass,9999500,300000,9699500
825,4845,Bishnu Pada Barman,MALDAHA UTTAR,Amra Bangalee,0,Graduate,1005000,260000,745000
826,585,Bishnu Pada Ray,ANDAMAN & NICOBAR ISLANDS,BJP,1,Graduate,5658980,175115,5483865
827,3288,Bishnu Prasad Das,KENDRAPARA,BJP,0,Graduate,1837410,0,1837410
828,3223,Bishnupriya Naik,KEONJHAR,Odisha Jan Morcha,0,10th Pass,245000,0,245000
829,3708,"Bismaya Mahapatra,",BHUBANESWAR,AAP,0,Post Graduate,15156959,3824000,11332959
830,4838,Bisnu Pada Roy,MALDAHA DAKSHIN,BJP,1,Post Graduate,5419006,650967,4768039
831,1332,Biswajit Ranjit Chatterjee,NEW DELHI,AITC,0,12th Pass,33350000,0,33350000
832,3244,Biswajit Ray,BALASORE,IND,0,Graduate,71000,0,71000
833,4350,Biswapriya Roy Choudhury,BALURGHAT,BJP,5,Graduate Professional,4440487,0,4440487
834,4727,Bitiya Manjhi,DUMKA,CPI(ML)L,0,10th Pass,1214500,0,1214500
835,3320,Bochare Shankar Mahadji,NANDED,IND,0,10th Pass,7978374,761000,7217374
836,761,Bodhsingh Bhagat,BALAGHAT,BJP,0,Graduate,24959436,1393732,23565704
837,3847,Bojanna N Somaiah,MYSORE,IND,0,Graduate Professional,2835000,500000,2335000
838,2538,Borkar Ravindra,NAGPUR,IND,0,10th Pass,300000,0,300000
839,157,Brahmadav Anand Paswan,JAMUI,BSP,0,12th Pass,9493973,175000,9318973
840,1552,Brahmanand Pratap Singh,SIDHI,IND,0,Graduate,0,0,0
841,2569,Brahmananda Reddy,TUMKUR,IND,7,Graduate Professional,261074,126000,135074
842,3925,Brajendra Gappu Chaturvedi,BHOPAL,IND,0,Post Graduate,890000,0,890000
843,3034,Brajlal,AMROHA,Bahujan Mukti Party,0,Post Graduate,6502000,0,6502000
844,4212,Brajmohan Malviya,UJJAIN,Prajatantrik Samadhan Party,0,Graduate Professional,882436,120000,762436
845,2977,Brindawan Singh Sikarwar,MORENA,BSP,1,12th Pass,18606750,0,18606750
846,1537,Brmhadatta Mishra Urf Chote,REWA,IND,0,12th Pass,2283500,0,2283500
847,2865,Buday Munda,KHUNTI,Akhil Bhartiya Jharkhand Party,0,12th Pass,1669500,50000,1619500
848,401,Budayya Pujeri,BANGALORE CENTRAL,Karunaadu Party,0,Graduate,1966100,0,1966100
849,2891,Budhram Laguri,SINGHBHUM,Bahujan Mukti Party,0,12th Pass,1639671,43898,1595773
850,3165,Budhsen Verma,PILIBHIT,SP,0,8th Pass,36598361,4550000,32048361
851,328,C B Chandrababu,ALAPPUZHA,CPI(M),10,Graduate Professional,1466177,360075,1106102
852,904,C G Saji Kumar,ANDAMAN & NICOBAR ISLANDS,IND,0,12th Pass,50000,0,50000
853,2231,C J Jagannath,UDUPI CHIKMAGALUR,CPI(ML) Red star,0,5th Pass,111000,0,111000
854,2555,C Mohan Kumar,MYSORE,BSP,0,10th Pass,5250000,0,5250000
855,297,C N Jayadevan,THRISSUR,CPI,3,Post Graduate,20041642,294000,19747642
856,3452,C R Choudhary,NAGAUR,BJP,0,Post Graduate,17921949,0,17921949
857,1042,C. L. Ruala,MIZORAM,INC,0,Graduate,25733421,0,25733421
858,6852,C.D. Meyyappan,CHENNAI CENTRAL,INC,0,Post Graduate,89988340,1100000,88888340
859,1201,C.H. Vijayashankar,HASSAN,BJP,0,Graduate,42165344,5100000,37065344
860,1897,C.K. Ramakrishnan,PALAKKAD,IND,0,Not Given,729614,380200,349414
861,2952,C.L. Karodiya,GWALIOR,Jan-Nyay Dal,0,Graduate,806184,0,806184
862,2632,C.Narayana Swamy,BANGALORE NORTH,INC,0,Post Graduate,247952597,922460,247030137
863,1088,C.S.Puttaraju,MANDYA,JD(S),0,12th Pass,45209196,11231000,33978196
864,7255,C.S.Valvi,NANDURBAR,IND,0,Graduate,10500,0,10500
865,3060,Captain Phool Chandra Sharma,AONLA,Jawan Kisan Morcha,0,Graduate,1010000,0,1010000
866,2948,Captan Babulal Goswami,GWALIOR,IND,0,Graduate,4300000,0,4300000
867,5396,Chaitram Suryavanshi,JANJGIR-CHAMPA,IND,0,Post Graduate,418000,0,418000
868,2198,Chalawadi Ashok Sahadevappa,UTTARA KANNADA,IND,0,Graduate,1780000,1505000,275000
869,2796,Champa Lal Patel,MAHASAMUND,IND,0,Graduate,1860000,0,1860000
870,480,Chamra Linda,LOHARDAGA,AITC,2,Graduate,7010805,1550000,5460805
871,7061,Chanbasha.M,KRISHNAGIRI,BSP,0,5th Pass,1106000,0,1106000
872,2534,Chanda Manwatkar,NAGPUR,IND,0,12th Pass,0,0,0
873,4094,Chandan Brahma,KOKRAJHAR,BPF,0,Graduate,61378388,26772159,34606229
874,5138,Chandan Lal Meena,TONK-SAWAI MADHOPUR,IND,0,Graduate,5862017,1000000,4862017
875,4419,Chandan Singh,MATHURA,SP,0,Graduate Professional,33511293,0,33511293
876,4071,Chandoo Lal Sahu S/O Avadh Ram Sahu,MAHASAMUND,IND,0,8th Pass,4000,0,4000
877,4647,Chandra Bhusan Kanwar,KORBA,Ambedkarite Party of India,0,Graduate Professional,21597,0,21597
878,4454,Chandra Bhushan,ARARIA,AAP,0,Graduate Professional,14088067,5025161,9062906
879,2763,Chandra Bhushan Prasad Chandravnsi,PATNA SAHIB,Bahujan Mukti Party,1,Literate,29711938,50200,29661738
880,2759,Chandra Dev Prasad,PATALIPUTRA,Bahujan Mukti Party,0,Post Graduate,479600,0,479600
881,5015,Chandra Pal,HARDOI,Bharatiya Republican Paksha,0,8th Pass,184037,0,184037
882,4920,Chandra Pal,AGRA,Adarsh Samaj Party,0,Doctorate,111676624,7056864,104619760
883,2436,Chandra Prakash,CHITTORGARH,BJP,0,Graduate,14134693,687284,13447409
884,2425,Chandra Prakash Gocher,BHILWARA,Bharatiya Yuva Shakti,0,12th Pass,7612000,60000,7552000
885,3987,Chandra Prakash Mandle,DURG,IND,3,Graduate Professional,23602100,2330000,21272100
886,834,Chandra Sekhar Sahu,BERHAMPUR,INC,0,Graduate Professional,22114000,642430,21471570
887,2397,Chandra Singh,JHALAWAR-BARAN,BSP,0,8th Pass,225000,0,225000
888,1957,Chandrababu,ALAPPUZHA,IND,0,10th Pass,0,0,0
889,767,Chandrabhan Singh Choudhary,CHHINDWARA,BJP,0,Graduate Professional,88884662,2258313,86626349
890,2685,Chandrabhushan Sharma,JAHANABAD,AAP,0,Doctorate,7877980,0,7877980
891,1231,Chandradev Thakur,CHATRA,Socialist Party (India),0,8th Pass,1683317,0,1683317
892,817,Chandradhwaja Majhi,NABARANGPUR,IND,0,Graduate,2028926,0,2028926
893,6956,"Chandragasan, N",CHIDAMBARAM,IND,0,8th Pass,525000,0,525000
894,2139,Chandrakant,BIDAR,AAP,0,Post Graduate,5000070,417370,4582700
895,5156,Chandrakant Bhaurao Khaire,AURANGABAD,SHS,8,12th Pass,90614560,20307244,70307316
896,3663,Chandrakant Tatu Khandait,SATARA,Bharipa Bahujan Mahasangh,0,Graduate,223500,100000,123500
897,6331,Chandramohan P,DINDIGUL,IND,0,10th Pass,3422000,0,3422000
898,6969,"Chandran, D.",COIMBATORE,CPI(ML)L,0,Graduate,3388439,1651255,1737184
899,2934,Chandrapal Singh Tomar,GUNA,IND,0,Post Graduate,6730000,200000,6530000
900,7365,Chandrasekaran.M,TIRUVALLUR,IND,0,Others,14147894,0,14147894
901,2550,Chandrashekaraiah,MYSORE,JD(S),0,Post Graduate,28573891,0,28573891
902,4152,Chandrda Shekhar Dubey,DHANBAD,AITC,4,10th Pass,40055646,190000,39865646
903,3440,Chandresh Kumari,JODHPUR,INC,0,12th Pass,307822286,4101175,303721111
904,5230,Chandresh Singh,VIDISHA,IND,0,10th Pass,42613,0,42613
905,4231,Chandu Lal Meena,DAUSA,BSP,3,10th Pass,1218571031,26015101,1192555930
906,110,Chandu Lal Sahu (Chandu Bhaiya) S/O Late Puneen Ram,MAHASAMUND,BJP,0,Graduate Professional,20879652,2700000,18179652
907,3909,Chandu Lal Sahu S/O Balchand Sahu,MAHASAMUND,IND,0,10th Pass,209000,0,209000
908,4070,Chandu Lal Sahu S/O Biju Ram Sahu,MAHASAMUND,IND,0,5th Pass,6000,0,6000
909,4067,Chandu Lal Sahu S/O Late Nathu Ram,MAHASAMUND,IND,0,5th Pass,254500,150000,104500
910,4069,Chandu Lal Sahu S/O Parmanand Sahu,MAHASAMUND,IND,0,Literate,2574000,0,2574000
911,4068,Chandu Lal Sahu S/O Same Lal Sahu,MAHASAMUND,IND,0,8th Pass,1114000,0,1114000
912,4066,Chandu Lal Sahu S/O Soju Lal Sahu,MAHASAMUND,IND,0,8th Pass,1307000,0,1307000
913,4074,Chandu Ram Sahu S/O Nakul Sahu,MAHASAMUND,IND,0,5th Pass,12000,0,12000
914,4072,Chandu Ram Sahu S/O Pilau Ram Sahu,MAHASAMUND,IND,0,8th Pass,648000,0,648000
915,4073,Chanduram Sahu S/O Ram Karosa Sahu,MAHASAMUND,IND,0,Literate,12000,0,12000
916,4664,Charan Bhaya,KORBA,IND,0,Not Given,352000,0,352000
917,4648,Charan Das Mahant,KORBA,INC,0,Doctorate,98328278,2500000,95828278
918,1301,Charan Jeet Singh,WEST DELHI,AIFB,0,Post Graduate,709000,0,709000
919,1056,Charanjeet Singh,SIRSA,INLD,0,10th Pass,8146887,3260000,4886887
920,6882,Charavanan. M.P.,CHENNAI NORTH,IND,0,Graduate,3716798,0,3716798
921,920,Chatap Wamanrao Sadashiv,CHANDRAPUR,AAP,3,Graduate Professional,29375000,1300000,28075000
922,1626,Chater Singh Kashyap,MUZAFFARNAGAR,Vanchit Jamat Party,0,10th Pass,12559000,0,12559000
923,198,Chattar Singh,KURUKSHETRA,BSP,0,Graduate Professional,72970569,3500000,69470569
924,3018,Chaturbhuj Snehi,TIKAMGARH,IND,0,12th Pass,0,0,0
925,3384,Chaudhari Kalu Vinayak,BARAMATI,BSP,0,8th Pass,65000,0,65000
926,5994,Chaudhari Mujjafar Jainuddin Alias Modi,RAIGAD,IND,0,5th Pass,1069000,515000,554000
927,2092,Chaudhary Daya Chand,FARIDABAD,Bhartiya Shakti Chetna Party,0,Graduate,10745000,0,10745000
928,5822,Chavan Harishchandra Deoram,DINDORI,BJP,1,Graduate,37240147,881137,36359010
929,2598,Chavan Vinod Narayan,YAVATMAL-WASHIM,IND,0,10th Pass,3361500,570000,2791500
930,5614,Chavhan Mohan Shamrao,RAVER,IND,0,Post Graduate,4213625,450000,3763625
931,7208,Chawan Suryakant Gangaram,MUMBAI NORTH CENTRAL,IND,0,8th Pass,3482557,0,3482557
932,943,Chaware Maya Namdeo,RAMTEK,SP,7,Post Graduate,13746000,1220000,12526000
933,7063,Chellakumar. Dr. A,KRISHNAGIRI,INC,1,Graduate Professional,52280762,29502704,22778058
934,5673,Chellakumarasamy.T.S,NAMAKKAL,AAP,0,Doctorate,43275164,2061000,41214164
935,331,Chengara Surendran,MAVELIKKARA,CPI,1,Graduate,3363470,794051,2569419
936,241,Cheni Ram Moran,DIBRUGARH,AIFB,0,10th Pass,824337,0,824337
937,321,Chetan Bhimraj Pendam,WARDHA,BSP,1,Post Graduate,13251784,0,13251784
938,3207,Chetram,SHAHJAHANPUR,INC,0,Graduate Professional,13768803,0,13768803
939,3233,Chhabi Mahali,MAYURBHANJ,AAP,0,Others,75674,0,75674
940,1153,Chhabilal Nial,KALAHANDI,Ambedkarite Party of India,0,Graduate Professional,580758,0,580758
941,3426,Chhaganaram / Bhalaram,JALORE,Bahujan Mukti Party,0,8th Pass,118668,0,118668
942,3425,Chhaganaram / Prhalad,JALORE,Hindustan Janta Party,0,Literate,1652000,4000,1648000
943,2986,Chhavendra,MORENA,IND,0,Literate,785508,0,785508
944,4161,Chhaya Kole,DUMKA,CPI,0,8th Pass,3061595,700000,2361595
945,145,Chhedi Paswan,SASARAM,BJP,0,Post Graduate,35776803,275000,35501803
946,3459,Chhoturam,NAGAUR,IND,0,10th Pass,837000,275000,562000
947,913,Chinchole Gangaram Kaluji,BULDHANA,IND,0,12th Pass,21065000,117000,20948000
948,7062,Chinna Pillappa.P,KRISHNAGIRI,DMK,0,Post Graduate,152477730,430835,152046895
949,7122,"Chinna Rajendran, C.",PERAMBALUR,IND,0,12th Pass,2700000,0,2700000
950,2570,Chinnappa.V,TUMKUR,CPI,0,Graduate,201696,21412,180284
951,7040,"Chinnasamy, M.",KARUR,DMK,0,Graduate Professional,76747420,16329000,60418420
952,7050,"Chinnasamy, M.",KARUR,IND,0,8th Pass,790800,100000,690800
953,7051,"Chinnasamy, V.",KARUR,IND,0,8th Pass,1329000,0,1329000
954,843,Chinnayyanaik,RAICHUR,IND,0,12th Pass,1658400,0,1658400
955,7185,Chinnusamy N,SALEM,IND,0,5th Pass,451500,0,451500
956,4019,Chintamani Mahto,RANCHI,IND,1,12th Pass,7763850,26150,7737700
957,4209,Chintamani Malviya,UJJAIN,BJP,0,Doctorate,18888754,5483153,13405601
958,158,Chirag Kumar Paswan,JAMUI,LJP,0,12th Pass,10414470,4458954,5955516
959,3766,Chitra Prasad,CHIKKBALLAPUR,BSP,0,Post Graduate,4740600,1800000,2940600
960,5264,Chitranjan Singh,KISHANGANJ,IND,0,10th Pass,630000,20000,610000
961,2886,Chitrasen Sinku,SINGHBHUM,INC,0,12th Pass,8992000,1100000,7892000
962,4371,Chitta Ranjan Kirttania,MALDAHA UTTAR,BSP,0,Graduate,17660906,840000,16820906
963,2063,Chitter Singh Bali,BHIWANI-MAHENDRAGARH,IND,0,10th Pass,2196500,650000,1546500
964,6325,Chitthan N.S.V,DINDIGUL,INC,0,Graduate,27649207,0,27649207
965,710,Chittoor Rajamannar,IDUKKI,IND,0,Post Graduate,60222146,1365374,58856772
966,1129,Chole Omprakash Bakaram,BHANDARA-GONDIYA,IND,0,Graduate Professional,1007000,800000,207000
967,2274,Chomang Kro,AUTONOMOUS DISTRICT,IND,0,Graduate,4122196,0,4122196
968,3657,Chopade Shriprasad Janardan,SANGLI,IND,0,12th Pass,334194,0,334194
969,3973,Chote Lal Mahto,KISHANGANJ,IND,0,5th Pass,334500,0,334500
970,5083,Choudhary Nashrudeen,ALWAR,Socialist Party (India),0,Literate,24094100,1450000,22644100
971,3759,Chowdahalli Javaraiah,CHAMARAJANAGAR,CPI(ML)L,0,Graduate Professional,393000,0,393000
972,302,Christy Fernandez,ERNAKULAM,IND,0,Doctorate,27176949,2620749,24556200
973,195,Chungkhokai Doungel,OUTER MANIPUR,NCP,0,Graduate,6685000,0,6685000
974,197,Chuni Manoj Kumar,KURUKSHETRA,IND,0,5th Pass,1593000,0,1593000
975,1991,Churchill Alemao,SOUTH GOA,AITC,3,Others,149868252,72589679,77278573
976,1854,Cleatus,WAYANAD,IND,2,8th Pass,6905000,0,6905000
977,3026,Cliffton De Souza,SOUTH GOA,Bahujan Mukti Party,0,10th Pass,152500,0,152500
978,3381,Col Suresh Patil (Rtd),PUNE,Bahujan Mukti Party,0,12th Pass,1034609,0,1034609
979,2472,Col. Sona Ram,BARMER,BJP,1,Graduate Professional,174678454,5584331,169094123
980,3627,Colonel Jayantrao Chitale,PUNE,IND,0,Graduate Professional,1014500,0,1014500
981,6916,Colonel Kadar Basha,CHENNAI SOUTH,IND,0,Others,9991131,0,9991131
982,940,Com. Bandu Ramchandra Meshram,RAMTEK,CPI(ML) Red star,0,12th Pass,285146,0,285146
983,912,Commander (Rtd) Ashok Raut,BULDHANA,IND,0,Graduate Professional,7250500,0,7250500
984,4811,Comrade Lata Bhabor,RATLAM,CPI(M),3,8th Pass,78649422,0,78649422
985,3327,Comrade Rajan Kshirsagar,PARBHANI,CPI,7,Graduate,4099277,700000,3399277
986,199,Comrade Ram Kumar,SIRSA,CPI(M),0,12th Pass,877705,0,877705
987,3344,Comred Bhise Ganpat Devrao,PARBHANI,IND,2,Graduate,757300,225000,532300
988,1739,Cp Verma,SAHARANPUR,IND,3,Literate,4750000,0,4750000
989,3816,D Eswar Thoremavu,MYSORE,IND,0,Graduate,500000,25000,475000
990,844,D H Pujar,KOPPAL,CPI(ML) Red star,4,5th Pass,2219600,350000,1869600
991,1283,D K Chopra,SOUTH DELHI,IND,1,Graduate,7080000,0,7080000
992,3769,D N Narasimhamurthy,CHIKKBALLAPUR,IND,0,10th Pass,290000,130000,160000
993,2176,D Prasad Sangappa,HAVERI,RPI(A),0,12th Pass,7850000,1080000,6770000
994,3814,D S Nirvanappa,MYSORE,CPI(ML) Red Star,0,5th Pass,629000,5000,624000
995,7502,D Sivamuthu Kumar,MADURAI,DMDK,2,Post Graduate,12866994,4084000,8782994
996,6851,D. Babu,CHENNAI CENTRAL,IND,0,5th Pass,60000,0,60000
997,6858,D. Ramesh,CHENNAI CENTRAL,IND,0,Post Graduate,495000,0,495000
998,3510,D.B.Naik,HINGOLI,CPI(M),1,Graduate,4071000,470000,3601000
999,2122,D.B.Nayak,RAICHUR,JD(S),1,Graduate,10591888,0,10591888
1000,5619,D.D.Wani,RAVER,IND,1,10th Pass,771968,10000,761968
1001,5474,D.Elumalai,VILUPPURAM,IND,0,Graduate,40000,0,40000
1002,2861,D.G.Raja,JAMSHEDPUR,SP,0,Graduate,1899744,265504,1634240
1003,2633,D.Jayaram,BANGALORE NORTH,Gareeb Aadmi Party,0,12th Pass,40000,0,40000
1004,2369,D.K. Chhangani,JAIPUR,CPI,0,Graduate,2605791,0,2605791
1005,1090,D.K.Suresh,BANGALORE RURAL,INC,7,12th Pass,858713138,184854756,673858382
1006,2619,D.M.Ambareesha,KOLAR,BSP,0,Post Graduate,145000,0,145000
1007,1224,D.V. Sadananda Gowda,BANGALORE NORTH,BJP,0,Graduate Professional,98888874,37020152,61868722
1008,2659,Dadan Yadav,BUXAR,BSP,22,10th Pass,26250000,103594500,-77344500
1009,731,Dadhibal,SATNA,Apna Dal,0,Post Graduate,2933600,0,2933600
1010,4123,Daduram Manhar,JANJGIR-CHAMPA,AAP,0,Post Graduate,2517042,0,2517042
1011,3573,Dagadu Manik Pawar,MADHA,IND,0,5th Pass,1521697,0,1521697
1012,915,Daharwal Ganeshdeo Raghuji,BHANDARA-GONDIYA,GGP,0,5th Pass,7113000,0,7113000
1013,1154,Daitary Pradhan,KALAHANDI,Aama Odisha Party,2,Post Graduate,47792839,367818,47425021
1014,447,Dalbir Singh Chahal,SONIPAT,Rashtravadi Janata Party,0,5th Pass,16475000,90000,16385000
1015,1336,Dalchand,NEW DELHI,IND,0,8th Pass,2970854,300000,2670854
1016,1773,Dalendra Nath Ray,COOCHBEHAR,Amra Bangalee,0,10th Pass,2358865,0,2358865
1017,745,Dalpat Singh Paraste,SHAHDOL,BJP,0,Graduate Professional,5524870,0,5524870
1018,5022,Dalveer Singh,HATHRAS,IND,0,5th Pass,68575,0,68575
1019,3401,Damale Shivajirao Waman,AHMEDNAGAR,Bhartiya Navjawan Sena (Paksha),0,Graduate Professional,1721000,905302,815698
1020,4002,Daman Chandra Bhakat,JAMSHEDPUR,BSP,0,10th Pass,38695000,40000,38655000
1021,3628,Dambale Rahul Dharma,PUNE,IND,13,12th Pass,20000,0,20000
1022,3688,Dambale Ram Dharma,SHIRUR,IND,0,10th Pass,1383000,105000,1278000
1023,4167,Damodar Singh,GODDA,AITC,0,12th Pass,3802143,100000,3702143
1024,994,Dan Bahadur Yadav,NORTH EAST DELHI,IND,0,Graduate,1345000,0,1345000
1025,1475,Dandekar Baburao Laxman,GADCHIROLI-CHIMUR,IND,0,12th Pass,580000,0,580000
1026,5157,Dandge Nanasaheb Damodhar,AURANGABAD,IND,0,Graduate,1335000,0,1335000
1027,2918,Daniel John,BHOPAL,IND,0,12th Pass,8081017,0,8081017
1028,5855,Danve Raosaheb Dadarao,JALNA,BJP,4,Graduate,184411862,8534130,175877732
1029,4275,Danvir,ETAH,IND,0,10th Pass,1423000,0,1423000
1030,649,Daryl William Ch Momin,TURA,INC,0,Post Graduate,1250390,204472,1045918
1031,696,Das K Varkala,ATTINGAL,IND,2,10th Pass,13633,39000,-25367
1032,3231,Dashmat Soren,MAYURBHANJ,BSP,0,10th Pass,855000,0,855000
1033,2885,Dashrath Gagrai,SINGHBHUM,JVM(P),3,Graduate,3940724,100000,3840724
1034,5080,Dashrath Kumar,ALWAR,Ambedkarite Party of India,0,Doctorate,1905000,200000,1705000
1035,1775,Dasrath Tirkey,ALIPURDUARS,AITC,0,Graduate,3550353,293909,3256444
1036,6258,"Dass, D.",ARAKKONAM,BSP,0,10th Pass,50000,0,50000
1037,1984,Dattaram Desai,NORTH GOA,AAP,0,Post Graduate,9795686,335819,9459867
1038,3699,Dattatraya Vitthal Thorat,SOLAPUR,IND,0,8th Pass,227000,0,227000
1039,5369,Dausingh Maravi,BILASPUR,IND,0,Graduate,435500,40000,395500
1040,404,David Horo,LAKHIMPUR,IND,0,10th Pass,94000,0,94000
1041,1037,Davinder Kumar,KURUKSHETRA,IND,2,12th Pass,2275000,250000,2025000
1042,1051,Davinder Singh,KARNAL,Rashtriya Karmyog Party,0,12th Pass,240000,0,240000
1043,5370,Daya Das Lahre,BILASPUR,IND,0,8th Pass,2097599,49000,2048599
1044,4967,Daya Shanker,FARRUKHABAD,Adarsh Rashtriya Vikas Party,0,8th Pass,506000,0,506000
1045,2869,Dayamani Barla,KHUNTI,AAP,5,Post Graduate,175500,0,175500
1046,1981,Dayanand G. Narvekar,NORTH GOA,IND,2,Graduate Professional,184306689,62952534,121354155
1047,1827,Dayanand Guruputrayya Chikkamath,BELGAUM,SP,0,Graduate,7050000,2000000,5050000
1048,6853,Dayanidhi Maran,CHENNAI CENTRAL,DMK,0,Graduate,109429193,0,109429193
1049,4444,Deba Kumar Barman,MANGALDOI,AITC,0,Others,15202790,948237,14254553
1050,3232,Debashis Marndi,MAYURBHANJ,JMM,0,Doctorate,3993858,627225,3366633
1051,3257,Debendra Kumar Mallik,JAJPUR,BSP,0,Graduate Professional,10000,0,10000
1052,4381,Deepa Dasmunsi,RAIGANJ,INC,1,Post Graduate,19163081,0,19163081
1053,7234,Deepak Digambar Shinde,MUMBAI NORTH EAST,IND,0,Post Graduate,2394016,0,2394016
1054,18,Deepak Gaur,FARIDABAD,Aarakshan Virodhi Party,0,12th Pass,1183000,325000,858000
1055,467,Deepak Karma,BASTAR,INC,0,Graduate,3601587,0,3601587
1056,1304,Deepak Kumar,WEST DELHI,Rashtriya Janadhikar Party,0,8th Pass,21000,0,21000
1057,1356,Deepak Kumar,EAST DELHI,IND,0,12th Pass,236200,0,236200
1058,4106,Deepak Kumar,BANKA,SUCI(C),0,12th Pass,2633089,0,2633089
1059,2958,Deepak Kumar Bansal Rangwale (Prerak),GWALIOR,IND,0,Graduate,4059104,264727,3794377
1060,5397,Deepak Narang,JANJGIR-CHAMPA,IND,0,10th Pass,1231800,0,1231800
1061,3375,Deepak Natharam Paigude,PUNE,MNS,1,12th Pass,114428519,50291943,64136576
1062,2609,Deepak Rajesh Coelho,DAKSHINA KANNADA,IND,0,Graduate,3328000,0,3328000
1063,587,Deepak Shukla,CHANDIGARH,IND,0,Graduate,1874000,338837,1535163
1064,6888,Deepak. C,CHENNAI NORTH,IND,0,Graduate,6832000,7000000,-168000
1065,1398,Deepaksingh Trymbakrao Deshmukh,WARDHA,IND,0,10th Pass,6900000,0,6900000
1066,3402,Deepali Sayyad,AHMEDNAGAR,AAP,1,Graduate,30052370,3767489,26284881
1067,1268,Deepender Singh,ROHTAK,INC,0,Post Graduate,358749354,39310300,319439054
1068,7144,Deivasigamani.K,POLLACHI,IND,0,10th Pass,9050000,0,9050000
1069,774,Denis Siangshai,SHILLONG,IND,0,Graduate,1287025457,0,1287025457
1070,1931,Densil Mendez,ERNAKULAM,JD(U),0,10th Pass,2634109,169614,2464495
1071,4424,Deol Hema Malini Dharmendra,MATHURA,BJP,0,Doctorate,1782015620,231234174,1550781446
1072,5914,Deora Milind Murli,MUMBAI SOUTH,INC,0,Graduate,408001069,59250670,348750399
1073,736,Deoraj Singh Patel,REWA,BSP,0,Post Graduate,70149663,17924260,52225403
1074,692,Deorao Monba Nannaware,GADCHIROLI-CHIMUR,Ambedkarite Party of India,0,Graduate Professional,4463077,922967,3540110
1075,5198,Deore Mahendra Trambak,DHULE,IND,0,Graduate,1940029,0,1940029
1076,921,Deotale Sanjay Wamanrao,CHANDRAPUR,INC,0,Graduate Professional,45464118,3496308,41967810
1077,5925,Desai Rajendra Daulat,MUMBAI SOUTH,IND,0,8th Pass,113800,0,113800
1078,3522,Deshmukh Balasaheb Desai,HINGOLI,IND,0,Not Given,680000,50000,630000
1079,5845,Deshmukh Iqbal A. Rehman,JALGAON,IND,0,5th Pass,130500,0,130500
1080,549,Deshmukh Jaideep Rajendra,WARDHA,IND,1,Post Graduate,2227258,0,2227258
1081,3488,Deshmukh Vikas Nanasaheb,AHMEDNAGAR,IND,0,12th Pass,3796964,510000,3286964
1082,2200,Deshpande Prashanth,UTTARA KANNADA,INC,0,Post Graduate,999522016,64619045,934902971
1083,599,Dev Kumar Choudhary,GAYA,IND,0,Graduate Professional,5087170,800000,4287170
1084,2747,Dev Kumar Verma,PATALIPUTRA,RPI(A),0,12th Pass,4333000,0,4333000
1085,3908,Dev Prasad Kelkar,MAHASAMUND,IND,0,10th Pass,6915060,250000,6665060
1086,7584,Devadasa Sundaram,TIRUNELVELI,DMK,0,Graduate,186962206,0,186962206
1087,6359,Devadass. R,KALLAKURICHI,INC,1,Graduate Professional,76577515,6568797,70008718
1088,7599,Devadoss.A.R,TIRUNELVELI,IND,0,10th Pass,51880493,1329992,50550501
1089,7100,Devaki. G,NAGAPATTINAM,IND,0,Post Graduate,45000,0,45000
1090,2306,Devanand,ALIGARH,Lok Dal,0,Graduate,305016,0,305016
1091,6890,Devaraj. G,CHENNAI NORTH,IND,0,Graduate Professional,577000,0,577000
1092,889,Devchand Dhruw,BASTAR,CPI(ML) Red star,0,8th Pass,371000,52235,318765
1093,1107,Devender,KARNAL,RPI(A),0,12th Pass,625000,201000,424000
1094,2920,Devendra Chaourasia,DAMOH,BSP,1,Graduate,8658000,340000,8318000
1095,2978,Devendra Kumar Agrval,MORENA,AAP,0,Graduate Professional,6240542,490100,5750442
1096,1604,Devendra Kumar Urf Gudda Bhaiyya,HOSHANGABAD,IND,0,10th Pass,95509,0,95509
1097,4264,Devendra Singh Urf Bhole Singh,AKBARPUR,BJP,0,10th Pass,28546617,559965,27986652
1098,3227,Devi Prasanna Besra,MAYURBHANJ,IND,0,Graduate,5178227,0,5178227
1099,1329,Devi Singh,NEW DELHI,Rashtriya Jankranti Party,0,Post Graduate,285000,0,285000
1100,500,Devinder Kumar Sehrawat,SOUTH DELHI,AAP,0,Post Graduate,23237892,540000,22697892
1101,3521,Devji Gangaram Asole,HINGOLI,IND,0,Graduate Professional,195500,0,195500
1102,3424,Devji Patel,JALORE,BJP,0,10th Pass,51846777,12780726,39066051
1103,3574,Devkate Somanath Alias Someshwar Chandrakant,MADHA,IND,1,5th Pass,148500,0,148500
1104,3468,Devkishan Dehiya,PALI,Megh Desham Party,0,10th Pass,443500,0,443500
1105,3630,Devkule Bibhishan Jagannath,PUNE,IND,0,10th Pass,1195000,0,1195000
1106,5280,Devnarayan Yadav,SUPAUL,Bahujan Mukti Party,0,Post Graduate,9500500,250000,9250500
1107,3523,Dhabe Uttam Maroti,HINGOLI,IND,0,Literate,1241000,0,1241000
1108,3595,Dhale Padmasheel Ramchandra,OSMANABAD,BSP,3,Post Graduate,3372138,330000,3042138
1109,23,Dhan Raj Chauhan,CHANDNI CHOWK,Naya Daur Party,0,8th Pass,370000,0,370000
1110,831,Dhanada Kanta Mishra,BERHAMPUR,AAP,0,Doctorate,10787163,5662400,5124763
1111,4356,Dhananjay Banerjee,JANGIPUR,Amra Bangalee,0,Post Graduate,929000,0,929000
1112,3532,Dhananjay Bhimrao Mahadik,KOLHAPUR,NCP,1,Graduate,448882000,71333000,377549000
1113,389,Dhananjay Kishore,GAYA,AAP,0,Graduate Professional,6509560,6102,6503458
1114,4644,Dhananjay Rathiya,RAIGARH,IND,0,10th Pass,121000,0,121000
1115,1130,Dhananjay Shamlalji Rajabhoj,BHANDARA-GONDIYA,IND,0,Post Graduate,3070000,0,3070000
1116,3733,Dhananjaya. H.H,BANGALORE CENTRAL,IND,1,12th Pass,809580000,460000,809120000
1117,295,Dhanapalan,THRISSUR,INC,1,Graduate,12435866,2269212,10166654
1118,7589,Dhanaraj.R.,TIRUNELVELI,Indian Christian Secular Party,0,Graduate,7160090,37000,7123090
1119,5575,Dhanarasu @ Mathimaharaja,PONDICHERRY,IND,0,8th Pass,7300000,1640000,5660000
1120,6334,Dhandabani.K,DINDIGUL,IND,0,10th Pass,1191095,425000,766095
1121,7411,"Dhandapani, M.",VELLORE,IND,0,Graduate,147168,0,147168
1122,5371,Dhani Ram Khare,BILASPUR,Republican Paksha (Khoripa),0,5th Pass,13485,0,13485
1123,5372,Dhani Ram Yadav,BILASPUR,SP,0,8th Pass,0,0,0
1124,1598,Dhaniram Yaduwanshi,CHHINDWARA,IND,0,12th Pass,504199,148810,355389
1125,5113,Dhanraj Bairwa,KARAULI-DHOLPUR,Socialist Party (India),0,5th Pass,300000,0,300000
1126,3441,Dhanraj Gehlot,JODHPUR,Jai Maha Bharath Party,0,Graduate,3506231,300000,3206231
1127,4649,Dhansingh Dhurve,KORBA,BSP,0,Post Graduate,542768,55693,487075
1128,4116,Dharam Bhargav,BILASPUR,BSP,0,12th Pass,1919014,506437,1412577
1129,2780,Dharam Pal Balgotra,UDHAMPUR,BSP,0,Others,16995852,1158038,15837814
1130,865,Dharambir,BHIWANI-MAHENDRAGARH,BJP,0,Graduate,50057200,4530000,45527200
1131,2064,Dharambir S/O Banwari,BHIWANI-MAHENDRAGARH,IND,0,Illiterate,2715000,0,2715000
1132,2066,Dharambir Singh,BHIWANI-MAHENDRAGARH,IND,0,Post Graduate,1424342,0,1424342
1133,4187,Dharamdas Ahirwar,INDORE,BSP,0,12th Pass,4086330,0,4086330
1134,458,Dharampal,GURGAON,BSP,0,12th Pass,16990111,0,16990111
1135,1030,Dharampal Dhiman,KURUKSHETRA,IND,0,10th Pass,765000,0,765000
1136,462,Dharampal Yadav,GURGAON,INC,0,Graduate,76792493,0,76792493
1137,1315,Dharamraj,NORTH WEST DELHI,Bhartiya Pragatisheel Congress,0,8th Pass,3486700,0,3486700
1138,997,Dharamveer Singh,NORTH EAST DELHI,Rashtriya Ekta Party,1,10th Pass,6497000,0,6497000
1139,3290,Dharanidhar Nayak,KENDRAPARA,INC,0,Post Graduate,35040745,11869710,23171035
1140,2065,Dharm Bir S/O Hari Singh,BHIWANI-MAHENDRAGARH,IND,0,10th Pass,51000,48000,3000
1141,5688,Dharmalingam.M,NAMAKKAL,IND,0,8th Pass,420000,0,420000
1142,3066,Dharmandra Yadav,BADAUN,SP,0,Post Graduate,24987715,8950291,16037424
1143,1704,Dharmender,GAUTAM BUDHHA NAGAR,Dharam Nirpeksh Dal,0,8th Pass,55813000,0,55813000
1144,588,Dharmender Singh,CHANDIGARH,Hindustan Ekta Party,0,Graduate,1623000,70000,1553000
1145,3051,Dharmendra Kumar,AONLA,BJP,0,10th Pass,5364652,0,5364652
1146,1449,Dharmendra Wasudeorao Mandlik,NAGPUR,Hindustan Janta Party,0,Post Graduate,23900,0,23900
1147,5099,Dharmi Ghunawat,DAUSA,Indian Peoples Green Party,0,12th Pass,663000,0,663000
1148,6825,Dharmjeet Singh Markam,SURGUJA,BSP,0,10th Pass,4633187,25000,4608187
1149,3848,Dhas Suresh Ramchandra,BEED,NCP,2,Graduate,74408903,10490592,63918311
1150,3861,Dhatture Hafizbhai Husain,SANGLI,IND,0,8th Pass,7288408,2035500,5252908
1151,243,Dhebor Gohain Boruah,LAKHIMPUR,AITC,0,Graduate Professional,7878597,0,7878597
1152,1327,Dheeraj Puri,NEW DELHI,SHS,0,10th Pass,27148834,0,27148834
1153,7590,Dhevanathan Yadav.T.,TIRUNELVELI,Tamil Nadu Makkal Congress,1,Illiterate,323363744,30874899,292488845
1154,1426,Dhimati Vidya Kishor Bhimte,RAMTEK,Ambedkarite Party of India,0,Post Graduate,3902394,69000,3833394
1155,2362,Dhiraj Gurjar,JAIPUR RURAL,SP,0,Post Graduate,413290807,500000,412790807
1156,2535,Dhiraj Jaidev Gajbhiye,NAGPUR,IND,0,12th Pass,0,0,0
1157,2726,Dhirendra Kumar,NALANDA,Janvadi Party(Socialist),0,10th Pass,250000,0,250000
1158,1784,Dhirendra Nath Roy,JALPAIGURI,Amra Bangalee,0,Graduate,1360000,0,1360000
1159,950,Dhote Jambuwantrao Bapurao,YAVATMAL-WASHIM,AIFB,0,10th Pass,6545000,0,6545000
1160,543,Dhotre Sanjay Shyamrao,AKOLA,BJP,3,Graduate Professional,48501735,6928458,41573277
1161,1782,Dhritiman Roy,JALPAIGURI,Rashtriya Janadhikar Suraksha Party,0,8th Pass,182500,0,182500
1162,1064,Dhulappa Gundappa,GULBARGA,JD(S),0,Graduate Professional,7335800,0,7335800
1163,7470,Dhurai Raaj Subha,SIVAGANGA,DMK,0,Others,119200359,16880062,102320297
1164,3502,Digambar Alias Gabbar Sudam Sakat,HATKANANGLE,Bharipa Bahujan Mahasangh,0,5th Pass,547074,0,547074
1165,1564,Digvijay Singh,JABALPUR,Bhartiya Shakti Chetna Party,0,Post Graduate,67620000,0,67620000
1166,982,Dildar Hussain Beg,CHANDNI CHOWK,IND,0,12th Pass,946408,0,946408
1167,2829,Dileep Kumar Rajak,GIRIDIH,IND,0,Graduate,439561,46500,393061
1168,4805,Dileep Singh Bhuriya,RATLAM,BJP,0,10th Pass,12259882,0,12259882
1169,3976,Dileshwar Kamait,SUPAUL,JD(U),0,Post Graduate,17930142,0,17930142
1170,5984,Dilip Atmaram Dumada,PALGHAR,Bahujan Mukti Party,0,10th Pass,2024600,0,2024600
1171,5942,Dilip Bhausaheb Gaikwad,MUMBAI SOUTH CENTRAL,IND,0,Illiterate,6100,100,6000
1172,3984,Dilip Kumar Koshle,BILASPUR,IND,0,12th Pass,2764540,1150000,1614540
1173,1455,Dilip Narayan,NAGPUR,IND,0,Others,607658,0,607658
1174,625,Dilip Paswan,JAMUI,IND,0,10th Pass,1531232,0,1531232
1175,5890,Dilip Prabhakar Aloni,KALYAN,IND,1,Post Graduate,7600000,198000,7402000
1176,3298,Dilip Sarkar,JALPAIGURI,Bahujan Mukti Party,0,Graduate,1011000,0,1011000
1177,801,Dillip Kumar Tirkey,SUNDARGARH,BJD,0,Graduate,70158593,831924,69326669
1178,4411,Dimple Yadav,KANNAUJ,SP,0,Graduate,280516418,6917710,273598708
1179,4245,Dinesh,TONK-SAWAI MADHOPUR,AITC,0,10th Pass,1632000,0,1632000
1180,111,Dinesh Kashyap,BASTAR,BJP,1,Post Graduate,16108199,2191216,13916983
1181,1298,Dinesh Kumar,WEST DELHI,Akhand Bharat Samaj Party,0,10th Pass,7386000,252000,7134000
1182,556,Dinesh Kumar,KARAKAT,Bahujan Mukti Party,1,Doctorate,478500,0,478500
1183,3111,Dinesh Kumar,KHERI,Bahujan Mukti Party,0,10th Pass,180872,0,180872
1184,4253,Dinesh Kumar Gautam,AGRA,IND,2,12th Pass,526770,0,526770
1185,5373,Dinesh Kumar Singh Khusro Nikhil,BILASPUR,IND,0,10th Pass,72000,0,72000
1186,2854,Dinesh Mahato,JAMSHEDPUR,IND,0,12th Pass,5169920,0,5169920
1187,3474,Dinesh Mev,PALI,IND,0,5th Pass,1387500,0,1387500
1188,27,Dinesh Pal Singh,NORTH EAST DELHI,IND,0,8th Pass,6931000,0,6931000
1189,3629,Dinesh Pandurang Pawar,PUNE,IND,0,10th Pass,113500,0,113500
1190,7207,Dinesh Phulsing Rathod,MUMBAI NORTH CENTRAL,IND,0,10th Pass,2133000,0,2133000
1191,5130,Dinesh Saini,TONK-SAWAI MADHOPUR,Jai Maha Bharath Party,0,12th Pass,1581000,0,1581000
1192,7189,Dinesh Shah,MUMBAI NORTH,Sardar Vallabhbhai Patel Party,0,Graduate,31634182,0,31634182
1193,7452,Dineshkumar.G,TIRUCHIRAPPALLI,IND,0,Post Graduate,6379498,1773000,4606498
1194,4451,Dipak Kumar Borah,NOWGONG,AITC,0,Post Graduate,627023,0,627023
1195,311,Dipak Kumar Roy,COOCHBEHAR,AIFB,1,Post Graduate,2859128,195000,2664128
1196,4364,Dipak Singh,MALDAHA DAKSHIN,Rashtriya Janadhikar Suraksha Party,0,Graduate,1408500,0,1408500
1197,3549,Dipratna Prabhakarrao Nilangekar,LATUR,AAP,0,Post Graduate,2025000,26672,1998328
1198,2922,Divan Upendr Pratap Singh (Raja Sab),DAMOH,Bhartiya Shakti Chetna Party,0,12th Pass,8328072,312910,8015162
1199,2565,Divya Spandana Uruf Ramya,MANDYA,INC,0,12th Pass,28043931,5530653,22513278
1200,1008,Diwakar,KAIRANA,AITC,0,12th Pass,155543,0,155543
1201,4675,Diwakar Bairagi,DURG,IND,1,Post Graduate,3340000,34000,3306000
1202,1474,Diwakar Pendam,GADCHIROLI-CHIMUR,Bahujan Mukti Party,0,8th Pass,3850000,0,3850000
1203,5603,Dnyaneshwar Vitthal Amale,RAVER,AIFB,1,Graduate,1115000,783000,332000
1204,2158,Doddamani Prasad,BELLARY,CPI(ML)L,1,Graduate Professional,16043,0,16043
1205,3852,Dongare Milind Kashinath,BEED,Prabuddha Republican Party,1,Graduate Professional,30393000,300000,30093000
1206,1435,Dongre Ashok Namaji,RAMTEK,IND,0,5th Pass,980000,0,980000
1207,546,Dongre Priya Anil,AMRAVATI,IND,0,8th Pass,702059,0,702059
1208,6971,"Doraisamy, A.",COIMBATORE,Makkal Manadu Katchi,0,8th Pass,5000,0,5000
1209,7367,Doss. R,TIRUVALLUR,IND,0,8th Pass,145000,0,145000
1210,827,Dr Bansidhar Tripathy,ASKA,AITC,0,Doctorate,1991383,0,1991383
1211,5195,Dr Bhupesh Prakash Patil,DHULE,IND,0,Graduate Professional,450000,60000,390000
1212,4486,Dr Dilip Kumar Jaiswal,KISHANGANJ,BJP,0,Doctorate,32949581,5793000,27156581
1213,2980,Dr Govind Singh,MORENA,INC,1,Graduate Professional,69688035,3184026,66504009
1214,3453,Dr Jyoti Mirdha,NAGAUR,INC,0,Graduate Professional,582676804,230942000,351734804
1215,3350,Dr Kulamani Nayak,BHUBANESWAR,"Proutist Bloc, India",0,Doctorate,2024713,0,2024713
1216,841,Dr Rajesh Alias Ravi Vallyapur,BIJAPUR,IND,0,Graduate Professional,12208000,0,12208000
1217,2329,Dr Rajkumar Sharma,JHUNJHUNU,IND,4,Doctorate,4537299,0,4537299
1218,3119,Dr S T Hasan,MORADABAD,SP,0,Post Graduate,31217401,175000,31042401
1219,3188,Dr Safiq Ur Rahman Barq,SAMBHAL,SP,0,Graduate,12883691,0,12883691
1220,121,Dr Shankar Bidari,BAGALKOT,IND,0,Graduate,55962000,0,55962000
1221,4102,Dr. Aditya Langthasa,NOWGONG,AIUDF,0,Doctorate,5644731,301684,5343047
1222,4168,Dr. Anil Murmu,RAJMAHAL,JVM(P),1,Post Graduate,2986472,328617,2657855
1223,526,Dr. Arun Kr. Sarmah,KALIABOR,AGP,0,Doctorate,19515691,4850186,14665505
1224,2671,Dr. Arun Kumar,JAHANABAD,Rashtriya Lok Samta Party,1,Doctorate,38846631,1000000,37846631
1225,681,Dr. Arvind Kumar Singh,ALIGARH,BSP,0,Doctorate,41664986,6100000,35564986
1226,2708,Dr. Ashok Kumar Singh,MUNGER,SHS,0,Doctorate,2054194,0,2054194
1227,2287,Dr. Balkrishan Bawari,GANGANAGAR,AAP,0,Graduate Professional,3855000,1090000,2765000
1228,105,Dr. Banshilal Mahato,KORBA,BJP,0,Graduate Professional,72303762,382905,71920857
1229,192,Dr. Banuprakash.K,HASSAN,IND,1,Graduate Professional,244250,200000,44250
1230,5823,Dr. Bharati Pravin Pawar,DINDORI,NCP,0,Doctorate,143541254,173000,143368254
1231,1214,Dr. Bhola Singh,BULANDSHAHR,BJP,0,Graduate,12577537,0,12577537
1232,1102,Dr. C Mohan,KOLAR,IND,0,Graduate Professional,11910000,0,11910000
1233,2365,Dr. C.P. Joshi,JAIPUR RURAL,INC,0,Doctorate,54972948,1400000,53572948
1234,2567,Dr. C.S.Hanumanthappa,MANDYA,AAP,0,Post Graduate,6965000,0,6965000
1235,78,Dr. Debomoy Sanyal,DHUBRI,BJP,0,Post Graduate,18136679,150000,17986679
1236,1569,Dr. Dhai Akshar (Rakesh Sonkar),JABALPUR,IND,0,Graduate,620000,95000,525000
1237,3999,Dr. Dhirendra Kumar Raj,HAZARIBAGH,IND,0,Graduate Professional,43518730,0,43518730
1238,5158,Dr. Feroz Khan Murtuza Khan,AURANGABAD,IND,0,Doctorate,21375000,0,21375000
1239,928,Dr. Gajbe Rameshkumar Baburaoji,GADCHIROLI-CHIMUR,AAP,0,Post Graduate,9315000,69000,9246000
1240,6002,Dr. Ghone Adesh Yashwant,RAIGAD,Bahujan Mukti Party,0,Graduate Professional,3246908,31702,3215206
1241,2429,Dr. Girija Vyas,CHITTORGARH,INC,1,Doctorate,23585480,0,23585480
1242,3483,Dr. Gurumayum Tonsana Sharma,INNER MANIPUR,Manipur Democratic Peoples Front,0,Doctorate,7135000,0,7135000
1243,65,Dr. Harsh Vardhan,CHANDNI CHOWK,BJP,2,Post Graduate,28229308,1780492,26448816
1244,4184,Dr. Hemlata Jamuna Devi,DHAR,AAP,0,Post Graduate,70225022,0,70225022
1245,668,Dr. Himanshu Singh,MEERUT,AAP,3,Graduate Professional,9408585,0,9408585
1246,3481,Dr. Ibomcha Singh,INNER MANIPUR,AAP,0,Graduate Professional,497250,0,497250
1247,6917,Dr. J. Jayavardhan,CHENNAI SOUTH,AIADMK,0,Graduate Professional,33959072,10981100,22977972
1248,2778,Dr. Jitendra Singh,UDHAMPUR,BJP,0,Graduate Professional,38464932,11881,38453051
1249,3027,Dr. Kapin Ch. Boro,ALIPURDUARS,IND,0,Graduate,6782287,0,6782287
1250,3747,Dr. Kodur Venkatesh,BANGALORE SOUTH,IND,0,Doctorate,44213130,0,44213130
1251,4151,Dr. Krishna Chandra Singh Raj,DHANBAD,IND,0,Post Graduate,734500,0,734500
1252,464,Dr. Kshetra Pal Singh,FARIDABAD,IND,0,Graduate Professional,3280000,0,3280000
1253,280,Dr. M.V. Ibraheem,MALAPPURAM,IND,3,Graduate Professional,232700,0,232700
1254,1196,Dr. Meer Layaq Hussain,BANGALORE CENTRAL,IND,0,Graduate Professional,30000,0,30000
1255,1358,Dr. Nabhit Kapur,EAST DELHI,Naya Daur Party,0,Doctorate,150000,0,150000
1256,927,Dr. Namdeo Dalluji Usendi,GADCHIROLI-CHIMUR,INC,1,Post Graduate,14281020,9382799,4898221
1257,2432,Dr. Narendra Kumar Gupta,CHITTORGARH,AAP,0,Graduate Professional,10723839,484486,10239353
1258,4235,Dr. Naseem Chaudhary Alias Dr. Naseem Gujjar,DAUSA,IND,0,Graduate Professional,6309000,0,6309000
1259,3180,Dr. Nepal Singh,RAMPUR,BJP,0,Doctorate,27136042,1614820,25521222
1260,3225,Dr. Nepole Raghu Murmu,MAYURBHANJ,BJP,0,Doctorate,4573490,419980,4153510
1261,2355,Dr. Om Singh Meena,JAIPUR RURAL,IND,0,Post Graduate,19869123,800000,19069123
1262,3875,Dr. Owhal Jitendra Mahadev,BEED,IND,0,Graduate Professional,3438256,1572500,1865756
1263,3978,Dr. Pervez Ali Ahmed,BARPETA,AITC,0,Graduate Professional,327895738,1163236,326732502
1264,3749,Dr. Pradeep Gadugesh,BANGALORE SOUTH,IND,0,Graduate Professional,737397,185386,552011
1265,2527,Dr. Pradeep Rambhau Nagrale,NAGPUR,Ambedkarite Party of India,0,Graduate Professional,8052965,4637487,3415478
1266,3666,Dr. Prakash Shamrao Pawar,SATARA,IND,0,Graduate Professional,886693,0,886693
1267,1728,Dr. Rahul Dipankar,BULANDSHAHR,AAP,0,Post Graduate,74254557,10800000,63454557
1268,2025,Dr. Rajesh Mahendia,HISAR,IND,0,Doctorate,3298180,350000,2948180
1269,2764,Dr. Rakesh Datta Mishra,PATNA SAHIB,Bharatiya Jan Kranti Dal (Democratic),0,Post Graduate,149047,0,149047
1270,4482,Dr. Ram Prakash Mahto,KATIHAR,JD(U),5,Doctorate,11829625,1231046,10598579
1271,3596,Dr. Ramesh Subrav Bansode,OSMANABAD,Republican Party of India,0,Graduate,410000,176114,233886
1272,4778,Dr. Rameshsingh Solanki,KHANDWA,Prajatantrik Samadhan Party,0,Graduate,3800000,2375000,1425000
1273,4916,Dr. Ramshankar Katheria,AGRA,BJP,21,Doctorate,14634885,4035000,10599885
1274,3192,Dr. Rashid Ali,SAMBHAL,Peace Party,0,Post Graduate,6576936,0,6576936
1275,937,Dr. Sandeep Natthuji Nandeshwar,RAMTEK,Bharipa Bahujan Mahasangh,0,Post Graduate,302494,836870,-534376
1276,6006,Dr. Sanjay Yashwant Aparanti,RAIGAD,AAP,0,Post Graduate,16266714,2924885,13341829
1277,663,Dr. Sanjeev Kumar Balyan,MUZAFFARNAGAR,BJP,1,Doctorate,10794222,3090803,7703419
1278,672,Dr. Satyapal Singh,BAGHPAT,BJP,0,Doctorate,67402076,352000,67050076
1279,64,Dr. Shashi Tharoor,THIRUVANANTHAPURAM,INC,0,Doctorate,230275186,0,230275186
1280,3221,Dr. Sudarshan Lohar,KEONJHAR,Rashtriya Indepndent Morcha,0,Post Graduate,4627400,0,4627400
1281,1431,Dr. Sunilbhau Vishwanathji Narnavre,RAMTEK,Republican Party of India (Khobragade),0,Not Given,2760000,0,2760000
1282,1247,Dr. Suraj Mandal,KODARMA,Jharkhand Vikas Dal,2,Doctorate,7871582,700000,7171582
1283,2643,Dr. Surendra Kumar Prasad,ARRAH,AAP,0,Post Graduate,12314344,0,12314344
1284,5090,Dr. Suresh Jatav,BHARATPUR,INC,0,Post Graduate,35400729,1504711,33896018
1285,422,Dr. Sushil Indora,SIRSA,Haryana Janhit Congress (BL),0,Graduate Professional,31066422,28522,31037900
1286,2380,Dr. Tanmay Sharma,JAIPUR,Indian Peoples Green Party,0,Post Graduate,23869513,1000000,22869513
1287,1373,Dr. Tarun Kumar,CHANDNI CHOWK,Vishva Shakti Party,0,Graduate Professional,5518804,2334044,3184760
1288,3477,Dr. Thokchom Meinya,INNER MANIPUR,INC,0,Doctorate,3825200,0,3825200
1289,5608,Dr. Ulhas Vasudeo Patil,RAVER,IND,1,Doctorate,112059276,2043531,110015745
1290,3667,Dr. Vijaysinha Diliprao Patil,SATARA,IND,0,Graduate Professional,0,0,0
1291,3011,Dr. Virendra Kumar,TIKAMGARH,BJP,0,Doctorate,8764635,0,8764635
1292,2374,Dr. Virendra Singh,JAIPUR,AAP,0,Post Graduate,72141860,0,72141860
1293,434,Dr. Yudhbir Singh Khyalia,HISAR,AAP,0,Doctorate,23346340,7678981,15667359
1294,3582,Dr.Bhise Indrakumar Devrao,MADHA,IND,0,Graduate Professional,13265000,13550000,-285000
1295,7593,Dr.Ganesan.M,TIRUNELVELI,IND,0,Graduate Professional,10943691,0,10943691
1296,7249,Dr.Gavit Heena Vaijaykumar,NANDURBAR,BJP,0,Graduate Professional,131103963,7571753,123532210
1297,7568,Dr.Jayakumar.K.,TENKASI,INC,0,Doctorate,12385277,0,12385277
1298,1132,Dr.Kohapare Harshawardhan Muneshwar,BHANDARA-GONDIYA,Bahujan Mukti Party,0,Graduate Professional,980000,14000,966000
1299,7569,Dr.Krishnasamy.K.,TENKASI,Puthiya Tamilagam,2,Post Graduate,166640601,10238049,156402552
1300,1094,Dr.Meerlayaq Hussain,BANGALORE NORTH,IND,0,Graduate Professional,31000,0,31000
1301,5847,Dr.Mubeen Ahmad,JALGAON,IND,1,Others,22500,0,22500
1302,4769,Dr.Neha Sharma,INDORE,SP,0,Doctorate,12661316,0,12661316
1303,2853,Dr.Om Prakash Ananad,JAMSHEDPUR,IND,0,Post Graduate,2292704,559358,1733346
1304,3578,Dr.Pramod Ramchandra Gawade,MADHA,IND,0,Doctorate,498000,266676,231324
1305,2995,Dr.Prashant Tripathi,RAJGARH,AAP,1,Graduate Professional,11252908,3907073,7345835
1306,781,Dr.Rajendra Ramkrishna Gawai,AMRAVATI,RPI,0,Graduate Professional,38261507,0,38261507
1307,7571,Dr.Sadhan Thirumalaikumar.T.,TENKASI,MDMK,1,Graduate Professional,34406591,18526162,15880429
1308,5835,Dr.Satish Bhaskarrao Patil,JALGAON,NCP,1,Graduate,46486689,7296297,39190392
1309,2994,Dr.Shivnarayan Verma,RAJGARH,BSP,0,Graduate Professional,410000,0,410000
1310,5869,Dr.Shrikant Eknath Shinde,KALYAN,SHS,0,Graduate Professional,998000,0,998000
1311,850,Dr.Sridhar Udupa,DAVANAGERE,IND,0,Doctorate,918000,0,918000
1312,4650,Dr.Urmila Singh Marko,KORBA,Rashtriya Gondvana Party,0,Graduate,3213305,0,3213305
1313,3376,Dr.Vishwajeet Patangrao Kadam,PUNE,INC,0,Doctorate,874957697,204983496,669974201
1314,140,Drupad Borgohain,JORHAT,CPI,0,Graduate,1479690,0,1479690
1315,5424,Dubraj Singh Markam,SURGUJA,IND,0,12th Pass,103540,0,103540
1316,4119,Dujram Boudh,JANJGIR-CHAMPA,BSP,0,12th Pass,1249497,216000,1033497
1317,3829,Dulal Rajbanshi,RAIGANJ,SUCI(C),2,12th Pass,885667,266749,618918
1318,206,Duli Chand,KARNAL,Lok Parivartan Party(DC),0,Graduate Professional,4828000,290000,4538000
1319,2351,Duli Chand Kumawat,SIKAR,IND,0,Graduate,9036500,0,9036500
1320,2295,Dulichand Meghwal,GANGANAGAR,IND,0,5th Pass,6113000,0,6113000
1321,3446,Dungar Mal Puniya,JODHPUR,IND,0,10th Pass,3116000,0,3116000
1322,6889,Durai Babu. R,CHENNAI NORTH,IND,0,8th Pass,402800,0,402800
1323,7002,Duraisamy.A,ERODE,IND,0,5th Pass,19312,0,19312
1324,2874,Durga Munda,RANCHI,BSP,0,8th Pass,16842973,0,16842973
1325,379,Durga Thakur,AURANGABAD,IND,0,10th Pass,730000,0,730000
1326,1799,Durgesh Chandra Gautam,ALIGARH,AITC,0,Graduate Professional,5878725,0,5878725
1327,2744,Durgesh Nandan Singh,PATALIPUTRA,IND,0,Graduate Professional,3273000,0,3273000
1328,1294,Dushmanta Kumar Giri,SOUTH DELHI,IND,1,Doctorate,9500000,2720000,6780000
1329,2394,Dushyant,JHALAWAR-BARAN,BJP,0,Post Graduate,239006838,2798782,236208056
1330,201,Dushyant Chautala,HISAR,INLD,0,Graduate,361326990,68744460,292582530
1331,797,Dusmanta Kar,SAMBALPUR,IND,0,Graduate Professional,10000,0,10000
1332,5901,Dutt Priya Sunil,MUMBAI NORTH CENTRAL,INC,0,Graduate,655093802,33463408,621630394
1333,7230,Dv. Amarsen Baburao Babar,MUMBAI NORTH EAST,IND,0,Doctorate,2629000,1500000,1129000
1334,1597,Dwarka Prasad Pahade,CHHINDWARA,IND,0,12th Pass,1276700,0,1276700
1335,1891,E S Khaja Hussain,PALAKKAD,SDPI,2,10th Pass,6490438,35000,6455438
1336,279,E. Ahamed,MALAPPURAM,IUML,1,Graduate Professional,11818952,0,11818952
1337,273,E. T. Mohammed Basheer,PONNANI,IUML,0,12th Pass,13216259,0,13216259
1338,3724,E.Salam,BANGALORE CENTRAL,IND,0,5th Pass,200000,0,200000
1339,4303,E.V.K.S. Elangovan,TIRUPPUR,INC,3,Graduate,153853744,18850000,135003744
1340,7140,Easwaran . R,POLLACHI,IND,0,8th Pass,2391135,600000,1791135
1341,1920,Edappally Basheer,CHALAKUDY,IND,0,Graduate,4228516,2000000,2228516
1342,5431,Ediroli Manian G,TIRUVANNAMALAI,Pattali Makkal Katchi,0,Post Graduate,6695071,839500,5855571
1343,6328,Elanchezhian.S,DINDIGUL,AAP,0,Graduate Professional,10729709,0,10729709
1344,6267,"Elango, D.",ARAKKONAM,IND,0,8th Pass,400000,0,400000
1345,6268,"Elango, N.",ARAKKONAM,IND,0,8th Pass,260000,0,260000
1346,6257,"Elango, N.R",ARAKKONAM,DMK,0,Graduate Professional,43068404,1304056,41764348
1347,6269,"Elangovan, A.",ARAKKONAM,IND,0,8th Pass,400000,0,400000
1348,6270,"Elangovan, D.",ARAKKONAM,IND,0,10th Pass,747800,0,747800
1349,503,Elias Kujur,TEZPUR,IND,0,Graduate Professional,502074,0,502074
1350,1778,Eliash Narjinary,ALIPURDUARS,BSP,0,12th Pass,4236000,0,4236000
1351,2196,Eliya Kati,UTTARA KANNADA,Sarva Janata Party,0,12th Pass,6330,30000,-23670
1352,7592,Elizabeth.D,TIRUNELVELI,IND,0,8th Pass,3646910,0,3646910
1353,1217,Em. Narayanaswamy,KOLAR,BJP,0,Graduate,22377047,7984143,14392904
1354,1456,Eng. Sanjay Raghunath Nasare,BHANDARA-GONDIYA,BSP,0,Graduate Professional,8504878,511145,7993733
1355,4213,Engineear Bhagwat Singh Rajput,VIDISHA,AAP,0,Others,2513476,0,2513476
1356,3121,Engineer Mohammad Irfan,MORADABAD,Peace Party,0,Graduate Professional,25678455,828616,24849839
1357,4862,Entaz Ali,BARPETA,Lok Bharati,0,8th Pass,1200000,0,1200000
1358,1565,"Er. Pravin Gajbhiye \""Dada\""",JABALPUR,Bahujan Mukti Party,0,Graduate Professional,4462,0,4462
1359,4504,Er. Ramfal Mandrey,BILASPUR,Ambedkarite Party of India,0,Post Graduate,301500,0,301500
1360,2299,Er. Shankar Pannu,BIKANER,INC,0,Others,56245484,3791491,52453993
1361,746,Er. Vijay Kumar Kol,SHAHDOL,AAP,0,Post Graduate,180118,0,180118
1362,5211,Eshi Yogesh Yashwant,DHULE,BSP,0,10th Pass,1339900,0,1339900
1363,7404,"Eswaran, R.",VELLORE,IND,0,Illiterate,219000,0,219000
1364,7108,"Eswaran, T.",NILGIRIS,Makkal Manadu Katchi,0,8th Pass,10000,0,10000
1365,7134,Eswaran.E.R.,POLLACHI,BJP,0,Graduate Professional,283641697,146250595,137391102
1366,7446,Eswaran.J,TIRUCHIRAPPALLI,IND,0,12th Pass,41000,0,41000
1367,6952,"Ezhumalai, V",CHIDAMBARAM,Akhil Bharat Hindu Mahasabha,0,Literate,0,44500,-44500
1368,129,Faggan Singh Kulaste,MANDLA,BJP,2,Post Graduate,25738420,98311,25640109
1369,4750,Fagram,BETUL,Samajwadi Jan Parishad,0,5th Pass,216170,6000,210170
1370,4496,Fagu Marandi,PURNIA,Jharkhand Disom Party,1,Graduate,1151323,0,1151323
1371,2003,Fakir Chand,SIRSA,IND,0,8th Pass,438500,0,438500
1372,2498,Falguni Tripura,TRIPURA EAST,CPI(ML)L,0,12th Pass,3500,0,3500
1373,3038,Farhat Hasan,AMROHA,BSP,1,10th Pass,47354896,0,47354896
1374,2379,Farooq Khan,JAIPUR,BSP,0,5th Pass,13091000,0,13091000
1375,4881,Faruk Aahammed Bhuyan,GAUHATI,IND,1,Doctorate,875500,300000,575500
1376,4450,Faruk Hazarika,NOWGONG,IND,0,5th Pass,2408443,700000,1708443
1377,5971,Fasale Baban Namdev,NASHIK,IND,0,10th Pass,101000,0,101000
1378,7088,Fathima Alias Bharathi. R,MAYILADUTHURAI,IND,1,10th Pass,808518,190000,618518
1379,4125,Fatte Singh Shyam,KORBA,IND,0,Illiterate,10250700,702807,9547893
1380,211,Fauji Jai Kawar Tyagi Dixit,GURGAON,IND,0,8th Pass,42915552,0,42915552
1381,2223,Fayaz Ahamed Alias Mohammad Fayaz Ahamad,SHIMOGA,Sarva Janata Party,0,8th Pass,6884684,409000,6475684
1382,3319,Feroz Khan Gazi,NANDED,IND,0,12th Pass,3482000,0,3482000
1383,1482,Firaj Pathan,CHANDRAPUR,Bahujan Mukti Party,1,12th Pass,6370,62000,-55630
1384,3202,Firoj Haider,SAMBHAL,IND,0,Graduate,8301000,0,8301000
1385,7235,Firoz Ahmed Siddiqui,MUMBAI NORTH EAST,IND,0,8th Pass,1669355,0,1669355
1386,4840,Firoz Akhtar,MALDAHA DAKSHIN,Bahujan Mukti Party,0,Post Graduate,909008,1533677,-624669
1387,2786,Foolodevi Netam,KANKER,INC,0,12th Pass,4819534,0,4819534
1388,16,Fr.Stephen,THIRUVANANTHAPURAM,IND,2,Post Graduate,169587,181000,-11413
1389,7206,Francis Lawrence Fernandes,MUMBAI NORTH CENTRAL,IND,0,Graduate,15071413,0,15071413
1390,4483,Fulmani Hembram,KATIHAR,Bharat Vikas Morcha,0,8th Pass,753000,0,753000
1391,4165,Furkan Ansari,GODDA,INC,1,Graduate,21332923,1040000,20292923
1392,3802,G Anojirao,KOPPAL,IND,0,12th Pass,2101000,0,2101000
1393,602,G C Patel,DAVANAGERE,Sarva Janata Party,0,Graduate Professional,719300,0,719300
1394,2621,G C Venkataramanappa,CHIKKBALLAPUR,RPI(A),0,5th Pass,375000,0,375000
1395,3772,G N Ravi,CHIKKBALLAPUR,IND,0,Others,673700,50000,623700
1396,2156,G Nataraja,BELLARY,Karunaadu Party,0,Others,885000,0,885000
1397,853,G V Sreerama Reddy,CHIKKBALLAPUR,CPI(M),1,Graduate Professional,6720730,620000,6100730
1398,4036,G. Anandhan,VILUPPURAM,CPI(M),1,10th Pass,192800,21500,171300
1399,3731,G. Narayanaswamy (Kapali),BANGALORE CENTRAL,IND,0,10th Pass,8146501,0,8146501
1400,4058,G. Palani,PONDICHERRY,CPI(ML)L,0,10th Pass,1239728,90000,1149728
1401,5593,G. Sutha,PONDICHERRY,IND,0,10th Pass,1120900,0,1120900
1402,3752,G. Venkatesh Bhovi,BANGALORE SOUTH,IND,0,10th Pass,3532000,0,3532000
1403,4347,G.Balasubramanian,KARUR,IND,0,12th Pass,5889437,332804,5556633
1404,4287,G.Bojan,KALLAKURICHI,IND,0,8th Pass,422000,0,422000
1405,7495,G.Kannan,MADURAI,IND,0,Graduate,101000,0,101000
1406,1220,G.M. Siddeshwara,DAVANAGERE,BJP,0,10th Pass,232375703,17951455,214424248
1407,3992,G.M.Siddeshi,DAVANAGERE,IND,0,12th Pass,1501000,275000,1226000
1408,3842,G.Maria Joseph Xaviour,MADURAI,IND,0,Post Graduate,7492013,0,7492013
1409,3786,G.N.Venkatesh,KOLAR,IND,0,Graduate Professional,545000,80000,465000
1410,2568,G.Nagendra,TUMKUR,IND,0,10th Pass,275000,0,275000
1411,5110,G.R.Barua,KARAULI-DHOLPUR,BSP,0,Post Graduate,24397589,278400,24119189
1412,1087,G.S.Basavaraj,TUMKUR,BJP,0,Graduate Professional,275785995,67200540,208585455
1413,4061,G.Shanmugam,PONDICHERRY,IND,0,Others,5875000,0,5875000
1414,4753,Gabbar Sinh Warkade,BETUL,Bahujan Mukti Party,0,8th Pass,75000,0,75000
1415,1226,Gadkari Nitin Jairam,NAGPUR,BJP,4,Graduate Professional,153704475,19004037,134700438
1416,4791,Gaffar,KHARGONE,IND,0,Literate,525500,0,525500
1417,978,Gagan Rastogi,CHANDNI CHOWK,IND,0,Graduate,53919,0,53919
1418,2597,Gaikawad Rajendra Vitthal,YAVATMAL-WASHIM,IND,1,12th Pass,30250,0,30250
1419,5831,Gaikwad Abhijeet Kalyanrao,DINDORI,IND,0,Graduate Professional,200000,0,200000
1420,5598,Gaikwad Bhagwan Madhav,RAVER,Prabuddha Republican Party,0,Literate,50000,0,50000
1421,5934,Gaikwad Eknath Mahadeo,MUMBAI SOUTH CENTRAL,INC,0,10th Pass,24441410,2050000,22391410
1422,934,Gaikwad Mohan Ramrao,NAGPUR,BSP,0,Doctorate,47473922,33921023,13552899
1423,3598,Gaikwad Ravindra Vishwanath,OSMANABAD,SHS,8,Post Graduate,32852793,5962702,26890091
1424,3548,Gaikwad Sunil Baliram,LATUR,BJP,0,Doctorate,17463251,0,17463251
1425,3354,Gaikwad Texas Bhausaheb,MAVAL,BSP,0,Graduate Professional,38366000,0,38366000
1426,3599,Gaikwad Umaji Pandurang,OSMANABAD,IND,0,10th Pass,597,0,597
1427,5908,Gajanan Chandrakant Kirtikar,MUMBAI NORTH WEST,SHS,0,Graduate,58352000,2257000,56095000
1428,3561,Gajanan Pandurang Mane,LATUR,IND,0,Not Given,838628,0,838628
1429,1700,Gajendra,GAUTAM BUDHHA NAGAR,Indian Oceanic Party,0,Post Graduate,50000,0,50000
1430,2777,Gajendra Kumar,PATNA SAHIB,Sankhyanupati Bhagidari Party,0,Graduate,1575000,0,1575000
1431,3556,Gajendra Limbaji Avghade,LATUR,IND,0,12th Pass,761000,0,761000
1432,6272,"Gajendran, S.",ARAKKONAM,IND,0,12th Pass,152000,0,152000
1433,3438,Gajendrasingh Shekhawat,JODHPUR,BJP,0,Post Graduate,143491494,92198588,51292906
1434,1755,Gajresh Kumar,BIJNOR,IND,1,Graduate,266000,0,266000
1435,3492,Gandhi Dilipkumar Mansukhlal,AHMEDNAGAR,BJP,10,10th Pass,65316725,34176876,31139849
1436,7105,"Gandhi, P.",NILGIRIS,INC,0,Graduate,3575000,538000,3037000
1437,7069,Gandhi.Tvs,KRISHNAGIRI,IND,0,Graduate,35033,0,35033
1438,6323,Gandhirajan S,DINDIGUL,DMK,0,Graduate Professional,64318720,13001000,51317720
1439,5676,Gandhiselvan.S,NAMAKKAL,DMK,0,Post Graduate,33049195,800000,32249195
1440,6910,Ganesan S,CHENNAI SOUTH,SUCI(C),0,Graduate Professional,32901000,0,32901000
1441,7575,Ganesan.S.,TENKASI,IND,0,Post Graduate,185000,0,185000
1442,3016,Ganesh,TIKAMGARH,IND,0,5th Pass,20000,0,20000
1443,938,Ganesh Bapurao Patil,RAMTEK,GGP,0,5th Pass,5220000,20000,5200000
1444,5941,Ganesh Bhimrao Budhe,MUMBAI SOUTH CENTRAL,IND,0,12th Pass,60000,50000,10000
1445,4820,Ganesh Rajak,VIDISHA,Samata Party,0,12th Pass,560000,0,560000
1446,2761,Ganesh Shaw,PATNA SAHIB,BSP,0,Graduate,64000,52000,12000
1447,732,Ganesh Singh,SATNA,BJP,2,Post Graduate,37800000,0,37800000
1448,5374,Ganesh Yadav,BILASPUR,GGP,0,10th Pass,100500,0,100500
1449,2588,Ganesha,CHITRADURGA,IND,0,Not Given,115500,0,115500
1450,6348,Ganesha Murthi.A,ERODE,MDMK,1,Graduate,29856503,2512561,27343942
1451,6962,"Ganeshkumar, K.",COIMBATORE,DMK,0,Graduate Professional,12964091,222000,12742091
1452,5035,Ganga Charan,KANNAUJ,Rashtriya Kranti Party,0,Post Graduate,1538638,75000,1463638
1453,2771,Ganga Vishnu Prasadq,PATNA SAHIB,IND,0,Graduate Professional,6401308,0,6401308
1454,7405,"Gangadaran, K.",VELLORE,IND,0,Not Given,4009373,0,4009373
1455,2802,Gangadhar Patel,MAHASAMUND,IND,0,5th Pass,929000,0,929000
1456,178,Gangadhar S. Badiger,DHARWAD,SUCI(C),0,Graduate,60000,0,60000
1457,3877,Gangadhar Sitaram Kalkute,BEED,IND,0,Graduate,425000,0,425000
1458,7398,"Gangadharan, K.",VELLORE,Tamil Nadu Makkal Congress,0,10th Pass,167000,17500,149500
1459,4789,Gangaram Pratap,KHARGONE,Aadijan Mukti Sena,0,8th Pass,38287,0,38287
1460,194,Gangmumei Kamei,OUTER MANIPUR,BJP,0,Post Graduate,10656364,0,10656364
1461,4697,Ganpat Mahto,DHANBAD,IND,1,12th Pass,21327928,0,21327928
1462,124,Gaur Chandra Majumder,ANDAMAN & NICOBAR ISLANDS,BSP,0,Graduate,3192819,688689,2504130
1463,687,Gaurav,BIJNOR,AAP,0,Graduate Professional,28246000,24000000,4246000
1464,5255,Gaurav Kumar Ghosh,BHAGALPUR,National Tiger Party,0,12th Pass,8464037,250000,8214037
1465,2301,Gauri Shankar,BIKANER,AAP,0,Doctorate,2173200,300000,1873200
1466,2533,Gaus Mohammed Sheikh Ayyub Sheikh,NAGPUR,IND,0,10th Pass,50000,0,50000
1467,4707,Gautam Kumar Mahato,DHANBAD,IND,0,10th Pass,415157,2000,413157
1468,4864,Gautam Kumar Sarma,BARPETA,IND,0,Post Graduate,5276151,600000,4676151
1469,1581,Gautam Ramteke,BALAGHAT,Republican Party of India (Khobragade),0,12th Pass,2000,0,2000
1470,4367,Gautam Sarkar,MALDAHA UTTAR,SUCI(C),0,Post Graduate,327400,0,327400
1471,3915,Gautam Shinde,BHOPAL,Apna Dal,0,Graduate Professional,633000,0,633000
1472,5988,Gavari Shyam Anant,PALGHAR,BSP,0,12th Pass,150000,0,150000
1473,7248,Gavit Manikrao Hodlya,NANDURBAR,INC,2,5th Pass,51833563,271769,51561794
1474,1511,Gawali Bhavana Pundlikrao,YAVATMAL-WASHIM,SHS,4,Graduate,60886040,7368967,53517073
1475,3668,Gawde Sukhdev Bhanudas,SATARA,IND,0,10th Pass,2170000,0,2170000
1476,3259,Gayadhar Mallick,JAJPUR,Samata Kranti Dal,1,10th Pass,371500,0,371500
1477,5160,Gayake Sadashiv Ambadas,AURANGABAD,SP,4,Graduate Professional,12025302,227000,11798302
1478,5200,Gazi Atejad,DHULE,IND,0,10th Pass,33000,0,33000
1479,369,Geeta Arya,SASARAM,AAP,0,8th Pass,18756436,0,18756436
1480,2884,Geeta Kora,SINGHBHUM,Jai Bharat Samanta Party,1,Graduate,30267735,583602,29684133
1481,2947,Geeta Rajput,GWALIOR,Al-Hind Party,0,12th Pass,53000,0,53000
1482,3393,Geetaram Ramchandra Kadam,SHIRUR,Socialist Party (India),0,12th Pass,6423981,1100000,5323981
1483,5997,Geete Anant Gangaram,RAIGAD,SHS,0,10th Pass,44466487,23968087,20498400
1484,1190,Geetha Shivarajkumar,SHIMOGA,JD(S),0,Graduate,176721674,38712502,138009172
1485,638,George Mankidiyil,THIRUVANANTHAPURAM,IND,0,Graduate Professional,20103771,0,20103771
1486,7400,"George, V.A.",VELLORE,Bharatiya Dr. B.R.Ambedkar Janta Party,0,5th Pass,7850,0,7850
1487,7609,Germanus.S,TIRUNELVELI,IND,0,Post Graduate,1264010,0,1264010
1488,4686,Gh. Nabi Shah,ANANTNAG,SP,0,10th Pass,19939000,878970,19060030
1489,5109,Ghanshyam,KARAULI-DHOLPUR,AAP,0,10th Pass,2100191,100000,2000191
1490,4768,Ghanshyam Chandel,INDORE,IND,0,Graduate,3465000,220000,3245000
1491,1335,Ghanshyam Dass,NEW DELHI,IND,0,10th Pass,21043000,0,21043000
1492,1577,Ghanshyam Kudape,MANDLA,IND,0,10th Pass,1351051,0,1351051
1493,3357,Gharat Santosh Rohidas,MAVAL,Bahujan Mukti Party,0,8th Pass,11200149,780879,10419270
1494,1489,Ghaywan Roshan Jambuwantrao,CHANDRAPUR,Republican Party (Khoripa),0,Post Graduate,1921000,0,1921000
1495,5094,Ghisu Lal,BHARATPUR,IND,0,12th Pass,275000,0,275000
1496,3680,Gholap Sandeep Bhaskar,SHIRDI,IND,0,8th Pass,193600,0,193600
1497,555,Ghulam Kundanam,KARAKAT,AAP,1,Graduate Professional,623000,280800,342200
1498,670,Ghulam Mohammed,BAGHPAT,SP,0,Post Graduate,22108104,5678445,16429659
1499,2785,Ghulam Nabi Azad,UDHAMPUR,INC,0,Post Graduate,41389590,0,41389590
1500,3520,Ghunnar Prakash Vitthalrao,HINGOLI,IND,0,12th Pass,10572325,300000,10272325
1501,485,Ghuran Ram,PALAMAU,JVM(P),3,Graduate,14586699,1046647,13540052
1502,874,Gicho Kabak,ARUNACHAL WEST,NCP,0,10th Pass,400000,0,400000
1503,3017,Girdhari,TIKAMGARH,IND,0,12th Pass,1403342,0,1403342
1504,3897,Girdhari Lal,UDHAMPUR,Bharatiya Bahujan Party,0,Post Graduate,24920000,0,24920000
1505,1172,Giridhar Gamang,KORAPUT,INC,0,Graduate,5895460,2500000,3395460
1506,341,Girija Kumary,ATTINGAL,BJP,0,12th Pass,3279941,146000,3133941
1507,3297,Girindra Nath Barman,COOCHBEHAR,BSP,0,10th Pass,103000,0,103000
1508,149,Giriraj Singh,NAWADA,BJP,1,Graduate,50054771,0,50054771
1509,6879,Giriraj. D,CHENNAI NORTH,IND,0,5th Pass,3415000,0,3415000
1510,6865,Girirajan .R,CHENNAI NORTH,DMK,0,Not Given,46700792,7733259,38967533
1511,3148,Girish Chandra,NAGINA,BSP,1,Graduate,24839368,8097654,16741714
1512,1541,Girish Kumar Gautam,REWA,IND,0,Post Graduate,381000,0,381000
1513,2174,Girishgouda Channabasanagouda Bistanagoudar,HAVERI,IND,0,Graduate,6555,0,6555
1514,2941,Girraj Yadav,GUNA,IND,6,10th Pass,565000,0,565000
1515,4166,Gita Mandal,GODDA,CPI(ML)L,3,Graduate,1887379,0,1887379
1516,5690,Gnanapandithan.P,NAMAKKAL,RPI (A),0,Illiterate,146000,0,146000
1517,5961,Godse Hement Tukaram,NASHIK,SHS,1,12th Pass,83611067,23559648,60051419
1518,7167,Gokila .K,RAMANATHAPURAM,IND,0,Post Graduate,134022,240000,-105978
1519,4181,Gokul Prasad Dongre,DEWAS,BSP,1,Graduate,18675000,329980,18345020
1520,7187,Gondane Divakar Laxman,MUMBAI NORTH,Bharipa Bahujan Mahasangh,1,Graduate,4103000,0,4103000
1521,7168,Gopal .R,RAMANATHAPURAM,IND,0,Graduate,570000,0,570000
1522,2303,Gopal Balmiki,BIKANER,IND,0,10th Pass,1000,0,1000
1523,5896,Gopal Chinayya Shetty,MUMBAI NORTH,BJP,10,5th Pass,95617889,0,95617889
1524,5089,Gopal Paharia,BHARATPUR,AAP,1,Graduate,108894131,0,108894131
1525,2775,Gopal Prasad Sinha,PATNA SAHIB,JD(U),0,Post Graduate,59131851,0,59131851
1526,1159,Gopal Pujari,NABARANGPUR,Aama Odisha Party,1,10th Pass,100000,0,100000
1527,2649,Gopal Singh,ARRAH,IND,0,10th Pass,2410664,0,2410664
1528,2457,Gopal Singh Shekhawat,RAJSAMAND,INC,0,Graduate Professional,4157012,796727,3360285
1529,7094,Gopal. Dr. K,NAGAPATTINAM,AIADMK,0,Graduate Professional,19074709,13629120,5445589
1530,7106,"Gopalakrishnan, C.",NILGIRIS,AIADMK,0,Post Graduate,10941189,1224754,9716435
1531,3439,Goparam Meghwal,JODHPUR,BSP,0,5th Pass,8626500,0,8626500
1532,4876,Gopi Baruah,GAUHATI,Lok Bharati,0,8th Pass,670004,0,670004
1533,506,Gopi Chand Shahabadi,TEZPUR,AITC,0,Graduate,20624119,3437403,17186716
1534,4093,Gopi Nath Das,GAUHATI,AIUDF,0,Graduate,11382580,0,11382580
1535,6352,Gopi P,ERODE,INC,0,Literate,19406959,895121,18511838
1536,4265,Gopi Raman,AKBARPUR,JD(U),1,10th Pass,1899211,20295,1878916
1537,819,Gopinath Jani,NABARANGPUR,BSP,0,8th Pass,426659,37200,389459
1538,5634,Gopinath Sakharam Mhaske,THANE,Bharipa Bahujan Mahasangh,0,Illiterate,2045000,0,2045000
1539,6273,"Gopinathan, G.",ARAKKONAM,IND,0,Graduate,25686000,3020900,22665100
1540,282,Gopinathan.N,MALAPPURAM,IND,0,Post Graduate,2486000,201347,2284653
1541,7407,"Gopu, C.",VELLORE,IND,0,12th Pass,2500000,150000,2350000
1542,2324,Gordhan Sarswat,CHURU,AITC,0,Literate,500000,0,500000
1543,2448,Gotam Lal Meena,UDAIPUR,CPI(ML)L,1,5th Pass,141876,0,141876
1544,254,Gothra Moopan Nellikadan Kannan,KASARAGOD,IND,0,Not Given,240000,0,240000
1545,115,Gourav Gogoi,KALIABOR,INC,0,Post Graduate,5473199,1042133,4431066
1546,1791,Goutam Bhattacharya,DARJEELING,SUCI(C),0,10th Pass,1201800,0,1201800
1547,2250,Goutam Malakar,KARIMGANJ,IND,0,8th Pass,242000,0,242000
1548,1424,Goutam Shriram Wasnik,RAMTEK,IND,0,8th Pass,764000,0,764000
1549,3756,Govind,BIDAR,SP,0,10th Pass,43703163,2740661,40962502
1550,1990,Govind Gaude,SOUTH GOA,IND,4,Others,5478000,650000,4828000
1551,2423,Govind Kumar Bairwa,BHILWARA,BSP,0,8th Pass,2470000,0,2470000
1552,5135,Govind Prasad,TONK-SAWAI MADHOPUR,IND,0,8th Pass,265000,0,265000
1553,3000,Govind Singh Rajput,SAGAR,INC,1,Post Graduate,30758478,2458028,28300450
1554,5613,Govinda Narayan Gunjal,RAVER,IND,0,Graduate Professional,484400,0,484400
1555,7408,"Govindan, C.",VELLORE,IND,0,Illiterate,250000,0,250000
1556,4295,Govindaraju K,SALEM,IND,0,8th Pass,1745550,78214,1667336
1557,3295,Govindarju.G,TUMKUR,IND,0,10th Pass,3285000,50000,3235000
1558,3805,Govindhareddy Pacharalli,KOPPAL,IND,0,Graduate,120000,30000,90000
1559,7064,Gowda.Nsm,KRISHNAGIRI,JD(S),0,Graduate,682247,0,682247
1560,3946,Gowrimani.S,KARUR,IND,0,5th Pass,8750000,500000,8250000
1561,3303,Granthi Narendrasingh Anmolsingh,NANDED,AAP,0,Graduate,14385756,36503,14349253
1562,1713,Grisa Kumar,GAUTAM BUDHHA NAGAR,IND,0,8th Pass,828000,0,828000
1563,227,Gufran Ahamad,MUZAFFARNAGAR,IND,0,12th Pass,2054600,125000,1929600
1564,2431,Gulab Chand Sahlot,CHITTORGARH,IND,0,10th Pass,1087100,0,1087100
1565,2925,Gulab Khan,DAMOH,IND,0,Post Graduate,432000,0,432000
1566,2045,Gulab Singh,SONIPAT,POORVANCHAL RASHTRIYA CONGRESS,0,Graduate,53952000,0,53952000
1567,2456,Gulam Farid,RAJSAMAND,SP,0,8th Pass,858960,148000,710960
1568,2340,Gulam Nabi,SIKAR,BSP,0,12th Pass,6711505,293515,6417990
1569,589,Gulkirat Kaur Panag,CHANDIGARH,AAP,0,Post Graduate,129508000,2164000,127344000
1570,600,Gullihatty. D. Shekhar,CHITRADURGA,JD(S),1,Graduate,7903095,682408,7220687
1571,3620,Gulmir Khan,PARBHANI,BSP,2,8th Pass,270000,0,270000
1572,875,Gumjum Haider,ARUNACHAL WEST,AITC,0,Graduate,8808016,0,8808016
1573,7475,Gunasekaran P,SIVAGANGA,IND,0,10th Pass,0,0,0
1574,6999,Gunasekaran T.K,ERODE,United Communist Party of India,0,10th Pass,21195000,5200000,15995000
1575,7109,"Gunasekaran, K.",NILGIRIS,RPI(A),0,12th Pass,87000,0,87000
1576,7570,Gunasekaran.K.,TENKASI,Tamil Nadu Makkal Congress,0,10th Pass,123000,0,123000
1577,7082,Gunasekaran.N,MAYILADUTHURAI,IND,0,Graduate,55500,0,55500
1578,5670,Gunasekaran.S,NAMAKKAL,IND,4,8th Pass,480184,81600,398584
1579,7463,Gunasekaran.T,THANJAVUR,IND,0,Graduate,5050,0,5050
1580,3922,Gundesh Khambra,BHOPAL,IND,0,10th Pass,179000,0,179000
1581,511,Gunin Basumatari,JORHAT,SP,0,Graduate Professional,10322068,217200,10104868
1582,547,Gunwant Sudamrao Devpare,AMRAVATI,BSP,0,Others,209390631,23488366,185902265
1583,7209,Gupta Kanhaiyalal Rajaram,MUMBAI NORTH CENTRAL,IND,0,5th Pass,16996369,0,16996369
1584,2826,Gurjeet Singh,GIRIDIH,AAP,0,Post Graduate,3182920,237000,2945920
1585,1036,Gurmeet Singh,KURUKSHETRA,Lok Dal,0,Graduate,3125677,69000,3056677
1586,1498,Gurnule Ramesh Vithoba,YAVATMAL-WASHIM,IND,0,8th Pass,85000,530,84470
1587,878,Gursagar Singh,JAMMU,Socialistic Democratic Party,0,12th Pass,19540000,3350000,16190000
1588,3711,Guru Prasad Pradhan,DHENKANAL,IND,0,Graduate Professional,1157381,0,1157381
1589,1428,Gurudas Uddhav Bawane,RAMTEK,IND,0,12th Pass,3742000,820000,2922000
1590,2230,Gurudeva S H,UDUPI CHIKMAGALUR,AAP,0,Graduate Professional,6971500,250000,6721500
1591,2188,Gurushantappa Chalwadi,DHARWAD,RPI(A),0,10th Pass,320255,0,320255
1592,3757,Guruswamy B,CHAMARAJANAGAR,SP,0,Graduate Professional,11061200,995250,10065950
1593,791,Gyan Chand,BARGARH,BSP,0,5th Pass,7854072,0,7854072
1594,3765,H D Kumara Swamy,CHIKKBALLAPUR,JD(S),1,Graduate,1677777589,729603654,948173935
1595,2626,H N Ramakrishna Reddy,CHIKKBALLAPUR,Pyramid Party of India,0,10th Pass,2626000,674000,1952000
1596,3960,H Raja,SIVAGANGA,BJP,0,Graduate Professional,9313714,2094707,7219007
1597,2592,H. Siddagangappa,CHITRADURGA,Ambedkar National Congress,0,12th Pass,209000,1150000,-941000
1598,2225,H. Suresh Poojari,SHIMOGA,IND,0,5th Pass,26000,0,26000
1599,3400,H.B.P. Ajay Sahebrao Baraskar Maharaj,AHMEDNAGAR,Bahujan Mukti Party,2,12th Pass,11185018,442109,10742909
1600,2613,H.D. Devegowda,HASSAN,JD(S),0,Graduate Professional,42721242,8648283,34072959
1601,2614,H.D. Revanna,HASSAN,Karunaadu Party,0,10th Pass,483000,50000,433000
1602,2214,H.K. Kenchveerappa,DAVANAGERE,Vichara Jagruthi Congress Paksha,1,10th Pass,4359500,50000,4309500
1603,1003,H.K. Mahendru,NORTH EAST DELHI,IND,0,8th Pass,41985,0,41985
1604,2201,H.K. Ramachandrappa,DAVANAGERE,CPI,0,10th Pass,3180981,0,3180981
1605,2566,H.K.Krishna,MANDYA,Karunaadu Party,0,Graduate,390000,0,390000
1606,3736,H.L. Manjunatha,BANGALORE CENTRAL,Kannada Chalavali Vatal Paksha,0,12th Pass,6000,0,6000
1607,2576,H.L.Mohan Kumar,TUMKUR,Hindustan Janta Party,0,8th Pass,978000,400000,578000
1608,3792,H.N.Narayanaswamy,KOLAR,IND,0,10th Pass,335000,100000,235000
1609,6297,H.Senthilkumar,ARANI,IND,0,10th Pass,5287542,0,5287542
1610,3796,H.V.Anjappa,KOLAR,IND,0,Post Graduate,5141000,0,5141000
1611,951,Habung Payeng,ARUNACHAL WEST,AAP,0,Post Graduate,14587055,0,14587055
1612,847,Hadapad Basavaraj,UTTARA KANNADA,Rani Chennamma Party,1,12th Pass,410000,0,410000
1613,1284,Hafiz Mustaq,SOUTH DELHI,Jan Samanta Party,0,Illiterate,430000,0,430000
1614,7194,Haji Akhtar Paperwala,MUMBAI NORTH,IND,0,10th Pass,5401000,750000,4651000
1615,474,Haji Jainul Abedin,CHATRA,BSP,0,Graduate,15758303,0,15758303
1616,3123,Haji Mohd Yaqoob,MORADABAD,BSP,2,8th Pass,68484555,575735,67908820
1617,1910,Haji Moideen Shah,THRISSUR,JD(U),0,Others,2100000,0,2100000
1618,2903,Hakim Singh,BHIND,IND,0,10th Pass,741417,0,741417
1619,5051,Hakim Singh,MAINPURI,IND,0,12th Pass,18326297,0,18326297
1620,2175,Halappa Doddaneelappa Timmenahalli,HAVERI,BSP,0,Graduate,1080000,200000,880000
1621,5886,Hameed Mohammad Gulamhussain Sayyed,KALYAN,SP,0,8th Pass,76138101,15207081,60931020
1622,95,Hamid Khan,FARIDABAD,Hindustan Kranti Dal,0,Graduate,5219608,49608,5170000
1623,2603,Haneef Khan,DAKSHINA KANNADA,SDPI,0,10th Pass,1703900,0,1703900
1624,2107,Hanmant Krishna Majukar,BELGAUM,IND,0,10th Pass,12403000,0,12403000
1625,1841,Hanmanth Holer,BIJAPUR,IND,1,12th Pass,141500,0,141500
1626,4958,Hansh Mukhi,ETAWAH,INC,0,Post Graduate,11522942,0,11522942
1627,4949,Hanshraj Singh,ETAH,AAP,0,8th Pass,8515861,400000,8115861
1628,204,Hansraj,HISAR,IND,0,12th Pass,60000,0,60000
1629,2001,Hansraj Hansa,SIRSA,Jan Morcha,0,12th Pass,77000,0,77000
1630,1748,Hansraj Saini,SAHARANPUR,IND,0,Graduate Professional,3411840,42000,3369840
1631,3462,Hanuman Beniwal,NAGAUR,IND,1,Graduate Professional,3309739,0,3309739
1632,3457,Hanumanram,NAGAUR,AAP,0,Graduate Professional,3023141,80027,2943114
1633,598,Hanumantappa Kabbar,HAVERI,IND,0,Graduate,1600000,0,1600000
1634,2191,Hanumantappa Mallappa Bankapur,DHARWAD,JD(S),0,8th Pass,25257819,1710000,23547819
1635,3317,Hanumante Dhondopant Nagorao,NANDED,Rashtriya Kisan Congress Party,0,Post Graduate,1075000,26000,1049000
1636,3325,Hanumante Vijay Chandrao,NANDED,IND,0,8th Pass,86000,0,86000
1637,3070,Har Bhagwan,BADAUN,IND,0,Graduate,6395670,44625,6351045
1638,1303,Har Gobind Arora,WEST DELHI,SHS,1,12th Pass,6189246,0,6189246
1639,4651,Harbhajan Singh,KORBA,IND,0,12th Pass,1341613,0,1341613
1640,1771,Harekrishna Sarkar,COOCHBEHAR,RPI(A),0,Post Graduate,1562066,665800,896266
1641,3032,Harekrishna Sarkar,JALPAIGURI,RPI(A),0,Post Graduate,962066,665800,296266
1642,1888,Hari Arumbil,PALAKKAD,BSP,0,12th Pass,415000,80000,335000
1643,877,Hari Chand Jalmeria,JAMMU,JKNPP,0,Graduate Professional,4004437,500000,3504437
1644,3929,Hari G,ARAKKONAM,AIADMK,4,Post Graduate,32966706,0,32966706
1645,155,Hari Manjhi,GAYA,BJP,1,8th Pass,10184120,2000000,8184120
1646,2459,Hari Om Singh Rathore,RAJSAMAND,BJP,0,Graduate,188310824,2728752,185582072
1647,448,Hari Parkash,SONIPAT,SUCI(C),0,10th Pass,5588154,0,5588154
1648,5077,Hari Prasad,ALWAR,IND,0,Post Graduate,707938,0,707938
1649,5124,Hari Ram,TONK-SAWAI MADHOPUR,IND,0,Graduate,112200,0,112200
1650,5084,Hari Singh Sharma,ALWAR,IND,0,8th Pass,516000,0,516000
1651,2851,Hari Uraon,JAMSHEDPUR,IND,0,12th Pass,819405,122000,697405
1652,6262,"Hari, S.",ARAKKONAM,IND,0,10th Pass,422300,0,422300
1653,6263,"Hari, S.",ARAKKONAM,IND,0,10th Pass,233800,0,233800
1654,1781,Haribhakta Sardar,JALPAIGURI,SUCI(C),1,10th Pass,1048500,70,1048430
1655,5986,Haribhau Soma Vartha,PALGHAR,IND,0,5th Pass,758500,0,758500
1656,820,Harihara Karana,KANDHAMAL,INC,0,Post Graduate,96350411,269368,96081043
1657,6264,"Harikrishnan, P.",ARAKKONAM,IND,0,Not Given,100000,0,100000
1658,3120,Hariom,MORADABAD,Naya Daur Party,0,12th Pass,3270600,0,3270600
1659,973,Hariom Sharma,CHANDNI CHOWK,AITC,0,10th Pass,23010474,3391550,19618924
1660,3299,Haripada Barman,JALPAIGURI,Rashtriya Janasachetan Party,0,12th Pass,239580,0,239580
1661,518,Hariprasad Dihingia,LAKHIMPUR,AGP,2,10th Pass,80659606,1997168,78662438
1662,3463,Hariram,NAGAUR,IND,0,8th Pass,1420000,0,1420000
1663,3458,Hariram Mehrada,NAGAUR,Bahujan Sangharshh Dal,0,Post Graduate,480500,0,480500
1664,4237,Harish Chandra,DAUSA,BJP,0,Graduate,60394789,45000,60349789
1665,2473,Harish Chaudhary,BARMER,INC,0,Post Graduate,8822577,2407054,6415523
1666,2445,Harish Rawat,BANSWARA,AAP,0,10th Pass,1941143,0,1941143
1667,5189,Harishchandra Dattu Patil,BHIWANDI,IND,0,Graduate,4851734,975000,3876734
1668,1328,Harkrishan Das Nijhawan,NEW DELHI,IND,1,12th Pass,29194281,572550,28621731
1669,1370,Harsh Kumar,NORTH EAST DELHI,IND,0,Graduate Professional,466633,0,466633
1670,1726,Harveer,BULANDSHAHR,IND,0,12th Pass,608000,0,608000
1671,4959,Harvilas Doharey,ETAWAH,Bahujan Mukti Party,0,Graduate Professional,6492000,140000,6352000
1672,2169,Hasan Ali Sirquazi,HAVERI,AAP,0,Post Graduate,3439291,800000,2639291
1673,4086,Hasnein Raza,AMROHA,New All India Congress Party,1,5th Pass,588000,0,588000
1674,7229,Hayat Abdullah Shaikh,MUMBAI NORTH EAST,IUML,0,Illiterate,39907,0,39907
1675,2460,Heera Alias Heera Bhai Kathat,RAJSAMAND,IND,0,Literate,885000,50000,835000
1676,550,Hem Chandra Barman,COOCHBEHAR,BJP,0,12th Pass,5092000,1050000,4042000
1677,516,Hem Kanta Miri,LAKHIMPUR,SUCI(C),0,Graduate Professional,69500,0,69500
1678,3065,Hema Mehra,BADAUN,AAP,0,10th Pass,103368000,0,103368000
1679,837,Hemanand Biswal,SUNDARGARH,INC,0,12th Pass,20107728,1300000,18807728
1680,2080,Hemant Kumar Saini,GURGAON,Bahujan Mukti Party,0,10th Pass,15206538,1008079,14198459
1681,3903,Hemant Pradhan,MAHASAMUND,IND,0,8th Pass,219000,0,219000
1682,1166,Hemendra Chandra Singh,KANDHAMAL,BJD,2,Graduate,503907437,4786551,499120886
1683,4948,Hemendraveer Singh,ETAH,Sarva Samaj Kalyan Party,0,Post Graduate,143500,0,143500
1684,4421,Hemendraveer Singh,MATHURA,Sarva Samaj Kalyan Party,0,Post Graduate,143500,0,143500
1685,2792,Hemlal Markam,KANKER,GGP,1,Graduate,967000,0,967000
1686,4169,Hemlal Murmu,RAJMAHAL,BJP,0,Graduate,41894447,13010487,28883960
1687,4156,Hemlata S. Mohan,DHANBAD,AJSUP,0,Doctorate,30794844,2087939,28706905
1688,4756,Hemraj Singh,DEWAS,Bahujan Sangharshh Dal,0,Post Graduate,65000,0,65000
1689,4810,Henary,RATLAM,AAP,0,Graduate,107000,0,107000
1690,2286,Hetram,GANGANAGAR,Rajasthan Vikas Party,0,Literate,965000,80000,885000
1691,132,Hina Likhiram Kawre,BALAGHAT,INC,0,Post Graduate,4804487,0,4804487
1692,5016,Hira Lal Verma,HARDOI,AAP,0,Post Graduate,6019712,500000,5519712
1693,2949,Hiraday Narayan Singh Tomar,GWALIOR,Akhil Bharat Hindu Mahasabha,0,10th Pass,398500,0,398500
1694,4710,Hiralal Sankhwar,DHANBAD,Jharkhand Party,0,Post Graduate,3422500,0,3422500
1695,520,Hiramoni Deka Sonowal,LAKHIMPUR,AAP,0,Doctorate,192000,0,192000
1696,763,Hirasan Uikey,BALAGHAT,GGP,0,Graduate Professional,3765446,200000,3565446
1697,4653,Hirasingh Markam,KORBA,GGP,3,Post Graduate,700304,0,700304
1698,1769,Hitendra Das,COOCHBEHAR,IND,0,8th Pass,2546997,0,2546997
1699,3894,Hoke (Patil)Rajedra Achyutrao,BEED,IND,0,12th Pass,142000,60000,82000
1700,240,Horen Borgohain,JORHAT,AIFB,0,Post Graduate,3260000,800,3259200
1701,4622,Hori Lal Yadav,RAIPUR,IND,2,Illiterate,8064318,26318,8038000
1702,522,Hrishikesh Baruah,LAKHIMPUR,IND,0,Post Graduate,9000,0,9000
1703,655,Hukum Singh,KAIRANA,BJP,2,Graduate Professional,29078847,2941671,26137176
1704,3033,Humera Akhtar,AMROHA,SP,0,12th Pass,14344567,50000,14294567
1705,2545,Hunashyal Ravi,BAGALKOT,JD(S),0,Graduate,9950000,812000,9138000
1706,2557,Hunsur K Chandrashekar,MYSORE,Democratic Prajakranthi Party Secularist,1,Post Graduate,4106000,0,4106000
1707,5933,Hussain Akbar Sayyed,MUMBAI SOUTH CENTRAL,Bahujan Mukti Party,0,5th Pass,8871653,480000,8391653
1708,7080,Hyder Ali.S,MAYILADUTHURAI,Manithaneya Makkal Katchi,1,10th Pass,11248827,0,11248827
1709,5571,I. Senthilkumar,PONDICHERRY,IND,2,8th Pass,41165,0,41165
1710,2466,Idrish Mohammad,RAJSAMAND,Jago Party,0,8th Pass,2682000,0,2682000
1711,2391,Iftekar Qureshi,JAIPUR,AIFB,0,Literate,52100,0,52100
1712,2402,Ijyaraj Singh,KOTA,INC,0,Post Graduate,280354736,0,280354736
1713,4808,Iliyas Bhai Machar,RATLAM,Minorities Democratic Party,0,8th Pass,1213500,700000,513500
1714,1874,Illyas,MALAPPURAM,BSP,0,10th Pass,988156,44000,944156
1715,2184,Imamsab. Toragal.,DHARWAD,IND,0,10th Pass,80000,0,80000
1716,4972,Imamuddin Husain Husain,FARRUKHABAD,IND,0,10th Pass,2560296,0,2560296
1717,2996,Imamuddin Khan,RAJGARH,IND,0,Graduate,1882500,70000,1812500
1718,4368,Imanuyel Hemram,MALDAHA UTTAR,Jharkhand Disom Party,0,10th Pass,64000,0,64000
1719,2895,Imarti Devi,BHIND,INC,0,12th Pass,12751000,1989540,10761460
1720,7397,"Imdad Shariff, A.",VELLORE,AAP,0,Post Graduate,23968,0,23968
1721,4081,Imran,KHAJURAHO,Peace Party,0,Graduate,391000,0,391000
1722,559,Imran Ali,KARAKAT,IND,0,Graduate,7845,0,7845
1723,5039,Imran Bin Zafar,KANNAUJ,AAP,0,Graduate,1514000,250000,1264000
1724,684,Imran Masood,SAHARANPUR,INC,5,12th Pass,47166093,2012262,45153831
1725,4623,Imrram Pasha,RAIPUR,Aazadi Ka Antim Aandolan Dal,0,12th Pass,217878947,0,217878947
1726,3824,Imtiaz Ahmed Mollah,MALDAHA DAKSHIN,SDPI,0,12th Pass,74000,57000,17000
1727,3374,Imtiyaz Peerzade,PUNE,BSP,0,Graduate,83320451,7500000,75820451
1728,1309,Inder Singh,NORTH WEST DELHI,Asankhya Samaj Party,0,10th Pass,2437000,0,2437000
1729,1573,Inder Singh Uikey,MANDLA,Ambedkarite Party of India,0,12th Pass,195000,0,195000
1730,4468,Inderaj Singh Saini,BANKA,IND,0,10th Pass,11918305,2000000,9918305
1731,1046,Inderjit Singh,GURGAON,BJP,0,Graduate Professional,250698763,0,250698763
1732,3484,Indira Oinam,INNER MANIPUR,IND,0,Graduate,948604,0,948604
1733,390,Indra Deo Choudhary,GAYA,Bahujan Mukti Party,0,10th Pass,507000,10000,497000
1734,4471,Indradeo Kumar Singh,BHAGALPUR,IND,0,Graduate Professional,3312913,0,3312913
1735,740,Indrajeet Kumar,SIDHI,INC,0,Graduate,62690091,2494561,60195530
1736,2315,Indrasingh Jat,CHURU,CPI(M),0,Post Graduate,8543953,0,8543953
1737,2655,Indu Singh,BUXAR,CPI(ML)L,0,Graduate Professional,10215879,0,10215879
1738,542,Ingle Krushanarao Ganpatrao,BULDHANA,NCP,0,Graduate,63065868,25092634,37973234
1739,7514,"Iniyavan, R.",THENI,IND,1,12th Pass,152000,31456,120544
1740,7515,"Innasimuthu, M.S.",THENI,IND,0,8th Pass,480639,0,480639
1741,290,Innocent,CHALAKUDY,IND,0,8th Pass,54474761,1303000,53171761
1742,1637,Iqra Chaudhry,MEERUT,IND,0,Not Given,400000,0,400000
1743,3776,Irappa Bharamappa Madar,DHARWAD,BSP,0,10th Pass,585029,80000,505029
1744,2187,Irashadbegum. Adhoni.,DHARWAD,IND,0,10th Pass,36000,0,36000
1745,2930,Irfan Khan,DAMOH,IND,2,8th Pass,161000,0,161000
1746,3062,Irshad Ali Ansari,AONLA,Peace Party,0,Post Graduate,2979192,0,2979192
1747,7079,Irulappan.V,MAYILADUTHURAI,SP,0,Post Graduate,10526000,0,10526000
1748,4779,Isamuddin Saiyyed,KHANDWA,Samata Party,1,Literate,16436850,0,16436850
1749,551,Ishabela Kujur,ALIPURDUARS,Rashtriya Janadhikar Suraksha Party,0,Graduate,88500,0,88500
1750,5838,Ishwar Dayaram More,JALGAON,Bahujan Mukti Party,2,Graduate,5390000,0,5390000
1751,2543,Ishwar Lahanu Nandagawali,BHANDARA-GONDIYA,IND,0,10th Pass,111000,0,111000
1752,1020,Ishwar Singh,AMBALA,IND,0,5th Pass,6084400,37741,6046659
1753,4861,Ismail Hussain,BARPETA,INC,0,Post Graduate,18415063,0,18415063
1754,3737,Ismail Khan Saif Ali,BANGALORE CENTRAL,AITC,0,12th Pass,97238300,0,97238300
1755,281,Ismail P.,MALAPPURAM,Welfare Party Of India,0,Post Graduate,9524919,0,9524919
1756,2144,Ismail Zabi Ullah,BIDAR,IND,0,Graduate,76000,0,76000
1757,4802,Ismile,MANDSOUR,IND,0,5th Pass,30000,0,30000
1758,1308,Istak Khan,WEST DELHI,IND,0,5th Pass,300000,0,300000
1759,1057,Ivoryna Shylla,SHILLONG,IND,0,10th Pass,23050000,0,23050000
1760,2910,J C Barai,BHOPAL,SUCI(C),0,10th Pass,3397000,0,3397000
1761,2516,J Nataraju,BANGALORE RURAL,IND,0,10th Pass,1912959,330000,1582959
1762,347,J Sudhakaran,THIRUVANANTHAPURAM,BSP,0,Post Graduate,40695000,2000000,38695000
1763,6849,J. Constandine Ravindran,CHENNAI CENTRAL,DMDK,1,Post Graduate,8690436,2610881,6079555
1764,5589,J. Dhandapani,PONDICHERRY,IND,1,Post Graduate,2802323,270000,2532323
1765,6847,J. Prabhakar,CHENNAI CENTRAL,AAP,0,10th Pass,5085238,135000,4950238
1766,1092,J. T.Prakash,BANGALORE RURAL,IND,0,Graduate,4854168,0,4854168
1767,7423,J.Laxmi,TIRUPPUR,CPI(ML) Red Star,0,8th Pass,3788740,1181573,2607167
1768,7491,J.Manikandeswaran,MADURAI,IND,0,Post Graduate,488000,40000,448000
1769,6931,J.S. Mahalingam,CHENNAI SOUTH,IND,0,Graduate Professional,142321,0,142321
1770,3509,Jadhav Chunnilal Mohan,HINGOLI,BSP,0,Graduate Professional,8401100,0,8401100
1771,777,Jadhav Prataprao Ganpatrao,BULDHANA,SHS,2,12th Pass,36033147,684092,35349055
1772,5164,Jadhav Pushpa Shantilal,AURANGABAD,Ambedkar National Congress,0,Illiterate,294744,0,294744
1773,3621,Jadhav Sanjay (Bandu) Haribhau,PARBHANI,SHS,7,10th Pass,31016711,5976851,25039860
1774,3572,Jadhav Sunil Gunda,MADHA,IND,0,8th Pass,255987,0,255987
1775,5964,Jadhav Vishnu Ramdas,NASHIK,IND,0,5th Pass,663219,0,663219
1776,5209,Jafar Bapuji Pathan,DHULE,IND,0,Literate,1415000,0,1415000
1777,970,Jag Mohan Singh Bakshi,CHANDNI CHOWK,Atulya Bharat Party,0,12th Pass,60404560,4500000,55904560
1778,2654,Jagadanand Singh,BUXAR,RJD,0,Graduate Professional,20142620,0,20142620
1779,6972,"Jagadeeswaran, S.",COIMBATORE,Ulzaipali Makkal Katchy,0,10th Pass,161000,15000,146000
1780,3245,Jagannath Das,BALASORE,IND,0,Graduate,396000,0,396000
1781,1359,Jagannath Tiwari,EAST DELHI,IND,0,12th Pass,1476456,43236,1433220
1782,2815,Jagarnath Mahto,GIRIDIH,JMM,4,10th Pass,5992366,454475,5537891
1783,3224,Jagat Mohan Naik,KEONJHAR,BSP,0,10th Pass,170700,10000,160700
1784,7374,"Jagathrakshakan, S. Thiru",SRIPERUMBUDUR,DMK,0,10th Pass,780453455,47551938,732901517
1785,2047,Jagbir,SONIPAT,IND,0,8th Pass,415316,0,415316
1786,665,Jagbir Singh,MUZAFFARNAGAR,IND,0,Graduate Professional,19380034,1100000,18280034
1787,207,Jagbir Singh Malik,SONIPAT,INC,0,Graduate Professional,69917201,2154569,67762632
1788,2036,Jagbir Singh Rana,KARNAL,IND,0,Post Graduate,54297291,2759783,51537508
1789,5217,Jagdane Ramesh Soma,DHULE,Maharashtra Parivartan Sena (T),0,Literate,150000,0,150000
1790,2963,Jagdeesh Kumar Patel,KHAJURAHO,Apna Dal,0,12th Pass,11500,0,11500
1791,5165,Jagdip Vishwanath Shinde,AURANGABAD,IND,0,Graduate Professional,21000,0,21000
1792,3410,Jagdish,AJMER,BSP,0,10th Pass,3157459,0,3157459
1793,2035,Jagdish,KARNAL,IND,0,Illiterate,4778000,60000,4718000
1794,3467,Jagdish,PALI,Bahujan Mukti Party,0,5th Pass,1311000,0,1311000
1795,2002,Jagdish,SIRSA,IND,0,Graduate,759500,0,759500
1796,217,Jagdish Bhagwan Kadu,WARDHA,IND,0,Graduate Professional,15288413,3305000,11983413
1797,3896,Jagdish Kumar,UDHAMPUR,Jai Maha Bharath Party,0,5th Pass,880000,0,880000
1798,2305,Jagdish Kumar,BIKANER,IND,0,8th Pass,608500,0,608500
1799,2356,Jagdish Prasad,JAIPUR RURAL,Lok Dal,0,Literate,423000,0,423000
1800,5078,Jagdish Prasad Bairwa,ALWAR,IND,0,10th Pass,2659200,0,2659200
1801,4670,Jagdish Prasad Nirala,JANJGIR-CHAMPA,IND,0,8th Pass,175177,0,175177
1802,3184,Jagdish Saran Sagar,RAMPUR,IND,0,5th Pass,1705000,0,1705000
1803,734,Jagdish Singh,SATNA,AAP,2,Graduate,58152000,630000,57522000
1804,683,Jagdish Singh Rana,SAHARANPUR,BSP,0,Graduate,72148732,4290563,67858169
1805,3418,Jagdish Singh Rawat,AJMER,IND,0,5th Pass,520000,0,520000
1806,1375,Jagjeet Singh,CHANDNI CHOWK,Bharatiya Gaon Taj Dal,0,10th Pass,353200,0,353200
1807,3178,Jagmohan,RAMPUR,IND,0,8th Pass,3212000,0,3212000
1808,5139,Jagmohan,TONK-SAWAI MADHOPUR,National Peoples Party,0,Graduate,6059284,0,6059284
1809,3363,Jagtap Laxman Murlidhar,MAVAL,IND,0,8th Pass,87461,0,87461
1810,3358,Jagtap Laxman Pandurang,MAVAL,Peasants And Workers Party of India,3,10th Pass,63729286,2417066,61312220
1811,3364,Jagtap Laxman Sitaram,MAVAL,IND,0,5th Pass,2210100,0,2210100
1812,3571,Jagtap Nitin Maruti,MADHA,IND,0,8th Pass,470000,180000,290000
1813,5923,Jaheda Mohammad Haneef Shaikh,MUMBAI SOUTH,IND,0,8th Pass,5200000,0,5200000
1814,6926,Jahir Hussain. M,CHENNAI SOUTH,AAP,0,10th Pass,15040363,1332793,13707570
1815,208,Jai Karan,ROHTAK,SUCI(C),0,Post Graduate,15703701,0,15703701
1816,492,Jai Prakash Agarwal,NORTH EAST DELHI,INC,0,Graduate,83974848,0,83974848
1817,159,Jai Prakash Das,JAMUI,CPI(ML)L,0,8th Pass,143450,0,143450
1818,4118,Jai Prakash Nair,DURG,CPI(ML)L,0,12th Pass,299500,195000,104500
1819,2740,Jai Prakash Yadav,PATALIPUTRA,IND,0,Graduate Professional,1434000,0,1434000
1820,1352,Jai Ram Lal,EAST DELHI,JKNPP,0,10th Pass,4827000,15000,4812000
1821,4739,Jai Shankar Jha,GODDA,AAP,0,Post Graduate,2890000,187000,2703000
1822,2046,Jai Singh,SONIPAT,AAP,0,Post Graduate,246912638,12140161,234772477
1823,2058,Jai Singh,ROHTAK,IND,0,10th Pass,18187000,200000,17987000
1824,2938,Jaibhansingh Pawaiya,GUNA,BJP,1,Others,8860522,72000,8788522
1825,1249,Jaideo Choudhary,KODARMA,SP,2,10th Pass,4620269,28831,4591438
1826,5595,Jain Manish Ishwarlal,RAVER,NCP,7,Graduate,1515146765,606612400,908534365
1827,5615,Jain Manish Satish,RAVER,IND,1,10th Pass,24568000,698490,23869510
1828,5635,Jain Surendrakumar K.,THANE,Akhil Bharatiya Jan Sangh,0,10th Pass,4063705,0,4063705
1829,2507,Jain Wilson,THIRUVANANTHAPURAM,IND,0,Graduate,100000,0,100000
1830,421,Jaipal Bhatti,SIRSA,IND,0,5th Pass,2300000,0,2300000
1831,3136,Jaipal Singh Saini,MORADABAD,SHS,0,12th Pass,36898000,40000,36858000
1832,4467,Jaiprakash Narayan Yadav,BANKA,RJD,2,Post Graduate,27846274,791539,27054735
1833,6315,Jaishankar.P.,CUDDALORE,IND,0,5th Pass,805979,900000,-94021
1834,4506,Jait Ram Khande,BILASPUR,IND,0,5th Pass,10058052,0,10058052
1835,4006,Jaitun Tuti,KHUNTI,IND,0,10th Pass,100000,0,100000
1836,4964,Jaiveer Singh,FARRUKHABAD,BSP,1,12th Pass,108959677,12165446,96794231
1837,1658,Jaivindra Kumar,BAGHPAT,IND,0,Graduate,244000,0,244000
1838,1595,Jalasram Nagwanshi,CHHINDWARA,IND,0,12th Pass,268000,0,268000
1839,2817,Jaleshwar Mahato,GIRIDIH,JD(U),1,Graduate,24314128,1184627,23129501
1840,472,Jalley Sonam,ARUNACHAL WEST,PPA,0,10th Pass,4680000,0,4680000
1841,4763,Jameela Bee,INDORE,IND,0,5th Pass,986237,0,986237
1842,1939,James Joseph,IDUKKI,IND,0,10th Pass,375000,67000,308000
1843,1948,James Joseph P,KOTTAYAM,IND,0,12th Pass,10508400,0,10508400
1844,2789,Jamuna Mandavi,KANKER,Chhattisgarh Swabhiman Manch,0,Graduate,3321000,1065000,2256000
1845,7582,Janagar Raja,TENKASI,IND,0,Graduate Professional,2790001,450000,2340001
1846,1536,Janardan Mishra,REWA,IND,0,Graduate,151000,0,151000
1847,738,Janardan Mishra,REWA,BJP,0,Graduate Professional,10156568,106977,10049591
1848,2610,Janardhana Poojary,DAKSHINA KANNADA,INC,0,Graduate,5242284,0,5242284
1849,1086,Janardhana Swamy,CHITRADURGA,BJP,0,Post Graduate,19210602,0,19210602
1850,6870,Janarthanan .J,CHENNAI NORTH,BSP,0,Graduate Professional,4940000,0,4940000
1851,31,Jannat Jahan-Ul-Haq (Naina),CHANDIGARH,BSP,0,Graduate,11100000,500000,10600000
1852,3185,Jannat Nisha,RAMPUR,All India Minorities Front,0,Not Given,160344,0,160344
1853,7092,Jarina Begam. N,MAYILADUTHURAI,IND,0,8th Pass,710000,0,710000
1854,3557,Jaripatke Dnyanoba Sopanrao,LATUR,IND,0,Graduate,200000,0,200000
1855,499,Jarnail Singh,WEST DELHI,AAP,0,Post Graduate,11542391,222000,11320391
1856,1297,Jarnail Singh S/O Gurbax Singh,WEST DELHI,IND,0,8th Pass,5955021,0,5955021
1857,2276,Jarnail Singh S/O Rajinder Singh,WEST DELHI,IND,0,10th Pass,2457012,0,2457012
1858,890,Jasmer Singh,CHANDIGARH,IND,0,10th Pass,5355500,290000,5065500
1859,1914,Jasminsha,THRISSUR,IND,2,Others,569648,0,569648
1860,1031,Jasvinder,KURUKSHETRA,IND,0,5th Pass,1730088,0,1730088
1861,2293,Jasvinder Singh,GANGANAGAR,Jai Maha Bharath Party,0,Graduate,3192000,0,3192000
1862,2048,Jaswant,SONIPAT,IND,0,10th Pass,612000,108000,504000
1863,2478,Jaswant Singh,BARMER,IND,0,Graduate,120424990,0,120424990
1864,4943,Jaswant Singh,AKBARPUR,Bahujan Mukti Party,0,12th Pass,4063662,0,4063662
1865,1048,Jaswinder Singh,KARNAL,INLD,0,10th Pass,46436884,2562000,43874884
1866,4654,Jata Shankar Pandey,KORBA,IND,0,8th Pass,21288,0,21288
1867,2768,Jauhar Azad,PATNA SAHIB,Janta Dal Rashtravadi,0,12th Pass,560500,360000,200500
1868,3780,Javaraiah,HASSAN,IND,0,10th Pass,50000,0,50000
1869,2832,Javed Islam,HAZARIBAGH,CPI(ML)L,0,Graduate,2117600,50000,2067600
1870,3092,Javed Khan,BAREILLY,IND,3,Literate,135000,0,135000
1871,2399,Javed Khan,JHALAWAR-BARAN,Bharatiya Yuva Shakti,0,12th Pass,50200,0,50200
1872,7019,Jawahar J.,KANNIYAKUMARI,BSP,0,Post Graduate,655813,30000,625813
1873,5166,Jawaharlal Laxman Bhagure,AURANGABAD,IND,0,10th Pass,448217,0,448217
1874,4501,Jay Narayan Yadav,SUPAUL,CPI(ML)L,2,Graduate,4748598,45000,4703598
1875,5556,Jay Prakash,FIROZABAD,SHS,0,Graduate,590800,0,590800
1876,773,Jay Prakash Patel,HOSHANGABAD,GGP,0,10th Pass,3411000,400000,3011000
1877,688,Jaya Prada Nahata,BIJNOR,RLD,0,12th Pass,226399859,3931582,222468277
1878,2562,Jayachandra,MANDYA,Bahujan Mukti Party,0,10th Pass,1006729,0,1006729
1879,324,Jayachandran Sarasamma,ALAPPUZHA,IND,1,Post Graduate,1587262,600000,987262
1880,7361,Jayakumar. M,TIRUVALLUR,INC,0,Graduate Professional,25910841,2336172,23574669
1881,4422,Jayant Choudhary,MATHURA,RLD,0,Post Graduate,136934546,21586003,115348543
1882,4699,Jayant Pandey,DHANBAD,AIFB,0,Post Graduate,92500,0,92500
1883,2979,Jayant Singh Tomar,MORENA,Loktantrik Samajwadi Party,0,Post Graduate,3368500,0,3368500
1884,2835,Jayant Sinha,HAZARIBAGH,BJP,0,Post Graduate,556754579,86380600,470373979
1885,2259,Jayanta Mallick,SILCHAR,IND,1,Graduate,777174,43000,734174
1886,7395,Jayaprakash,VELLORE,BSP,0,Graduate Professional,1550000,0,1550000
1887,2233,Jayaprakash Hegde,UDUPI CHIKMAGALUR,INC,0,Graduate Professional,90305073,16640811,73664262
1888,3768,Jayaprakasha Yadav,CHIKKBALLAPUR,IND,0,10th Pass,51000,0,51000
1889,6313,Jayasankar.C.R,CUDDALORE,DMDK,0,Post Graduate,355033000,267451000,87582000
1890,3444,Jayda,JODHPUR,IND,0,Illiterate,200000,0,200000
1891,1254,Jayram Indwar,LOHARDAGA,BSP,0,12th Pass,1965000,0,1965000
1892,3540,Jeevan Alias C.A.Patil,KOLHAPUR,IND,0,Graduate,500000,0,500000
1893,4655,Jeevan Lal Rautel,KORBA,IND,0,8th Pass,2836042,0,2836042
1894,7558,Jegan. P,THOOTHUKKUDI,DMK,2,Post Graduate,92068468,6531204,85537264
1895,6985,"Jerlld Amalajothi, I.",COIMBATORE,IND,0,10th Pass,943000,0,943000
1896,3445,Jetharam Meghwal,JODHPUR,IND,0,8th Pass,765000,25000,740000
1897,3878,Jethlia Santoshbapu Mitthulal,BEED,IND,0,Post Graduate,970125,0,970125
1898,5167,Jevrikar Indrakumar Dnyanoba,AURANGABAD,BSP,0,Graduate,13071000,2200000,10871000
1899,7093,Jeyaprakash. B,MAYILADUTHURAI,IND,0,12th Pass,255043,0,255043
1900,7553,Jeyasingh Thiyagaraj Natterjee.J,THOOTHUKKUDI,AIADMK,0,Post Graduate,9822294,0,9822294
1901,1171,Jhina Hikaka,KORAPUT,BJD,0,Graduate,8800000,0,8800000
1902,3282,Jibesh Kishore Sundaray,CUTTACK,AITC,1,10th Pass,12814048,0,12814048
1903,1915,Jiju Cheenikkal,THRISSUR,IND,0,10th Pass,226394,400000,-173606
1904,3268,Jimuta Prasad Mishra,DHENKANAL,AAP,0,Post Graduate,3657868,0,3657868
1905,4678,Jinendra Ghritlahare,DURG,IND,0,12th Pass,3376000,50000,3326000
1906,533,Jinti Gogoi,KALIABOR,AAP,0,Graduate,42000,0,42000
1907,33,Jitan Ram Manjhi,GAYA,JD(U),0,Graduate,2360142,13109,2347033
1908,137,Jiten Gogoi,KALIABOR,IND,1,8th Pass,14407099,2700000,11707099
1909,1136,Jitendra Aadkuji Raut,BHANDARA-GONDIYA,Akhil Bhartiya Manavta Paksh,1,Graduate,76820,0,76820
1910,2497,Jitendra Choudhury,TRIPURA EAST,CPI(M),0,12th Pass,11322979,2030773,9292206
1911,5927,Jitendra Kamabhai Kataria,MUMBAI SOUTH,IND,0,Graduate,73000,0,73000
1912,2823,Jitendra Kumar,GIRIDIH,SP,0,Graduate,8029500,4000000,4029500
1913,4005,Jitendra Manki Alias Jitendra Prasad Manki,KHUNTI,IND,0,Graduate,6120000,65000,6055000
1914,4851,Jitendra Nath Halder,MURSHIDABAD,BSP,0,8th Pass,551000,0,551000
1915,4219,Jitendra Singh,ALWAR,INC,0,Graduate,111824330,4781367,107042963
1916,3058,Jitendra Singh,AONLA,Naitik Party,0,Post Graduate,1008091,0,1008091
1917,1817,Jitendra Subhash Nerle,CHIKKODI,IND,0,10th Pass,45500,0,45500
1918,4121,Jivan Bharati,JANJGIR-CHAMPA,IND,0,8th Pass,828000,0,828000
1919,1310,Jodhraj Paharia,NORTH WEST DELHI,IND,0,Illiterate,7221810,0,7221810
1920,7552,Joel. S,THOOTHUKKUDI,MDMK,4,Graduate Professional,15241542,26008,15215534
1921,245,Joganati Datta,TRIPURA WEST,IND,0,8th Pass,165000,0,165000
1922,3558,Jogdand Fakira Vaijnath,LATUR,IND,0,Graduate,27000,0,27000
1923,1555,Jogendra Singh,SHAHDOL,Bahujan Mukti Party,0,8th Pass,180411,0,180411
1924,4947,Jogendra Singh,ETAH,Mahan Dal,0,Graduate,4125422,0,4125422
1925,2883,John Miran Munda,SINGHBHUM,AIFB,3,12th Pass,600000,450000,150000
1926,7020,John Thangam D.,KANNIYAKUMARI,AIADMK,3,Graduate,61593668,1080000,60513668
1927,4452,Jonjonali Baruah,NOWGONG,INC,0,Graduate,41306996,9937766,31369230
1928,1260,Jorawar Ram,PALAMAU,JD(U),2,12th Pass,16525000,205000,16320000
1929,2858,Josai Mardi,JAMSHEDPUR,Rashtriya Deshaj Party,0,Graduate Professional,1246500,0,1246500
1930,7039,Jose Bilbin J.,KANNIYAKUMARI,IND,0,Graduate Professional,1660000,0,1660000
1931,11,Jose K Mani,KOTTAYAM,Kerala Congress (M),0,Post Graduate,26236371,0,26236371
1932,4133,Joseph Bara,RAIGARH,IND,0,12th Pass,2235000,75000,2160000
1933,6948,Joseph Gunasekar,CHENNAI SOUTH,IND,0,Graduate Professional,2325000,0,2325000
1934,1774,Joseph Munda,ALIPURDUARS,INC,0,Graduate,2312000,550000,1762000
1935,507,Joseph Toppo,TEZPUR,AGP,0,10th Pass,3289490,22904,3266586
1936,4159,Joshil Murmu,DUMKA,IND,0,Graduate,30672,0,30672
1937,7441,Jothi.P,TIRUCHIRAPPALLI,SP,0,Not Given,40391000,2050000,38341000
1938,7042,"Jothimani, S.",KARUR,INC,0,Post Graduate,4293910,258500,4035410
1939,2270,Joy Ram Engleng,AUTONOMOUS DISTRICT,BJP,0,10th Pass,22032158,5096806,16935352
1940,1944,Joyce George,IDUKKI,IND,0,10th Pass,1034810,0,1034810
1941,804,Jual Oram,SUNDARGARH,BJP,1,Others,24202170,0,24202170
1942,881,Jugal Kishore,JAMMU,BJP,0,10th Pass,26824308,300000,26524308
1943,1927,Juno John Baby,ERNAKULAM,IND,0,Others,934581,0,934581
1944,798,Justin Lugun,SUNDARGARH,SUCI(C),0,10th Pass,8092,0,8092
1945,702,Jyothish Perumpulickal,MAVELIKKARA,SDPI,0,12th Pass,101500,5400,96100
1946,4752,Jyoti Dhurve,BETUL,BJP,2,Post Graduate,26232000,1000000,25232000
1947,784,Jyoti Gajanan Makode,AMRAVATI,Ambedkarite Party of India,0,10th Pass,139000,0,139000
1948,2514,Jyoti Sanjay Dewkar,AMRAVATI,IND,0,10th Pass,216572,0,216572
1949,4792,Jyoti Sukhlal Gore,KHARGONE,CPI,1,8th Pass,1820400,0,1820400
1950,4173,Jyotin Soren,RAJMAHAL,CPI(M),1,Graduate,1901675,90000,1811675
1951,2933,Jyotiraditya M. Scindia,GUNA,INC,0,Post Graduate,330888751,795000,330093751
1952,2515,K A Mohan,BANGALORE RURAL,Kamarajar Deseeya Congress,0,5th Pass,1733000,0,1733000
1953,294,K Ambujakshan,CHALAKUDY,Welfare Party Of India,1,Post Graduate,2134142,82000,2052142
1954,1098,K Arkesh,CHIKKBALLAPUR,AAP,0,Post Graduate,30067157,750000,29317157
1955,1905,K Biju,ALATHUR,IND,3,8th Pass,73500,0,73500
1956,1930,K C Karthikeyan,ERNAKULAM,BSP,0,10th Pass,5180540,700000,4480540
1957,327,K C Venugopal,ALAPPUZHA,INC,0,Post Graduate,12856075,456010,12400065
1958,126,K H Muniyappa,KOLAR,INC,0,Graduate Professional,184663000,27863000,156800000
1959,1804,K K Ashokan,KASARAGOD,IND,0,10th Pass,5351775,517000,4834775
1960,293,K M Noordeen,CHALAKUDY,AAP,0,Graduate,158604311,0,158604311
1961,3801,K M Ranganathreddy,KOPPAL,SP,1,Graduate Professional,5500000,0,5500000
1962,1104,K Narendra Babu,KOLAR,IND,0,Post Graduate,200000,0,200000
1963,1868,K P Ratheesh,KOZHIKODE,AAP,0,Others,737252,45000,692252
1964,1337,K P Sankaran Menon,NEW DELHI,IND,0,Doctorate,182208649,0,182208649
1965,2157,K Raghavendra,BELLARY,Pyramid Party of India,1,10th Pass,20000,0,20000
1966,2625,K S Swamy,CHIKKBALLAPUR,IND,0,Graduate,1192500,0,1192500
1967,1903,K S Velayudhan,ALATHUR,IND,0,10th Pass,1211050,0,1211050
1968,1839,K Shivram,BIJAPUR,JD(S),0,Post Graduate,26203570,0,26203570
1969,177,K Somashekar,RAICHUR,SUCI(C),0,Graduate,3539,0,3539
1970,257,K Sudhakaran,KANNUR,INC,2,Post Graduate,21659467,1969997,19689470
1971,2278,K Sudhakaran (Kollon House),KANNUR,IND,0,Post Graduate,1898622,756505,1142117
1972,2279,K Sudhakaran (Sreeshylam),KANNUR,IND,0,12th Pass,414862,82500,332362
1973,2208,K Syed Zabiulla,DAVANAGERE,IND,0,12th Pass,627000,0,627000
1974,1083,K Yadava Shetty,DAKSHINA KANNADA,CPI(M),0,12th Pass,2135040,145000,1990040
1975,4034,K. Arasan,VILUPPURAM,IND,0,Illiterate,630000,0,630000
1976,334,K. Bhaskaran,KOLLAM,IND,1,Graduate,6313287,108453,6204834
1977,3934,K. Kamaraj,KALLAKURICHI,AIADMK,0,Post Graduate,35459256,544099,34915157
1978,3774,K. Kushala Bellare,DAKSHINA KANNADA,IND,0,Not Given,16329916,6500000,9829916
1979,6933,K. Mani,CHENNAI SOUTH,JD(U),0,5th Pass,2723000,0,2723000
1980,5570,K. Manjini,PONDICHERRY,IND,0,5th Pass,70000,0,70000
1981,4035,K. Muthayian,VILUPPURAM,DMK,0,Post Graduate,74251826,22432121,51819705
1982,4076,K. P. Kamte,GWALIOR,Bharatiya Rashtriya Mazdoor Dal,0,Illiterate,4500,0,4500
1983,5574,K. Ramadass,PONDICHERRY,IND,0,8th Pass,54823,0,54823
1984,3764,K. S. Srinivasmurthy,CHAMARAJANAGAR,CPI(ML) Red Star,0,Graduate,323207,0,323207
1985,3932,K. Sekar,KALLAKURICHI,IND,0,10th Pass,52000,0,52000
1986,830,K. Shyambabu Subudhi,BERHAMPUR,IND,0,12th Pass,16000000,0,16000000
1987,822,K. Shyambabu Subudhi,ASKA,IND,0,10th Pass,1660000,0,1660000
1988,473,K. V. Pusa,NAGALAND,INC,0,Graduate,15500000,0,15500000
1989,3957,K.Balasubramanian,CUDDALORE,CPI,0,Graduate,5998936,0,5998936
1990,5473,K.Desingu,VILUPPURAM,IND,0,8th Pass,395000,0,395000
1991,6295,K.Elumalai,ARANI,IND,0,10th Pass,490500,0,490500
1992,852,K.G. Sreedhar,SHIMOGA,AAP,0,Graduate,22283800,147575,22136225
1993,900,K.G.Das,ANDAMAN & NICOBAR ISLANDS,CPI(M),0,12th Pass,4221392,0,4221392
1994,3791,K.H.Madhusoodan,KOLAR,IND,0,12th Pass,235000,0,235000
1995,3840,K.K.Ramesh,MADURAI,IND,0,Post Graduate,315000,0,315000
1996,3838,K.Kalaimani,SIVAGANGA,Makkal Manadu Katchi,0,8th Pass,447413,200000,247413
1997,4283,K.Kaliyamurthy,VILUPPURAM,BSP,1,10th Pass,1150000,0,1150000
1998,3811,K.Mahadevappa,MANDYA,Bharatiya Dr. B.R.Ambedkar Janta Party,0,Graduate Professional,500,0,500
1999,6373,K.Mohammed Yasin,KALLAKURICHI,AAP,0,Others,2457180,312000,2145180
2000,6303,K.Moorthy,ARANI,IND,1,12th Pass,112000,0,112000
2001,3730,K.Murthy,BANGALORE CENTRAL,IND,0,10th Pass,80000,0,80000
2002,2607,K.N. Somashekar,DAKSHINA KANNADA,IND,0,Graduate,13036000,1915500,11120500
2003,276,K.Narayanan Master,PONNANI,BJP,1,12th Pass,10368303,1657088,8711215
2004,300,K.P. Sreesan,THRISSUR,BJP,1,12th Pass,4653270,0,4653270
2005,6911,K.R.Ramaswamy@Traffic Ramaswamy,CHENNAI SOUTH,IND,0,Others,29530,0,29530
2006,4330,K.Raja,MADURAI,Desiya Forward Bloc,2,8th Pass,6137145,1353026,4784119
2007,5464,K.Rajamanickam,VILUPPURAM,IND,0,12th Pass,212500,0,212500
2008,5475,K.Rani,VILUPPURAM,INC,0,Post Graduate,41275211,8973429,32301782
2009,6857,K.Raveendran,CHENNAI CENTRAL,IND,0,Graduate Professional,266500,0,266500
2010,7536,K.Samuvelraj,VIRUDHUNAGAR,CPI(M),1,12th Pass,711701,74000,637701
2011,7426,K.Senthilkumar,TIRUPPUR,IND,0,5th Pass,44100,0,44100
2012,3812,K.Shivananda,MANDYA,Hindustan Janta Party,0,10th Pass,260000,0,260000
2013,299,K.Sivaraman,THRISSUR,CPI(ML) Red star,1,10th Pass,3658000,0,3658000
2014,7538,K.Solairaj,VIRUDHUNAGAR,IND,0,10th Pass,51700,0,51700
2015,5471,K.Srinivasan,VILUPPURAM,IND,0,Literate,253000,0,253000
2016,4302,K.Subbarayan,TIRUPPUR,CPI,0,10th Pass,6836109,0,6836109
2017,7492,K.Thangapandi,MADURAI,IND,0,Illiterate,101000,0,101000
2018,2559,K.Udayakumar,MANDYA,IND,0,10th Pass,906000,0,906000
2019,5467,K.Umasankar,VILUPPURAM,DMDK,0,Post Graduate,11251249,1291251,9959998
2020,6,K.V. Thomas,ERNAKULAM,INC,0,Post Graduate,11848550,522352,11326198
2021,2573,K.V.Srinivas Kalkere,TUMKUR,IND,0,Graduate,90600,30000,60600
2022,4289,K.Vellaiyan,KALLAKURICHI,IND,0,5th Pass,2575000,295000,2280000
2023,6374,K.Vetrivel,KALLAKURICHI,IND,0,12th Pass,1003333,931833,71500
2024,77,Kabindra Purkayastha,SILCHAR,BJP,0,Post Graduate,6236945,130502,6106443
2025,5991,Kadam Ramesh Ramchandra,RAIGAD,Peasants And Workers Party of India,0,Graduate,15220472,0,15220472
2026,3669,Kadam Sagar Uttamrao,SATARA,IND,1,Graduate,150,0,150
2027,1721,Kadeem,GAUTAM BUDHHA NAGAR,IND,0,5th Pass,20300,0,20300
2028,1707,Kadir Khan Jaiswal,GAUTAM BUDHHA NAGAR,IND,0,8th Pass,1461000,0,1461000
2029,226,Kadir Rana,MUZAFFARNAGAR,BSP,5,Literate,135202262,24105110,111097152
2030,5609,Kadri Saniya Saiyed Ali,RAVER,IND,3,Others,5500000,2000000,3500000
2031,3735,Kadugudi Sonnappa,BANGALORE CENTRAL,RPI(A),0,10th Pass,4083633,546581,3537052
2032,4018,Kafilur Rahman,RANCHI,IND,0,Graduate Professional,920000,0,920000
2033,5168,Kailas Chandrabhan Dhengde,AURANGABAD,IND,0,10th Pass,17200,0,17200
2034,5830,Kailas Sakharam More,DINDORI,IND,0,10th Pass,2320084,0,2320084
2035,4201,Kailash Awasya,KHARGONE,AAP,2,Post Graduate,1687286,0,1687286
2036,2384,Kailash Chand Saini,JAIPUR,Hindustan Janta Party,0,8th Pass,16758886,0,16758886
2037,4790,Kailash Patel,KHARGONE,IND,0,12th Pass,5843000,0,5843000
2038,1176,Kailash Sabara,KORAPUT,Samata Kranti Dal,0,Graduate Professional,16000,0,16000
2039,4809,Kailash Vasuniya,RATLAM,Bahujan Mukti Party,0,Graduate,96342,0,96342
2040,3341,Kajale Pradip Mahadev,PARBHANI,IND,1,12th Pass,744277,0,744277
2041,3398,Kakade Kisan Yashwant,AHMEDNAGAR,BSP,0,10th Pass,403500,0,403500
2042,1790,Kakali Majumdar (Roy),DARJEELING,BSP,0,10th Pass,2895875,711396,2184479
2043,7619,Kakarwal Pratapsing Mahajan,JALNA,IND,0,Graduate,1671107,69052,1602055
2044,3600,Kakasaheb Baburao Rathod,OSMANABAD,IND,0,10th Pass,50000,100000,-50000
2045,7104,"Kala, M.",NILGIRIS,BSP,0,Post Graduate,196000,0,196000
2046,5678,Kalaivanan.M,NAMAKKAL,JD(S),0,Graduate Professional,1158000,0,1158000
2047,3267,Kalakar Naik,DHENKANAL,Ambedkarite Party of India,0,12th Pass,2140000,0,2140000
2048,3256,Kalandi Mallick,JAJPUR,AAP,0,12th Pass,225518,0,225518
2049,6968,"Kalapirar Kuppusamy, C.",COIMBATORE,CPI(ML) Red Star,0,8th Pass,2000,0,2000
2050,3876,Kale Bajirao Shankar,BEED,IND,0,10th Pass,755000,0,755000
2051,3851,Kale Krishna Bhanudas,BEED,Bharipa Bahujan Mahasangh,0,Graduate Professional,936000,52000,884000
2052,829,Kali Charana Nayak,ASKA,IND,0,5th Pass,255213,0,255213
2053,2864,Kalicharan Munda,KHUNTI,INC,0,12th Pass,4069525,31895,4037630
2054,807,Kalikesh Narayan Singh Deo,BOLANGIR,BJD,3,Graduate,87955818,24410449,63545369
2055,5926,Kalim Khurshid Baig Mirza,MUMBAI SOUTH,The Lok Party of India,0,5th Pass,170000,0,170000
2056,5586,Kaliyamurthy,PONDICHERRY,IND,0,10th Pass,72814,30000,42814
2057,2132,Kallalinga,BIDAR,IND,0,Graduate,6241000,830000,5411000
2058,4175,Kallushing Kumre,BETUL,GGP,0,12th Pass,612000,20000,592000
2059,4627,Kamaaluddin,RAIPUR,IND,0,8th Pass,441000,0,441000
2060,85,Kamakhya Prasad Tasa,JORHAT,BJP,0,Post Graduate,1694785,0,1694785
2061,1757,Kamal,BIJNOR,IND,0,5th Pass,1606593,0,1606593
2062,1275,Kamal Chand Arya,FARIDABAD,Bahujan Mukti Party,0,Graduate Professional,36090683,0,36090683
2063,2267,Kamal Das,SILCHAR,IND,0,5th Pass,900802,0,900802
2064,4129,Kamal Dev,KORBA,Bhartiya Shakti Chetna Party,0,8th Pass,322410,27508,294902
2065,162,Kamal Kanti Debnath,TRIPURA WEST,IND,0,10th Pass,2569416,414150,2155266
2066,3094,Kamal Kishor Engineer,BAREILLY,IND,0,Graduate,2967000,500000,2467000
2067,1772,Kamal Krishna Bairagi,COOCHBEHAR,Rashtriya Janadhikar Suraksha Party,0,10th Pass,138800,0,138800
2068,4249,Kamal Kumar Dhobi,TONK-SAWAI MADHOPUR,IND,0,Literate,70000,0,70000
2069,2359,Kamal Kumar Gaur,JAIPUR RURAL,IND,0,12th Pass,10180000,3002800,7177200
2070,766,Kamal Nath,CHHINDWARA,INC,0,Graduate,2069080434,51172087,2017908347
2071,4180,Kamal Singh,DEWAS,Prajatantrik Samadhan Party,0,Post Graduate,2604000,0,2604000
2072,4241,Kamal Singh,KARAULI-DHOLPUR,AITC,0,8th Pass,637000,0,637000
2073,4859,Kamal Uddin,BARPETA,IND,0,Literate,152836,0,152836
2074,7531,Kamalavel Selvan,VIRUDHUNAGAR,BSP,1,Graduate Professional,1529881,46496,1483385
2075,102,Kamalbhan Singh,SURGUJA,BJP,0,Post Graduate,24773173,2995985,21777188
2076,3130,Kamar Alam,MORADABAD,Indian Bahujan Samajwadi Party,0,12th Pass,1784350,0,1784350
2077,7027,Kamaraj G.,KANNIYAKUMARI,IND,0,Graduate Professional,2871000,0,2871000
2078,7026,Kamaraj K.,KANNIYAKUMARI,IND,0,10th Pass,2323400,300000,2023400
2079,5427,Kamaraj M,TIRUVANNAMALAI,IND,0,5th Pass,507000,0,507000
2080,6360,Kamaraj. R,KALLAKURICHI,IND,0,10th Pass,268440,0,268440
2081,3828,Kamarujjaman Khandekar,MURSHIDABAD,SUCI(C),0,12th Pass,777500,0,777500
2082,5904,Kamat Gurudas Vasant,MUMBAI NORTH WEST,INC,0,Graduate Professional,488871453,0,488871453
2083,544,Kamble Bhanudas Chokoba,AKOLA,BSP,0,12th Pass,4607000,0,4607000
2084,3497,Kamble Chandrakant Tukaram,HATKANANGLE,BSP,0,10th Pass,30000,0,30000
2085,3534,Kamble Dayanand Vasant,KOLHAPUR,Bahujan Mukti Party,0,Graduate Professional,189918,10000,179918
2086,3546,Kamble Deepak Arvind,LATUR,BSP,0,12th Pass,3326994,0,3326994
2087,3555,Kamble Milind Haribhau,LATUR,IND,0,10th Pass,1000,0,1000
2088,3539,Kamble Sukumar Dattu,KOLHAPUR,IND,0,Post Graduate,275000,0,275000
2089,3503,Kamble Sukumar Dattu,HATKANANGLE,IND,0,Post Graduate,275000,0,275000
2090,2579,Kamble Uttam Bhagaji,YAVATMAL-WASHIM,Prabuddha Republican Party,0,Post Graduate,0,0,0
2091,487,Kameshwar Baitha,PALAMAU,AITC,48,10th Pass,1808000,0,1808000
2092,3977,Kameshwar Chaupal,SUPAUL,BJP,1,Post Graduate,41372252,12909,41359343
2093,1311,Kamini Kaur,NORTH WEST DELHI,IND,0,8th Pass,233096000,0,233096000
2094,231,Kamlesh,BULANDSHAHR,SP,1,5th Pass,7593541,0,7593541
2095,3009,Kamlesh Kumar,TIKAMGARH,INC,0,Doctorate,329992919,84598565,245394354
2096,4823,Kamlesh Sallam,VIDISHA,GGP,0,5th Pass,620000,0,620000
2097,2806,Kamleshwar Verma,RAJNANDGAON,INC,1,Graduate,21111998,236375,20875623
2098,2700,Kamleshwari Mandal,MUNGER,BSP,0,Others,3065084,0,3065084
2099,5638,Kamrujjama Kutubali Meenai,THANE,Peace Party,0,Post Graduate,3923999,0,3923999
2100,3845,Kanabur Sadashiv  Sidamallappa,BAGALKOT,JD(U),0,Graduate Professional,15493504,2229492,13264012
2101,6977,"Kanagasabapathy, G.",COIMBATORE,IND,0,5th Pass,19500,0,19500
2102,5116,Kanchan Bai,KARAULI-DHOLPUR,IND,0,Illiterate,45000,0,45000
2103,641,Kanchan Kumari,KODARMA,IND,0,12th Pass,5980857,85000,5895857
2104,4293,Kandasamy R,SALEM,IND,0,10th Pass,31000,0,31000
2105,5259,Kanhai Mandal,KATIHAR,IND,0,8th Pass,579677,0,579677
2106,2795,Kanhaiya Sahu,MAHASAMUND,BSP,0,Graduate,42374312,120000,42254312
2107,3473,Kanhaiyalal Pareek,PALI,IND,0,Graduate,5021340,2182277,2839063
2108,2350,Kanhaylal,SIKAR,IND,0,10th Pass,328500,0,328500
2109,7547,Kannan,VIRUDHUNAGAR,IND,0,5th Pass,555776,0,555776
2110,7565,Kannan,TENKASI,BSP,0,Post Graduate,286788,0,286788
2111,7357,"Kannan, A.S.",TIRUVALLUR,CPI,0,10th Pass,29177341,1600000,27577341
2112,7048,"Kannan, P.",KARUR,IND,0,8th Pass,3500,0,3500
2113,7516,"Kannan, S.",THENI,IND,0,Graduate,2839263,300000,2539263
2114,7047,"Kannan, S.",KARUR,IND,2,12th Pass,140340,0,140340
2115,7165,Kannathasan .R,RAMANATHAPURAM,IND,0,10th Pass,20000,0,20000
2116,1994,Kanta,KURUKSHETRA,Indian Bahujan Sandesh Party (Kanshiram),1,10th Pass,34224262,26405000,7819262
2117,6934,Kanthavel D,CHENNAI SOUTH,IND,0,8th Pass,246000,0,246000
2118,552,Kanti Singh,KARAKAT,RJD,4,Graduate,60390021,337826,60052195
2119,4205,Kantilal Bhuriya,RATLAM,INC,1,Graduate Professional,47510241,0,47510241
2120,654,Kanwar Hasan,KAIRANA,BSP,0,Post Graduate,37686620,245671,37440949
2121,3037,Kanwar Singh Tanwar,AMROHA,BJP,0,5th Pass,1788430770,4036151,1784394619
2122,386,Kapil Choudhary,GAYA,AITC,0,12th Pass,1606000,0,1606000
2123,7196,Kapil Kantilal Soni,MUMBAI NORTH,IND,0,Post Graduate,1484092,0,1484092
2124,5185,Kapil Moreshwar Patil,BHIWANDI,BJP,0,Graduate,363758831,10697367,353061464
2125,491,Kapil Sibal,CHANDNI CHOWK,INC,0,Graduate Professional,1144747216,0,1144747216
2126,408,Kapoor Singh,AMBALA,BSP,0,Doctorate,32373100,3483000,28890100
2127,1300,Karam Chand Lathwal,WEST DELHI,Bhartiya Pragatisheel Congress,0,Post Graduate,28936843,0,28936843
2128,5226,Karan Burman Gareeb,DHAR,Samata Samadhan Party,0,12th Pass,60727,35000,25727
2129,92,Karan Singh,ROHTAK,IND,0,10th Pass,12226000,162000,12064000
2130,210,Karan Singh,GURGAON,IND,0,Graduate,58279661,2735214,55544447
2131,7618,Karande Ganesh Navnathrao,JALNA,IND,0,Post Graduate,2040000,970000,1070000
2132,2863,Karia Munda,KHUNTI,BJP,0,Post Graduate,7474796,0,7474796
2133,144,Karra Parasu Ramaiah,SASARAM,JD(U),1,Doctorate,24500404,1672000,22828404
2134,2010,Kartar Singh,HISAR,IND,0,Graduate,36950500,0,36950500
2135,2282,Kartar Singh Bains,GANGANAGAR,AITC,0,Post Graduate,3180703,0,3180703
2136,1610,Kartar Singh Bhadana,KAIRANA,RLD,1,8th Pass,334053064,2555000,331498064
2137,7526,"Karthigaisamy, P.",VIRUDHUNAGAR,CPI(ML) Red Star,1,5th Pass,1637904,0,1637904
2138,7474,Karthikarajan T,SIVAGANGA,IND,0,10th Pass,603600,0,603600
2139,7143,Karthikeyan. Pon,POLLACHI,IND,0,12th Pass,11346000,0,11346000
2140,7468,Karti P Chidambaram,SIVAGANGA,INC,0,Graduate Professional,596685048,92587423,504097625
2141,1488,Kartik Gajanan Kodape,CHANDRAPUR,IND,0,Others,190000,0,190000
2142,2828,Kartik Mahto,GIRIDIH,BSP,3,10th Pass,12176000,2000000,10176000
2143,3243,Kartikeswar Patra,BALASORE,AITC,1,Not Given,4365951,0,4365951
2144,3982,Karuna Shukla,BILASPUR,INC,0,Post Graduate,30261209,1673200,28588009
2145,1806,Karunakaran Kalippurayil,KASARAGOD,IND,0,10th Pass,4514183,0,4514183
2146,7517,"Karuppiah, R.",THENI,IND,0,Literate,3946522,0,3946522
2147,4868,Kashem Ali Akonda,DHUBRI,IND,0,12th Pass,7590000,2150000,5440000
2148,5987,Kashinath Laxman Kokera,PALGHAR,IND,0,8th Pass,2286452,400000,1886452
2149,4195,Kashinath Upadhyay,KHANDWA,IND,0,Graduate,3182000,0,3182000
2150,3005,Kashiram Patel,SAGAR,GGP,0,Graduate,100500,0,100500
2151,4871,Kasir Uddin Sk.,DHUBRI,IUML,0,12th Pass,2746500,16000,2730500
2152,7166,Kasirajan .N,RAMANATHAPURAM,IND,0,5th Pass,770000,1000000,-230000
2153,1207,Kathavaraya,CHAMARAJANAGAR,Dr. Ambedkar Samajvadi Democratic Party,0,10th Pass,1315000,520000,795000
2154,7141,Kathiravan. K,POLLACHI,IND,0,Post Graduate,522,0,522
2155,7142,Kathiresan. L,POLLACHI,IND,0,Post Graduate,5377000,300000,5077000
2156,3687,Katore Mahadev Niwritti,SHIRUR,IND,0,Graduate,1052914,0,1052914
2157,2727,Kaushal Kumar Kaushalendra Sinha Alias Bharat Manas,NALANDA,IND,1,12th Pass,3049003,0,3049003
2158,5394,Kaushal Prasad,JANJGIR-CHAMPA,IND,0,Graduate,50000,0,50000
2159,2495,Kaushal Rai,SIKKIM,AAP,0,Post Graduate,192000,0,192000
2160,2725,Kaushlendra Kumar,NALANDA,JD(U),0,12th Pass,11815717,477000,11338717
2161,2532,Kavita Vinod Kumar Tibdiwal (Agrawal),NAGPUR,IND,0,Post Graduate,3694650,600000,3094650
2162,590,Kawaljit Singh,CHANDIGARH,CPI(ML)L,4,Graduate Professional,22000,0,22000
2163,4438,Kazi Nekib Ahmed,GAUHATI,Regional Democratic Secular Congress,0,Graduate,16650020,0,16650020
2164,2521,Kenchaiah,BANGALORE RURAL,IND,0,Not Given,510000,0,510000
2165,2916,Kesari Singh,BHOPAL,IND,0,Graduate,15325217,0,15325217
2166,7406,"Kesavan, M.",VELLORE,IND,0,8th Pass,831388,0,831388
2167,6880,Kesavan. L,CHENNAI NORTH,IND,0,8th Pass,27659000,1228000,26431000
2168,1768,Keshab Chandra Ray,COOCHBEHAR,INC,0,Graduate,6801343,0,6801343
2169,521,Keshab Gogoi,LAKHIMPUR,IND,0,Graduate,858000,0,858000
2170,1529,Keshav,SATNA,IND,0,Post Graduate,76250,0,76250
2171,1680,Keshav Choudhary,GHAZIABAD,IND,1,12th Pass,1000,0,1000
2172,1228,Keshwar Yadav,CHATRA,SP,16,5th Pass,3450487,300000,3150487
2173,4656,Kewal Bharti Goswami,KORBA,SP,1,Post Graduate,6275000,0,6275000
2174,3698,Kewale Chaya Nagnath,SOLAPUR,IND,0,Literate,15000,0,15000
2175,5594,Khadase Raksha Nikhil,RAVER,BJP,0,Graduate,144222841,0,144222841
2176,4366,Khagen Murmu,MALDAHA UTTAR,CPI(M),0,Graduate,5342394,291761,5050633
2177,5073,Khaim Chand,ALWAR,Bharatiya Yuva Shakti,0,8th Pass,7246800,0,7246800
2178,519,Khairul Islam,LAKHIMPUR,IND,0,10th Pass,413129,0,413129
2179,4394,Khajan Singh,FIROZABAD,Lok Dal,0,12th Pass,351000,0,351000
2180,3043,Khajan Singh,AMROHA,Rashtriya Congress (Babu Jagjivanram),0,Literate,1025000,0,1025000
2181,3741,Khan Abdul Razack,BANGALORE SOUTH,BSP,0,10th Pass,3708254,0,3708254
2182,5917,Khan Abdus Salam Kasmi,MUMBAI SOUTH,BSP,0,Others,2351000,0,2351000
2183,5881,Khan Mohammed Ahmed,KALYAN,IND,5,10th Pass,200000,0,200000
2184,7232,Khan Shamim Banu,MUMBAI NORTH EAST,IND,0,5th Pass,3869918,0,3869918
2185,5945,Khan Siraj Ahmad Sarajun Hak,MUMBAI SOUTH CENTRAL,IND,7,5th Pass,1840000,0,1840000
2186,5980,Kharapade Ladakya Rupa,PALGHAR,CPI(M),0,12th Pass,2641309,0,2641309
2187,4878,Khargeswar Das,GAUHATI,IND,0,8th Pass,550800,0,550800
2188,2031,Khatab Singh Mor,KARNAL,Bhartiya Shakti Chetna Party,0,12th Pass,14880000,200000,14680000
2189,5597,Khatik Mohammad Haroon Abdul Kadir,RAVER,SP,2,Post Graduate,2218302,475000,1743302
2190,593,Khem Lal Bansal,CHANDIGARH,Inqalab Vikas Dal,0,10th Pass,76108195,900000,75208195
2191,236,Khem Raj Chetry,TEZPUR,CPI(M),0,12th Pass,300100,0,300100
2192,1280,Kheme Thakur,FARIDABAD,SP,1,Graduate,1267000,0,1267000
2193,2805,Khemraj Lodhi,RAJNANDGAON,IND,0,Graduate,9000000,100000,8900000
2194,5101,Khemraj Meena,DAUSA,Bharatiya Yuva Shakti,0,Graduate Professional,140095,0,140095
2195,2477,Khet Singh Rajpurohit,BARMER,IND,0,10th Pass,50046,0,50046
2196,2467,Khima Ram Salavi,RAJSAMAND,IND,1,8th Pass,1566000,85000,1481000
2197,3626,Khirid Simkumar Bhagwan,PUNE,IND,0,Post Graduate,26532579,0,26532579
2198,5385,Khitiz Kumar Sabharkar,DURG,Republican Paksha (Khoripa),0,Graduate Professional,31000,0,31000
2199,50,Khobragade Chandrabhan Jairam,RAMTEK,IND,0,10th Pass,37804,0,37804
2200,5085,Khoob Raj Neeraj,ALWAR,Bahujan Mukti Party,1,12th Pass,11513535,700000,10813535
2201,5148,Khudus Samad,AURANGABAD,Bahujan Mukti Party,0,10th Pass,41890,0,41890
2202,759,Khuman Singh Armo,MANDLA,AAP,0,12th Pass,1178622,0,1178622
2203,4426,Khurshida Anowara Begum,BARPETA,SUCI(C),0,Post Graduate,4918640,369608,4549032
2204,2091,Khush Dil Sehgal (Kapoor),FARIDABAD,Akhil Bharatiya Hind Kranti Party,0,Post Graduate,3903000,45000,3858000
2205,248,Kim Gangte,OUTER MANIPUR,AITC,0,Post Graduate,10150000,0,10150000
2206,1997,Kiran Pal,KURUKSHETRA,Bharatiya Inqalab Party,0,12th Pass,18260000,0,18260000
2207,1296,Kiran Pal Singh,SOUTH DELHI,IND,0,8th Pass,630000,0,630000
2208,1420,Kiran Prem Kumar Rodge (Patankar),RAMTEK,BSP,0,Literate,6074383,0,6074383
2209,782,Kirantai Dadarao Alias Kokubhau Kokate,AMRAVATI,IND,0,8th Pass,0,0,0
2210,5876,Kiratkar Dayanand Tulshiram,KALYAN,BSP,1,12th Pass,3768000,251108,3516892
2211,246,Kiren Rijiju,ARUNACHAL WEST,BJP,0,Graduate,12539868,475000,12064868
2212,4097,Kirip Chaliha,MANGALDOI,INC,0,Post Graduate,25799434,0,25799434
2213,7220,Kirit Somaiya,MUMBAI NORTH EAST,BJP,10,Doctorate,72156258,6593325,65562933
2214,4234,Kirodi Lal,DAUSA,National Peoples Party,1,Graduate Professional,22522693,1170000,21352693
2215,7257,Kirtawade Vidhyadhar Bhimrao,THANE,BSP,0,10th Pass,721500,0,721500
2216,5086,Kishan Lal,ALWAR,IND,0,8th Pass,3061599,0,3061599
2217,3209,Kishan Lal,SHAHJAHANPUR,Lok Dal,0,8th Pass,140000,0,140000
2218,2959,Kishan Lal Kushwah,GWALIOR,Rashtriya Samanta Dal,0,8th Pass,3740000,0,3740000
2219,4975,Kishan Pal Singh,FARRUKHABAD,IND,0,8th Pass,3393000,80000,3313000
2220,678,Kishan Pal Singh,GAUTAM BUDHHA NAGAR,AAP,0,10th Pass,14376352,592054,13784298
2221,4158,Kishor Kumar Murmu,DHANBAD,Bahujan Mukti Party,0,Others,1545450,0,1545450
2222,319,Kishor Rambhau Kinkar,WARDHA,Bahujan Mukti Party,1,Graduate,12132347,345000,11787347
2223,1932,Kishore,ERNAKULAM,IND,0,10th Pass,90000,0,90000
2224,5115,Kishore Kumar,KARAULI-DHOLPUR,IND,0,Literate,3104400,0,3104400
2225,439,Kismat Sharma,KARNAL,IND,0,10th Pass,1350000,540000,810000
2226,6978,"Kittusamy, P.",COIMBATORE,IND,0,5th Pass,80000,0,80000
2227,13,Kodikunnil Suresh,MAVELIKKARA,INC,1,Graduate Professional,13251330,3439654,9811676
2228,3493,Kokare Shivaji Jaysingh,BARAMATI,IND,0,8th Pass,9381000,75000,9306000
2229,6881,Kolangi. M,CHENNAI NORTH,IND,0,Literate,2000,0,2000
2230,2616,Kolar Kesava,KOLAR,JD(S),7,Graduate,168319791,75522284,92797507
2231,3489,Kolsepatil Baban Gangadhar,AHMEDNAGAR,IND,3,Graduate Professional,337159952,2379701,334780251
2232,5144,Kori Lal,TONK-SAWAI MADHOPUR,IND,0,5th Pass,2019500,0,2019500
2233,5434,Kothandapani B,TIRUVANNAMALAI,IND,0,10th Pass,300000,0,300000
2234,2618,Kotiganahalli Ramaiah,KOLAR,AAP,0,12th Pass,7724963,1285958,6439005
2235,5400,Kranti Kumar Chandrakar,RAIPUR,IND,0,Graduate Professional,3748061,0,3748061
2236,4132,Kripa Shankar Bhagat,RAIGARH,BSP,0,Post Graduate,3141334,0,3141334
2237,4638,Kriparam Sidar,RAIGARH,GGP,0,8th Pass,7745000,400000,7345000
2238,1593,Kripashankar Yadav,CHHINDWARA,IND,0,12th Pass,1106345,0,1106345
2239,4965,Krishan Kumar Dixit,FARRUKHABAD,RASHTRIYA VIKLANG PARTY,0,12th Pass,3433843,0,3433843
2240,2313,Krishan Kumar Saran,CHURU,AAP,0,Graduate,20295507,3900000,16395507
2241,1649,Krishan Pal,BAGHPAT,Naitik Party,1,12th Pass,4414465,0,4414465
2242,1047,Krishan Pal,FARIDABAD,BJP,0,Graduate Professional,296440144,19707475,276732669
2243,1605,Krishanpal,KAIRANA,IND,0,Literate,10804500,0,10804500
2244,3112,Krishna Adhikari,KHERI,CPI(ML)L,5,10th Pass,5000,0,5000
2245,76,Krishna Das,KARIMGANJ,BJP,0,12th Pass,2794334,0,2794334
2246,2901,Krishna Devi,BHIND,AAP,0,Graduate,11415750,1325000,10090750
2247,3417,Krishna Kumar Dadhich,AJMER,IND,0,Graduate,100000,0,100000
2248,5401,Krishna Nandan Singh,RAIPUR,IND,0,Post Graduate,2220153,0,2220153
2249,3206,Krishna Raj,SHAHJAHANPUR,BJP,0,Post Graduate,16506411,3612812,12893599
2250,2969,Krishna Sharan,KHAJURAHO,Brihattar Bharat Prajatantra Sewa Party,0,Graduate,1600500,0,1600500
2251,648,Krishna Singh,KODARMA,JD(U),1,Literate,518000,0,518000
2252,4174,Krishna Singh,RAJMAHAL,IUML,0,12th Pass,680000,2680000,-2000000
2253,872,Krishna Tirath,NORTH WEST DELHI,INC,0,Graduate,56882796,0,56882796
2254,6324,Krishnamoorthy A,DINDIGUL,DMDK,0,Graduate Professional,11703000,0,11703000
2255,7508,"Krishnamoorthy, K.",THENI,CPI(ML) Red Star,0,8th Pass,320000,0,320000
2256,614,Krishnamurthy,MANDYA,RPI(A),0,12th Pass,6110000,100000,6010000
2257,2560,Krishnamurthy.M,MANDYA,BSP,0,Post Graduate,839000,0,839000
2258,1902,Krishnan Eranhikkal,ALATHUR,SDPI,0,12th Pass,903301,20000,883301
2259,7469,Krishnan S,SIVAGANGA,CPI,0,Graduate Professional,7153000,1656914,5496086
2260,3945,Krishnan.M,NAMAKKAL,IND,0,Graduate Professional,1000,0,1000
2261,304,Krishnankutty M.K.,ERNAKULAM,CPI(ML) Red star,0,10th Pass,879121,40000,839121
2262,1904,Krishnankutty V,ALATHUR,IND,0,10th Pass,146988,6000,140988
2263,7457,Krishnasamy Vandayar.T,THANJAVUR,INC,0,Graduate Professional,173643172,11034462,162608710
2264,7576,Krishnasamy.A.,TENKASI,IND,0,8th Pass,447500,0,447500
2265,942,Krupal Balaji Tumane,RAMTEK,SHS,1,Graduate,46564362,216000,46348362
2266,1385,Krushnarao Ingle,BULDHANA,IND,0,Literate,206100,35000,171100
2267,3601,Kshirsagar Shivaji Jagannath,OSMANABAD,IND,0,Post Graduate,6142200,0,6142200
2268,3602,Kshirsagar Vijay Maruti,OSMANABAD,IND,0,Post Graduate,90000,47500,42500
2269,1787,Kshitish Chandra Mandal,JALPAIGURI,BSP,0,Graduate,550000,0,550000
2270,2168,Kuber Vasudev Subbaji,HAVERI,IND,0,12th Pass,2996700,0,2996700
2271,3712,Kulamani Samal,JAGATSINGHPUR,BJD,0,Graduate Professional,25158570,0,25158570
2272,793,Kulamani Urma,BARGARH,Paschimanchal Vikas Party,0,8th Pass,153000,0,153000
2273,1054,Kuldeep Bishnoi,HISAR,Haryana Janhit Congress (BL),1,Graduate,786595116,104464405,682130711
2274,122,Kuldeep Rai Sharma,ANDAMAN & NICOBAR ISLANDS,INC,0,Graduate Professional,31594826,5034619,26560207
2275,2011,Kuldeep S/O Ishwar Singh,HISAR,IND,0,Graduate,1522160,0,1522160
2276,2012,Kuldeep S/O Karan Singh,HISAR,IND,0,8th Pass,225700,0,225700
2277,2015,Kuldeep S/O Madan Lal,HISAR,IND,0,5th Pass,1012562,48000,964562
2278,2013,Kuldeep S/O Narain Singh,HISAR,IND,0,5th Pass,55000,0,55000
2279,2014,Kuldeep S/O Pardumn,HISAR,IND,0,Post Graduate,260000,102000,158000
2280,2016,Kuldeep S/O Sajjan,HISAR,IND,0,12th Pass,6548165,137000,6411165
2281,1035,Kuldeep Singh,KURUKSHETRA,RPI,0,10th Pass,53708428,0,53708428
2282,4083,Kuldeep Singh,MORENA,IND,1,Graduate,856024,0,856024
2283,2007,Kuldeep Singh S/O Shishpal,HISAR,Bahujan Mukti Party,0,Post Graduate,25500,0,25500
2284,2166,Kulkarni Chandrashekharayya Gurulingayya,HAVERI,IND,0,Graduate,1725000,20000,1705000
2285,4144,Kumait Ram Sandil,SURGUJA,IND,0,Post Graduate,3610829,200829,3410000
2286,2855,Kumar Chandra Mardi,JAMSHEDPUR,AAP,2,8th Pass,3820000,0,3820000
2287,2752,Kumar Indra Bhushan,PATALIPUTRA,IND,2,Graduate,9122284,285000,8837284
2288,2770,Kumar Rajiv,PATNA SAHIB,IND,0,Post Graduate,0,0,0
2289,1351,Kumar Vivek Gautam,EAST DELHI,IND,0,Graduate,390500,1900000,-1509500
2290,7455,Kumar.P S/O Palaniappan,TIRUCHIRAPPALLI,IND,0,Graduate,1090000,155000,935000
2291,6990,Kumaran.V,DHARMAPURI,IND,0,Doctorate,2850000,0,2850000
2292,6339,Kumarasamy K.K,ERODE,AAP,0,Graduate Professional,11661670,2200000,9461670
2293,2296,Kumbha Ram,GANGANAGAR,IND,1,12th Pass,3550978,0,3550978
2294,925,Kumbhare Hansraj Gulab,CHANDRAPUR,BSP,0,Post Graduate,551500,0,551500
2295,5251,Kumkum Singh,BHAGALPUR,Bharat Vikas Morcha,1,Doctorate,825000,0,825000
2296,2222,Kunaje Manjunatha Gowda,SHIMOGA,BSP,0,Graduate,1413790,0,1413790
2297,2766,Kunal Singh,PATNA SAHIB,INC,0,12th Pass,51271000,750000,50521000
2298,2757,Kundan Prasad Singh,PATALIPUTRA,AAP,0,12th Pass,4833000,0,4833000
2299,5271,Kunj Bihar Paswan,PURNIA,IND,0,Literate,1266625,83000,1183625
2300,4143,Kunj Bihari Paikra,SURGUJA,Bahujan Mukti Party,0,Graduate Professional,2337000,125000,2212000
2301,351,Kunnil Shajahan,THIRUVANANTHAPURAM,SDPI,3,Graduate,1105500,350000,755500
2302,345,Kunnukuzhi S Mani,THIRUVANANTHAPURAM,IND,0,10th Pass,5000040,0,5000040
2303,1764,Kunwar Bhartendra,BIJNOR,BJP,2,Post Graduate,24840646,0,24840646
2304,4271,Kunwar Devendra Singh Yadav,ETAH,SP,1,Doctorate,1249971797,77123717,1172848080
2305,3050,Kunwar Sarvraj Singh,AONLA,SP,0,Graduate Professional,25118224,0,25118224
2306,3117,Kunwer Sarvesh Kumar,MORADABAD,BJP,4,10th Pass,72866898,600000,72266898
2307,5695,Kuppayee R,SALEM,IND,0,12th Pass,150000,0,150000
2308,6330,Kuppuraj C,DINDIGUL,IND,0,Post Graduate,2160000,0,2160000
2309,7154,Kuppuramu .D,RAMANATHAPURAM,BJP,0,Graduate Professional,24225393,0,24225393
2310,3531,Kurane Ajay Prakash,KOLHAPUR,BSP,0,Graduate,2255800,0,2255800
2311,2084,Kusheshwar Bhagat,GURGAON,IND,0,8th Pass,181000,0,181000
2312,2090,Kusum Kumari,FARIDABAD,All India Peoples Front,0,Post Graduate,75167,0,75167
2313,412,Kusum Sherwal,AMBALA,INLD,0,Doctorate,21378240,696974,20681266
2314,2261,Kutub Ahmed Mazumder,SILCHAR,AIUDF,0,Graduate,1249603,190679,1058924
2315,2547,Kutubuddin Kazi,BAGALKOT,AAP,0,10th Pass,3002000,200000,2802000
2316,3819,L.P.Yadunandana,TUMKUR,IND,0,Graduate,340000,0,340000
2317,6914,La.Ganesan,CHENNAI SOUTH,BJP,0,12th Pass,307000,0,307000
2318,571,Labha Ram,JAMMU,IND,0,12th Pass,860000,230000,630000
2319,823,Ladu Kishore Swain,ASKA,BJD,0,Graduate,3488390,25000,3463390
2320,3081,Laiq Ahmad,BAREILLY,Naitik Party,0,Not Given,1645600,9400,1636200
2321,4120,Lakhan Lahare,JANJGIR-CHAMPA,IND,0,Post Graduate,2584567,0,2584567
2322,3020,Lakhan Lal,TIKAMGARH,IND,0,12th Pass,482600,70000,412600
2323,5392,Lakhan Lal Chauhan,JANJGIR-CHAMPA,Bahujan Mukti Party,0,10th Pass,1603217,0,1603217
2324,5379,Lakhan Lal Sahu S/O Nandram Sahu,BILASPUR,IND,0,5th Pass,2236151,0,2236151
2325,5378,Lakhan Lal Sahu S/O Santram Sahu,BILASPUR,IND,0,8th Pass,250000,0,250000
2326,5380,Lakhan Sahu S/O Mahindar Sahu,BILASPUR,IND,0,Literate,52500,0,52500
2327,5375,Lakhan Sahu S/O Manohar Lal,BILASPUR,IND,0,5th Pass,2218603,0,2218603
2328,4227,Lakhan Singh,BHARATPUR,Peoples Green Party,0,8th Pass,2879000,0,2879000
2329,2935,Lakhan Singh Baghel,GUNA,BSP,0,Graduate,19797009,550000,19247009
2330,106,Lakhanlal Sau S/O Kalyan Lal Sahu,BILASPUR,BJP,0,Post Graduate,8661133,306357,8354776
2331,4239,Lakkhiram,KARAULI-DHOLPUR,INC,0,Post Graduate,2915000,0,2915000
2332,237,Lakshi Kanta Kurmi,TEZPUR,CPI(ML)L,0,8th Pass,106200,0,106200
2333,2799,Lakshman Masturiya,MAHASAMUND,AAP,0,Post Graduate,2242689,0,2242689
2334,5232,Lakshman Singh,VIDISHA,INC,0,Graduate,83783624,17068702,66714922
2335,7606,Lakshmanan @ Lakkan.A,TIRUNELVELI,IND,0,8th Pass,12061000,0,12061000
2336,5006,Lakshmi,FATEHPUR SIKRI,AAP,1,Graduate,886000,0,886000
2337,7539,Lakshmi Gandan,VIRUDHUNAGAR,IND,4,Graduate Professional,446386,21500,424886
2338,1180,Lakshmi Hebbalkar,BELGAUM,INC,0,Post Graduate,83015088,2579238,80435850
2339,1330,Lakshmi Narayan,NEW DELHI,Bharatiya Bahujan Party,0,8th Pass,8202800,0,8202800
2340,1548,Lal Bahadur Singh,SIDHI,Samata Samadhan Party,0,10th Pass,312000,0,312000
2341,2760,Lal Bahadur Singh Patel,PATNA SAHIB,Krantikari Vikas Dal,1,10th Pass,830000,0,830000
2342,870,Lal Chand,BHIWANI-MAHENDRAGARH,Republican Backward Congress,0,Graduate,11484000,0,11484000
2343,755,Lal Das,JABALPUR,GGP,0,10th Pass,8070000,130000,7940000
2344,4012,Lal Jotindra Dev,RANCHI,Akhil Bhartiya Jharkhand Party,0,Post Graduate,7216000,0,7216000
2345,482,Lal Say Kumar Bhagat,LOHARDAGA,CPI(ML)L,0,12th Pass,1319000,0,1319000
2346,4933,Lal Singh Tomar,AKBARPUR,SP,6,Post Graduate,42832429,12923479,29908950
2347,1562,Lala Kol,SHAHDOL,IND,0,8th Pass,130100,2000,128100
2348,4813,Lalchand,UJJAIN,IND,0,12th Pass,5915000,0,5915000
2349,1258,Laldev Ram,PALAMAU,Bahujan Mukti Party,0,12th Pass,7293888,0,7293888
2350,3695,Lalit Babar,SOLAPUR,AAP,0,Graduate,3798836,0,3798836
2351,1614,Lalit Chauhan,MUZAFFARNAGAR,JD(U),0,12th Pass,685000,0,685000
2352,5848,Lalit Gaurishankar Sharma,JALGAON,IND,0,10th Pass,1425150,150000,1275150
2353,866,Lalit Kumar,BHIWANI-MAHENDRAGARH,AAP,0,Graduate Professional,8922356,4625841,4296515
2354,5402,Lalit Kumar Patel,RAIPUR,IND,0,Graduate Professional,50000,0,50000
2355,2099,Lalit Mittal,FARIDABAD,IND,0,Post Graduate,4295126,0,4295126
2356,2246,Lalit Mohon Suklabaidya,KARIMGANJ,INC,2,Post Graduate,11328972,0,11328972
2357,3029,Lalit Singha,DARJEELING,Bahujan Mukti Party,0,8th Pass,269500,0,269500
2358,1967,Lalitha Malayalappuzha,PATHANAMTHITTA,IND,0,10th Pass,110000,0,110000
2359,7414,"Lalitha, K.",VELLORE,IND,0,10th Pass,470000,0,470000
2360,2657,Lallan Rup Narayan Pathak,BUXAR,IND,0,Doctorate,7750000,0,7750000
2361,2943,Lalli Ram Rai,GUNA,IND,0,Illiterate,131000,0,131000
2362,2730,Lallu Ram,NALANDA,Bahujan Mukti Party,0,Literate,61000,0,61000
2363,1164,Lambodar Kanhar,KANDHAMAL,IND,2,Graduate Professional,1303200,38000,1265200
2364,1010,Lamlalmoi@ Momoi Gangte,OUTER MANIPUR,CPI(ML)L,0,Graduate,800000,0,800000
2365,536,Lamminlien Gangte,OUTER MANIPUR,JD(U),0,Illiterate,5177000,0,5177000
2366,2721,Lata Sinha,NALANDA,IND,0,Post Graduate,2330367,64000,2266367
2367,1138,Lawrencia Lakra,SUNDARGARH,IND,0,12th Pass,1500,0,1500
2368,2098,Laxman,FARIDABAD,IND,0,Not Given,127600,0,127600
2369,2463,Laxman,RAJSAMAND,Jai Maha Bharath Party,0,5th Pass,397073,18000,379073
2370,3486,Laxman Bhanudas Sonale,AHMEDNAGAR,IND,0,Graduate,3309077,0,3309077
2371,2452,Laxman Bhil,UDAIPUR,BSP,0,5th Pass,277900,0,277900
2372,2887,Laxman Giluwa,SINGHBHUM,BJP,4,12th Pass,8094301,108145,7986156
2373,4126,Laxman Lal Kaiwart,KORBA,Chhattisgarhiya Party,0,12th Pass,127580,0,127580
2374,4388,Laxmi,FIROZABAD,Bhartiya Shakti Chetna Party,0,Graduate,710078,20000,690078
2375,4393,Laxmi Narayan,FIROZABAD,Rashtriya Janwadi Party (Krantikari),0,Graduate,2658630,1571154,1087476
2376,3001,Laxmi Narayan Yadav,SAGAR,BJP,1,Post Graduate,23962099,956348,23005751
2377,5108,Laxmikant,KARAULI-DHOLPUR,IND,0,Graduate,51000,0,51000
2378,2454,Laxmilal Gameti,UDAIPUR,Socialist Party (India),0,Literate,255700,0,255700
2379,1583,Laxminarayan Dehariya,BALAGHAT,Bahujan Mukti Party,1,12th Pass,1710000,0,1710000
2380,7485,Lenin M,SIVAGANGA,IND,0,12th Pass,148120,0,148120
2381,1137,Lily Prema Kujur,SUNDARGARH,Bahujan Mukti Party,0,12th Pass,161000,0,161000
2382,7566,Lingam.P,TENKASI,CPI,1,Graduate,1407450,341191,1066259
2383,786,Lingaraj Pradhan,BARGARH,AAP,0,Post Graduate,2470000,0,2470000
2384,1174,Lingaraj Sabara@Gomango,KORAPUT,IND,0,Post Graduate,5462041,1123000,4339041
2385,3910,Lodhi Seema Kaushik,RAJNANDGAON,SP,0,8th Pass,10720000,1240000,9480000
2386,6928,Loganathan,CHENNAI SOUTH,IND,0,5th Pass,205500,0,205500
2387,5453,Loganathan P,TIRUVANNAMALAI,IND,0,10th Pass,180000,0,180000
2388,1436,Lokhande Ganesh Haibatrao,RAMTEK,IND,0,Graduate Professional,548000,600,547400
2389,3405,Lokhande Sadashiv Kisan,SHIRDI,SHS,1,10th Pass,38294539,1497168,36797371
2390,3995,Loknath Mahto,HAZARIBAGH,AJSUP,1,12th Pass,23139387,236074,22903313
2391,3095,Lotan Singh,BAREILLY,IND,5,10th Pass,1470000,0,1470000
2392,1710,Lt Col Sp Singh,GAUTAM BUDHHA NAGAR,Nav Bharat Democratic Party,0,Graduate,17777227,0,17777227
2393,1325,Lukman Khan,NEW DELHI,IND,2,5th Pass,3786699,0,3786699
2394,961,M .K Raghavan,KOZHIKODE,INC,0,Graduate,6164901,1558128,4606773
2395,3831,M Ahamed Shahjahan,SALEM,IND,0,Post Graduate,4100000,0,4100000
2396,1889,M B Rajesh,PALAKKAD,CPI(M),11,Graduate Professional,4676316,700680,3975636
2397,3926,M C Mittal Jai Gurudeo Tatdhari,BHOPAL,IND,0,12th Pass,8070000,569170,7500830
2398,2234,M D Mainuddin Khan Alias Asfiya,UDUPI CHIKMAGALUR,IND,0,8th Pass,163000,0,163000
2399,724,M G Purushothaman,CHALAKUDY,BSP,0,Others,296000,78000,218000
2400,960,M I Shanavas,WAYANAD,INC,0,Post Graduate,27122055,7711000,19411055
2401,1009,M Khamchinpau Zou,OUTER MANIPUR,AAP,0,Post Graduate,1010616,0,1010616
2402,330,M M Paulose,ALAPPUZHA,IND,0,10th Pass,7322508,0,7322508
2403,1867,M Raghavan,KOZHIKODE,IND,0,10th Pass,20493829,0,20493829
2404,1206,M Shivanna,CHAMARAJANAGAR,JD(S),3,Graduate Professional,31402152,7852000,23550152
2405,402,M Veerappa Moily,CHIKKBALLAPUR,INC,0,Graduate Professional,137366682,39433827,97932855
2406,7487,M Venkatesan,MADURAI,IND,0,Post Graduate,2213164,620397,1592767
2407,6932,M. Arumugam,CHENNAI SOUTH,IND,0,8th Pass,374000,0,374000
2408,2489,M. Baby,KOLLAM,IND,0,10th Pass,1871596,0,1871596
2409,5572,M. Chittibabu,PONDICHERRY,IND,0,Graduate,7745000,0,7745000
2410,5862,M. Javed A. Wahab,JALNA,IND,0,12th Pass,10510000,0,10510000
2411,6950,M. Jayaraman,CHENNAI SOUTH,IND,0,Graduate,634836,0,634836
2412,4344,M. Karunakaran,TIRUCHIRAPPALLI,Lok Satta Party,0,Post Graduate,7319600,0,7319600
2413,2591,M. Kumbhaiah,CHITRADURGA,JD(U),0,Graduate Professional,38291000,4950000,33341000
2414,5584,M. Marie Uthriyanathan,PONDICHERRY,Samata Party,3,8th Pass,454250,478409,-24159
2415,6859,M. Mohamed Rasik,CHENNAI CENTRAL,IND,0,Graduate,100000,0,100000
2416,6855,M. Murugan,CHENNAI CENTRAL,IND,0,Graduate Professional,954117,0,954117
2417,1916,M. N. Kutty,THRISSUR,IND,0,10th Pass,4251600,120000,4131600
2418,6854,M. Prabakaran,CHENNAI CENTRAL,IND,0,10th Pass,6366720,215000,6151720
2419,4063,M. Ramadass,PONDICHERRY,IND,0,Doctorate,8094600,604861,7489739
2420,666,M. Shahid,MEERUT,BSP,0,5th Pass,1989984945,103807610,1886177335
2421,3830,M. Venkatesan,VILUPPURAM,CPI(ML)L,0,Graduate,781450,32500,748950
2422,337,M.A. Baby,KOLLAM,CPI(M),2,Graduate,6430619,625000,5805619
2423,4044,M.Badhusha,TIRUCHIRAPPALLI,IND,0,Literate,815000,0,815000
2424,3958,M.Chandrakasi,CHIDAMBARAM,AIADMK,0,Graduate,7243646,2020472,5223174
2425,6299,M.Durairaj,ARANI,IND,0,Post Graduate,350000,0,350000
2426,4332,M.Gopalakrishnan,MADURAI,IND,6,10th Pass,3798200,1040000,2758200
2427,6289,M.K.Vishnu Prasad,ARANI,INC,1,Graduate Professional,110571761,23691877,86879884
2428,4328,M.Kamacis,MADURAI,AAP,0,Graduate Professional,4494623,966227,3528396
2429,5477,M.Kathirvel,VILUPPURAM,IND,0,5th Pass,1501500,0,1501500
2430,1043,M.Lalmanzuala,MIZORAM,AAP,0,Graduate,63800000,0,63800000
2431,4849,M.M. Abdul Bari,MURSHIDABAD,IUML,0,Others,444293,0,444293
2432,1203,M.Mahesh Alias Harsha,HASSAN,IND,0,10th Pass,37777,0,37777
2433,7490,M.Meenakshisundaram,MADURAI,IND,0,Post Graduate,4235311,80000,4155311
2434,4331,M.Mohammed Ali,MADURAI,Samata Party,0,5th Pass,245086,0,245086
2435,3951,M.Mohandass,TIRUCHIRAPPALLI,IND,0,Graduate,21687000,2745000,18942000
2436,3790,M.Muniyappa,KOLAR,IND,0,8th Pass,2060000,0,2060000
2437,6302,M.Munusamy,ARANI,IND,0,8th Pass,296000,0,296000
2438,125,M.P. Sayed Mohammaed Koya,LAKSHADWEEP,BJP,0,Graduate,14073985,0,14073985
2439,6370,M.P.Mannan,KALLAKURICHI,IND,0,Post Graduate,567061,0,567061
2440,2519,M.P.Munawer Shariff,BANGALORE RURAL,IND,0,Others,25000,0,25000
2441,4306,M.Palanisamy,TIRUPPUR,IND,0,10th Pass,7050442,1000000,6050442
2442,3966,M.Pushparayan,THOOTHUKKUDI,AAP,380,Literate,8775806,0,8775806
2443,7435,M.Rajendran,TIRUPPUR,IND,0,12th Pass,300000,0,300000
2444,2227,M.S. Mainuddin,SHIMOGA,IND,0,10th Pass,160000,0,160000
2445,3793,M.S.Narayanaswamy,KOLAR,IND,0,10th Pass,1000,0,1000
2446,3837,M.Saravanan,SIVAGANGA,IND,0,12th Pass,3870000,0,3870000
2447,7537,M.Satheesh,VIRUDHUNAGAR,IND,0,Graduate,206911,0,206911
2448,7419,M.Senthilnathan,TIRUPPUR,DMK,0,Post Graduate,203278896,127959469,75319427
2449,958,M.T. Ramesh,PATHANAMTHITTA,BJP,0,Graduate,1039808,0,1039808
2450,5476,M.Umashankar,VILUPPURAM,IND,0,Literate,30000,0,30000
2451,4059,M.V. Omalingam,PONDICHERRY,AIADMK,0,Others,26412176,21600000,4812176
2452,2134,Machendar,BIDAR,IND,0,Post Graduate,11000000,550000,10450000
2453,1058,Machindra Kadapure,CHIKKODI,BSP,0,Illiterate,101000,0,101000
2454,3071,Madan Lal,BADAUN,National Party,0,10th Pass,1447000,0,1447000
2455,5403,Madan Lal Sahu,RAIPUR,CPI(ML) Red Star,0,Graduate,2176006,460586,1715420
2456,575,Madan Lal Sharma,JAMMU,INC,0,10th Pass,18843802,384929,18458873
2457,4704,Madan Mohan Ram,DHANBAD,BSP,6,10th Pass,672000,0,672000
2458,2951,Madan Mohan Singh Tomar,GWALIOR,Bhartiya Jan Yug Party,0,12th Pass,4795500,8704,4786796
2459,4098,Madhab Rajbangshi,MANGALDOI,AGP,0,Graduate Professional,6779962,5480000,1299962
2460,3218,Madhaba Sardar,KEONJHAR,INC,0,Post Graduate,1757015,99665,1657350
2461,7551,"Madhavan, P.",VIRUDHUNAGAR,IND,0,5th Pass,2105703,0,2105703
2462,7466,Madhavan.T,THANJAVUR,IND,0,Not Given,441000,106842,334158
2463,7387,"Madhavaraj, K.V. Thiru.",SRIPERUMBUDUR,IND,1,12th Pass,95307,2225,93082
2464,3709,"Madhu Sudan Yadav,",BHUBANESWAR,BSP,0,Graduate,2050000,1440,2048560
2465,2264,Madhu Sudhan Das,SILCHAR,IND,0,12th Pass,72053,0,72053
2466,3863,Madhukar Baburao Kambale,SANGLI,IND,0,8th Pass,742800,0,742800
2467,5098,Madhuri Pushker,BHARATPUR,IND,0,12th Pass,7863409,0,7863409
2468,1816,Magadum Ismail Magadum,CHIKKODI,IND,1,10th Pass,2027500,600000,1427500
2469,7577,Magesh.S.,TENKASI,IND,0,Graduate,20000,0,20000
2470,498,Mahabal Mishra,WEST DELHI,INC,1,12th Pass,388226286,8691614,379534672
2471,36,Mahabali Singh,KARAKAT,JD(U),5,8th Pass,33437255,0,33437255
2472,2337,Mahabeer Prasad Kumawat,JHUNJHUNU,IND,0,10th Pass,1516293,0,1516293
2473,3383,Mahadeo Jagannath Jankar,BARAMATI,Rashtriya Samaj Paksha,0,Others,6874700,0,6874700
2474,2112,Mahadev Bhimsha,GULBARGA,BSP,1,Graduate,9222545,825000,8397545
2475,5245,Mahadev Kumar,BHAGALPUR,IND,1,10th Pass,2182100,185000,1997100
2476,2871,Mahadev Ravinath Pahan,KHUNTI,Rashtriya Deshaj Party,0,12th Pass,2137028,0,2137028
2477,3744,Mahadeva Swamy. B. M,BANGALORE SOUTH,Bharatiya Dr. B.R.Ambedkar Janta Party,0,12th Pass,812200,586200,226000
2478,3495,Mahadik Prahlad Dagadu,BARAMATI,IND,0,12th Pass,20105000,355000,19750000
2479,7535,Mahalingam,VIRUDHUNAGAR,Desiya Forward Bloc,0,5th Pass,2906722,810000,2096722
2480,3283,Mahameghabahan Aira Kharabela Swain,CUTTACK,Aama Odisha Party,0,Post Graduate,3225000,0,3225000
2481,5070,Mahant Chand Nath Yogi,ALWAR,BJP,0,Graduate,199653,0,199653
2482,3923,Mahant Gopal Das Baba Shahab,BHOPAL,IND,0,Literate,108000,0,108000
2483,4915,Maharaj Singh Dhangar,AGRA,SP,0,5th Pass,25798815,1095365,24703450
2484,5056,Maharam Singh,MATHURA,Bahujan Mukti Party,0,Post Graduate,24535,0,24535
2485,1576,Mahatalal Barkade,MANDLA,National Peoples Party,0,8th Pass,208000,0,208000
2486,1560,Mahaveer Parshad Manjhi,SHAHDOL,IND,0,8th Pass,4568000,0,4568000
2487,2069,Mahavir Singh,BHIWANI-MAHENDRAGARH,IND,0,12th Pass,130100,0,130100
2488,3969,Mahboob Alam Ansari,BANKA,Bharatiya Momin Front,0,Post Graduate,8071913,0,8071913
2489,5218,Mahemood Bhaijaan,DHULE,Awami Vikas Party,0,Graduate Professional,964000,235000,729000
2490,2086,Mahender Jat,GURGAON,IND,0,Graduate Professional,10206000,400000,9806000
2491,2794,Mahendra Gawade,KANKER,IND,0,12th Pass,306413,0,306413
2492,3435,Mahendra K. Choudhary,JALORE,IND,0,12th Pass,26113500,0,26113500
2493,3998,Mahendra Kishor Mehta,HAZARIBAGH,IND,0,10th Pass,1035500,0,1035500
2494,2940,Mahendra Kumar,GUNA,IND,1,Graduate,1760000,320000,1440000
2495,2405,Mahendra Kumar,KOTA,IND,0,10th Pass,259127,0,259127
2496,4223,Mahendra Kumar,BHARATPUR,BSP,0,10th Pass,21762465,1275000,20487465
2497,3006,Mahendra Kumar Choudhary,SAGAR,Bahujan Mukti Party,0,Post Graduate,146079,0,146079
2498,1788,Mahendra Kumar Roy,JALPAIGURI,CPI(M),0,Graduate,10695976,0,10695976
2499,4737,Mahendra Murmu,GODDA,Jharkhand Vikas Dal,0,Post Graduate,1658000,0,1658000
2500,483,Mahendra Oraon,LOHARDAGA,IND,0,12th Pass,2180000,20000,2160000
2501,1795,Mahendra Prasad Lama,DARJEELING,IND,0,Doctorate,34438296,3900024,30538272
2502,2919,Mahendra Pratap Singh,DAMOH,INC,0,Post Graduate,28167705,100395,28067310
2503,1251,Mahendra Ravidas,KODARMA,Bahujan Mukti Party,0,Graduate,889868,133210,756658
2504,5932,Mahendra Tulshiram Bhingardive,MUMBAI SOUTH CENTRAL,IND,0,Graduate,12615000,618747,11996253
2505,7056,"Mahendran, T.",KARUR,IND,0,12th Pass,584794,0,584794
2506,6895,Mahendran. K.P.P.,CHENNAI NORTH,IND,0,10th Pass,481953,0,481953
2507,7148,Mahendran. M,POLLACHI,IND,0,Literate,13000,9000,4000
2508,7137,Mahendran.C,POLLACHI,AIADMK,0,Post Graduate,231430367,18128825,213301542
2509,3078,Mahendrapal,BADAUN,Bhartiya Shakti Chetna Party,0,10th Pass,4300000,0,4300000
2510,3048,Mahesh,AMROHA,RPI(A),0,12th Pass,340000,0,340000
2511,1718,Mahesh,GAUTAM BUDHHA NAGAR,IND,0,Graduate Professional,3101000,0,3101000
2512,3722,Mahesh Basappa Nandihal,BAGALKOT,Karunaadu Party,1,Graduate,2340300,434000,1906300
2513,3469,Mahesh Bhandari,PALI,AAP,0,Post Graduate,176779000,14241000,162538000
2514,2965,Mahesh Chandra,KHAJURAHO,Rashtriya Samanta Dal,0,Others,3472884,0,3472884
2515,98,Mahesh Chandra Mohanty,ASKA,BJP,0,Graduate,2702481,1021000,1681481
2516,769,Mahesh Dubey,CHHINDWARA,AAP,0,Graduate,500000,0,500000
2517,67,Mahesh Giri,EAST DELHI,BJP,1,10th Pass,5216375,400000,4816375
2518,4137,Mahesh Harpaal,RAIPUR,Shakti Sena (Bharat Desh),0,10th Pass,500000,0,500000
2519,7254,Mahesh Jaysing Pawara,NANDURBAR,IND,0,Graduate,300000,0,300000
2520,2375,Mahesh Joshi,JAIPUR,INC,0,Doctorate,29252918,4781745,24471173
2521,2407,Mahesh Kumar Raniwal,KOTA,AARAKSHAN VIRODHI PARTY,0,8th Pass,281100,0,281100
2522,4107,Mahesh Mandal,KATIHAR,Bahujan Mukti Party,3,Doctorate,1821376,0,1821376
2523,2735,Mahesh Paswan,NALANDA,Bharat Bhrashtachar Mitao Party,1,Graduate,1930000,0,1930000
2524,5057,Mahesh Pratap Sharma,MATHURA,Rashtriya Vikas Party,0,Graduate Professional,18881596,0,18881596
2525,60,Mahesh Sharma,GAUTAM BUDHHA NAGAR,BJP,0,Graduate Professional,473797545,40905738,432891807
2526,1232,Mahesh Singh Yadav,CHATRA,JD(U),0,Graduate,44079939,3281756,40798183
2527,5907,Mahesh Waman Manjrekar,MUMBAI NORTH WEST,MNS,0,12th Pass,58319993,25240470,33079523
2528,1524,Mahgoo,SATNA,Dalit Vikas Party(Bharat),0,Graduate,3027000,0,3027000
2529,2202,Mahima J Patel,DAVANAGERE,JD(S),0,Graduate Professional,29683292,1245000,28438292
2530,442,Mahinder Pal,KARNAL,IND,0,5th Pass,8401000,8000000,401000
2531,2037,Mahmood Hassan,KARNAL,IND,0,8th Pass,1622345,640000,982345
2532,4243,Makkhan,TONK-SAWAI MADHOPUR,IND,9,10th Pass,45453872,12102619,33351253
2533,5970,Maksud Iliyas Khan,NASHIK,IND,1,10th Pass,134285,530000,-395715
2534,2160,Malagi Shivakumar Giriyappa,BELLARY,AAP,0,Post Graduate,8580500,0,8580500
2535,2471,Malam Singh,BARMER,BSP,0,Post Graduate,1752238,530000,1222238
2536,5824,Mali Sharad Sahebrao,DINDORI,BSP,0,12th Pass,210000,0,210000
2537,2790,Malik Ram Thakur,KANKER,Ambedkarite Party of India,0,10th Pass,2397500,805000,1592500
2538,4977,Malikhan Singh,FARRUKHABAD,IND,0,Graduate Professional,1322500,0,1322500
2539,1568,Malkhan Patel,JABALPUR,IND,0,Not Given,1738000,0,1738000
2540,2517,Mallesha,BANGALORE RURAL,IND,0,12th Pass,407000,500000,-93000
2541,358,Mallikarjun Kharge,GULBARGA,INC,0,Graduate Professional,102220880,7410154,94810726
2542,1763,Malook Nagar,BIJNOR,BSP,0,Graduate,2896200000,33733000,2862467000
2543,441,Mam Chand,KARNAL,CPI,0,Illiterate,37120000,2100000,35020000
2544,7518,Mamallan Tha. Kanagamuthu,THENI,IND,0,Doctorate,8341084,0,8341084
2545,4772,Mamata Bhati,INDORE,Rashtriya Ahinsa Manch,0,8th Pass,251000,0,251000
2546,3237,Mamata Kundu,BALASORE,AAP,0,Graduate,15105000,4500000,10605000
2547,7549,"Mammathan, M.",VIRUDHUNAGAR,IND,0,8th Pass,607100,89100,518000
2548,4228,Mamraj,BHARATPUR,IND,0,10th Pass,2274195,505006,1769189
2549,387,Mamta Kumari,GAYA,SP,0,12th Pass,4195976,5454,4190522
2550,435,Mamta Rani,HISAR,"Rashtrawadi Parivartan Party (L.B,)",0,8th Pass,3922079,138000,3784079
2551,142,Mamun Imdadul Haque Chawdhury,LAKHIMPUR,AIUDF,0,Post Graduate,567483,0,567483
2552,2880,Man Singh Mardi,RANCHI,Jharkhand Party (Naren),0,12th Pass,40000,0,40000
2553,1566,Manak Lal Gontiya,JABALPUR,Ambedkarite Party of India,0,8th Pass,220000,0,220000
2554,2692,Mananjay Kumar,JAHANABAD,IND,0,Graduate,3527000,0,3527000
2555,3434,Manara Ram,JALORE,IND,0,Illiterate,35000,0,35000
2556,4830,Manas Chakraborty,BALURGHAT,CPI(ML) Red Star,0,10th Pass,30500,0,30500
2557,3313,Manas Kumar Behera,JAGATSINGHPUR,IND,0,Post Graduate,7105375,163500,6941875
2558,3352,Manas Ranjan Mishra,BHUBANESWAR,IND,0,Post Graduate,38090100,0,38090100
2559,3271,Manasi Swain,DHENKANAL,SUCI(C),3,Post Graduate,453116,950000,-496884
2560,468,Manbodh Baghel,BASTAR,BSP,0,Graduate Professional,1405000,0,1405000
2561,3633,Manchak Trimbakrao Karale,PUNE,IND,0,Literate,1575000,0,1575000
2562,2095,Mandheer Singh Maan,FARIDABAD,IND,0,10th Pass,40072745,0,40072745
2563,3506,Mane Arvind Bhiva,HATKANANGLE,IND,0,12th Pass,557300,400000,157300
2564,2990,Maneesh Kumar Rawat,MORENA,Jai Maha Bharath Party,0,Graduate Professional,511000,0,511000
2565,7044,"Maneeshankar, M.G.",KARUR,Rashtriya Samaj Paksha,0,Graduate Professional,50000,650000,-600000
2566,3154,Maneka Sanjay Gandhi,PILIBHIT,BJP,1,12th Pass,374132826,219202,373913624
2567,437,Mange Ram,HISAR,BSP,0,12th Pass,14755486,0,14755486
2568,419,Mange Ram,SIRSA,BSP,0,Graduate,6507759,0,6507759
2569,661,Mange Ram Kashyap,MUZAFFARNAGAR,Majdoor Kisan Union Party,0,Graduate Professional,2663000,0,2663000
2570,7242,Mangesh Madhukar Humne,MUMBAI NORTH WEST,Bahujan Mukti Party,0,Graduate Professional,4048000,0,4048000
2571,2435,Mangi Lal Solanki,CHITTORGARH,Bahujan Mukti Party,0,10th Pass,11050206,70800,10979406
2572,2474,Mangilal,BARMER,AAP,0,Post Graduate,11414442,556105,10858337
2573,2298,Mangilal Nayak,BIKANER,National Unionist Zamindara Party,0,Graduate,1060000,0,1060000
2574,4204,Mangilal Urf Kranti Parivartan,MANDSOUR,BSP,0,Post Graduate,234900,0,234900
2575,1542,Mangleshwar Bhaiya,REWA,Naya Daur Party,0,12th Pass,760000,0,760000
2576,5842,Mango Pundlik Pagare,JALGAON,Rashtravadi Janata Party,0,Doctorate,55000,30000,25000
2577,5075,Mangu Ram Sain,ALWAR,Akhil Bharatiya Congress Dal (Ambedkar),0,12th Pass,72000,0,72000
2578,249,Mani Charenamei,OUTER MANIPUR,IND,0,Graduate,11422552,1108000,10314552
2579,7076,Mani Shankar Aiyar,MAYILADUTHURAI,INC,0,Post Graduate,84319020,4526676,79792344
2580,7127,"Mani, P.",PERAMBALUR,IND,0,10th Pass,2163000,0,2163000
2581,7520,"Mani, S.V.",THENI,IND,0,8th Pass,956543,112054,844489
2582,7066,Mani.G.K,KRISHNAGIRI,Pattali Makkal Katchi,11,Graduate,4704309,0,4704309
2583,7529,Manickam Tagore,VIRUDHUNAGAR,INC,1,Graduate Professional,17292470,4953498,12338972
2584,7057,"Manickavasagam, A.",KARUR,IND,0,Graduate,8874100,0,8874100
2585,4991,Manik,FATEHPUR SIKRI,Lok Dal,0,10th Pass,372000,0,372000
2586,5376,Manik Dahariya,BILASPUR,IND,0,8th Pass,251500,150000,101500
2587,7034,Manikandan I.,KANNIYAKUMARI,IND,1,12th Pass,2000,0,2000
2588,5444,Manikkavel M R,TIRUVANNAMALAI,JD(S),0,10th Pass,1030000,0,1030000
2589,3856,Manikrao Madhavrao Bavne,BEED,SP,0,Post Graduate,39351000,80000,39271000
2590,4703,Manilal Mahto,DHANBAD,IND,0,12th Pass,750860,0,750860
2591,7413,"Manimaran, M.",VELLORE,IND,0,8th Pass,0,0,0
2592,2897,Manish Katroliya,BHIND,BSP,0,Post Graduate,3179334,0,3179334
2593,396,Manish Kumar,NAWADA,IND,2,Graduate,1798755,428000,1370755
2594,1414,Manish Vinayakrao Telrandhe,WARDHA,IND,1,Graduate,4316000,162000,4154000
2595,6337,Manivannan N,DINDIGUL,IND,0,Post Graduate,920000,70000,850000
2596,7177,Manivasagam,RAMANATHAPURAM,IND,0,Graduate,900000,0,900000
2597,1917,Maniyangattil Sukumaran,THRISSUR,IND,0,Literate,281000,0,281000
2598,1353,Manjeet Singh,EAST DELHI,IND,0,Graduate Professional,143000,60000,83000
2599,2004,Manjeet Singh,SIRSA,IND,0,5th Pass,710000,0,710000
2600,28,Manju Chhibber,EAST DELHI,RPI(A),0,Graduate,31380000,0,31380000
2601,3142,Manju Devi,NAGINA,Lok Dal,0,10th Pass,266013,0,266013
2602,2680,Manju Devi,JAHANABAD,Krantikari Vikas Dal,1,Literate,1110000,0,1110000
2603,1245,Manju Kumari,KODARMA,AITC,0,Post Graduate,2598000,0,2598000
2604,2611,Manju. A.,HASSAN,INC,0,Graduate Professional,165271740,1131586,164140154
2605,3777,Manjunatha,HASSAN,Bharatiya Dr. B.R.Ambedkar Janta Party,0,5th Pass,150000,0,150000
2606,2235,Manjunatha G,UDUPI CHIKMAGALUR,IND,0,12th Pass,0,0,0
2607,4836,Manjur Alahi Munshi,MALDAHA DAKSHIN,IND,0,10th Pass,4835000,0,4835000
2608,7578,"Manmathan,M.",TENKASI,IND,0,8th Pass,607100,89100,518000
2609,3986,Mannu Lal Parganiha,DURG,Chhattisgarh Swabhiman Manch,0,8th Pass,3912484,0,3912484
2610,4761,Manohar Ahiriya,DEWAS,IND,0,12th Pass,985000,0,985000
2611,1119,Manohar Baliram Sonone,AMRAVATI,IND,1,12th Pass,5006000,1705000,3301000
2612,4025,Manohar Sinku,SINGHBHUM,BSP,0,Graduate,2228000,0,2228000
2613,1779,Manohar Tirkey,ALIPURDUARS,Revolutionary Socialist Party,0,10th Pass,10594756,0,10594756
2614,4178,Manohar Untwal,DEWAS,BJP,0,12th Pass,6336490,1448086,4888404
2615,1093,Manohar.H.Ayyannavar,BANGALORE NORTH,IND,0,Graduate Professional,12862871,0,12862871
2616,1805,Manoharan K,KASARAGOD,IND,2,Graduate,171100,0,171100
2617,7138,Manoharan.M,POLLACHI,BSP,0,Graduate Professional,2602000,0,2602000
2618,835,Manoj Choudhury,BERHAMPUR,AITC,0,10th Pass,163000,0,163000
2619,1252,Manoj Kumar,KODARMA,IND,0,Post Graduate,8410000,10000,8400000
2620,1270,Manoj Kumar,ROHTAK,BSP,0,12th Pass,13590000,0,13590000
2621,1261,Manoj Kumar,PALAMAU,RJD,1,Graduate,8357000,2350000,6007000
2622,2052,Manoj Kumar,SONIPAT,IND,0,Graduate Professional,5915698,685000,5230698
2623,629,Manoj Kumar Manjhi,JAMUI,IND,0,12th Pass,121000,150000,-29000
2624,4740,Manoj Kumar Ray,GODDA,IND,0,10th Pass,50500,0,50500
2625,4405,Manoj Kumar Soni,HATHRAS,BSP,0,Post Graduate,130780329,3900000,126880329
2626,4825,Manoj Kumar Yadav,VIDISHA,SP,0,Post Graduate,3545837,740000,2805837
2627,5111,Manoj Rajoria,KARAULI-DHOLPUR,BJP,0,12th Pass,28636113,3277324,25358789
2628,66,Manoj Tiwari,NORTH EAST DELHI,BJP,0,Post Graduate,199483924,34645630,164838294
2629,2085,Manoj Yadav,GURGAON,IND,0,12th Pass,3298000,1450000,1848000
2630,239,Manorom Gogoi,JORHAT,AAP,0,Post Graduate,6659665,1647593,5012072
2631,5265,Manowar Alam,KISHANGANJ,Janta Dal Rashtravadi,0,12th Pass,465813,215,465598
2632,4732,Manraj,GODDA,BSP,0,Post Graduate,22084558,0,22084558
2633,2442,Manshankar Ninama,BANSWARA,BJP,0,8th Pass,4040285,870146,3170139
2634,799,Mansid Ekka,SUNDARGARH,IND,2,12th Pass,630000,280000,350000
2635,4492,Mansoor Alam,PURNIA,SP,0,12th Pass,7196656,600000,6596656
2636,4716,Mantosh Kumar Mandal,DHANBAD,Amra Bangalee,0,Post Graduate,2025930,0,2025930
2637,530,Mantu Saikia,KALIABOR,IND,0,10th Pass,5575521,6168003,-592482
2638,3367,Manuel Sabino D'Souza,MAVAL,IND,0,Graduate,647000,0,647000
2639,5599,Manyar Shai. Sajid Shai. Kadar,RAVER,Minorities Democratic Party,0,Graduate,42000,0,42000
2640,1962,Manzoor Thengana,PATHANAMTHITTA,SDPI,1,Others,43900000,0,43900000
2641,174,Maraganna Hunnur,BIJAPUR,IND,0,Graduate,375000,0,375000
2642,7006,Maragatham K,KANCHEEPURAM,AIADMK,0,12th Pass,18949050,4468600,14480450
2643,7014,Maragatham M,KANCHEEPURAM,IND,0,8th Pass,122000,0,122000
2644,46,Maratha Virender Verma,KARNAL,BSP,0,Graduate Professional,96600000,0,96600000
2645,7521,"Mariappan, S.K.",THENI,IND,2,Graduate,240000,32000,208000
2646,7548,Marimuthu,VIRUDHUNAGAR,IND,0,10th Pass,280000,0,280000
2647,6896,Marimuthu. P,CHENNAI NORTH,IND,0,5th Pass,3861000,120000,3741000
2648,6897,Mariraj. T.R,CHENNAI NORTH,IND,0,8th Pass,35000,0,35000
2649,860,Marpalli Ramiah Vasudeva,DAKSHINA KANNADA,AAP,0,Post Graduate,15692369,0,15692369
2650,5943,Martis Clifard Lorence,MUMBAI SOUTH CENTRAL,IND,0,Graduate Professional,7515805,126000,7389805
2651,7041,"Maruthaiveeran, V.",KARUR,BSP,0,Illiterate,21000,0,21000
2652,7128,"Marutharaj, P.",PERAMBALUR,IND,0,8th Pass,930000,180000,750000
2653,2123,Maruti,RAICHUR,National Development Party,0,Graduate Professional,50000,0,50000
2654,2189,Maruti Ramappa Hanasi,DHARWAD,IND,0,Graduate,2243000,230000,2013000
2655,7149,Mary Stella. M,POLLACHI,IND,0,8th Pass,6658000,2625000,4033000
2656,7377,"Masilamani, R. (Dr).",SRIPERUMBUDUR,MDMK,0,Post Graduate,20199073,0,20199073
2657,5698,Mass Ganesh A,SALEM,Thrinamool Tamil Nadu Congress,0,10th Pass,275100,0,275100
2658,3086,Massarrat Warsi,BAREILLY,CPI,0,12th Pass,983000,0,983000
2659,2483,Master Bhaira Ram Meghwal,BARMER,IND,0,Graduate,20000,0,20000
2660,3920,Master Sajid Siddiqui,BHOPAL,SDPI,0,Graduate Professional,3148467,0,3148467
2661,2059,Master Sher Singh,BHIWANI-MAHENDRAGARH,CPI(M),0,Graduate Professional,12962284,500926,12461358
2662,3826,Masudul Islam,MURSHIDABAD,SDPI,0,8th Pass,1046590,0,1046590
2663,7221,Matchindra Hanumantrao Chate,MUMBAI NORTH EAST,BSP,1,Graduate Professional,48299405,5348951,42950454
2664,5827,Mate Bharat Kisan,DINDORI,Bahujan Mukti Party,0,Post Graduate,4920887,1001402,3919485
2665,218,Mate Manohar Alias Mama,BHANDARA-GONDIYA,IND,0,8th Pass,191077,0,191077
2666,1963,Mathew Parey,PATHANAMTHITTA,IND,0,Graduate Professional,200000,0,200000
2667,308,Mathew T Thomas,KOTTAYAM,JD(S),4,Graduate Professional,10379737,649181,9730556
2668,4370,Mausam Noor,MALDAHA UTTAR,INC,0,Graduate Professional,9778222,28534,9749688
2669,2605,Maxim Pinto,DAKSHINA KANNADA,IND,0,10th Pass,25265000,5500000,19765000
2670,5909,Mayank Ramesh Gandhi,MUMBAI NORTH WEST,AAP,0,Graduate,31416461,18016075,13400386
2671,6344,Mayilsamy K,ERODE,IND,0,Graduate,365500,20000,345500
2672,984,Md Afaq,CHANDNI CHOWK,Jai Maha Bharath Party,0,5th Pass,4374000,0,4374000
2673,5267,Md Akhtar Ali,PURNIA,IND,0,Literate,110551,0,110551
2674,5233,Md Aslam Beg,ARARIA,Janta Dal Rashtravadi,1,12th Pass,15000,63733,-48733
2675,4841,Md Ezaruddin,MALDAHA DAKSHIN,Jamat-E-Seratul Mustakim,0,Post Graduate,542142,0,542142
2676,4839,Md Faruque Hossain,MALDAHA DAKSHIN,IUML,0,Post Graduate,3143672,424909,2718763
2677,1253,Md Jalil Ansari,KODARMA,National Loktantrik Party,0,Illiterate,541600,0,541600
2678,4113,Md Shahid Akhtar,PURNIA,Bahujan Mukti Party,0,Graduate,5457339,0,5457339
2679,5270,Md Shamsher Alam,PURNIA,JMM,1,12th Pass,6135336,300000,5835336
2680,1140,Md. Ali Hussain,SAMBALPUR,IND,0,12th Pass,9030000,4420000,4610000
2681,2914,Md. Ateek,BHOPAL,Prajatantrik Samadhan Party,0,Post Graduate,663000,0,663000
2682,560,Md. Dilbas Ansari,KARAKAT,IND,0,Post Graduate,70000,0,70000
2683,4865,Md. Dilir Khan,BARPETA,IND,0,Graduate,187306,0,187306
2684,3989,Md. Ginnatulla Sk,JANGIPUR,Jamat-E-Seratul Mustakim,0,Post Graduate,190721,0,190721
2685,3330,Md. Iliyas Md. Amir Maniyar,PARBHANI,Bharipa Bahujan Mahasangh,0,Graduate,15000,82800,-67800
2686,5258,Md. Iqbal Ahmad,KATIHAR,Samajwadi Janata Party (Rashtriya),2,Others,2827500,0,2827500
2687,2684,Md. Istiyak,JAHANABAD,AITC,2,Graduate Professional,9481904,0,9481904
2688,4738,Md. Jenul,GODDA,Bahujan Mukti Party,1,Graduate Professional,3280000,0,3280000
2689,4375,Md. Khodabox Sekh,MURSHIDABAD,Welfare Party Of India,0,Graduate,1915000,0,1915000
2690,4359,Md. Moazzem Hossain,MALDAHA DAKSHIN,AITC,0,Post Graduate,8580219,0,8580219
2691,4374,Md. Najmul Hoque,MURSHIDABAD,AIUDF,0,Post Graduate,1267080,0,1267080
2692,4365,Md. Najrul Islam,MALDAHA DAKSHIN,AIUDF,0,Others,1225345,0,1225345
2693,4741,Md. Noor Hassan,GODDA,Samata Party,3,Graduate,203000,0,203000
2694,3825,Md. Nurul Islam,MALDAHA UTTAR,Welfare Party Of India,0,Graduate Professional,12148752,0,12148752
2695,3821,Md. Sahabuddin,JANGIPUR,SDPI,2,Post Graduate,1407507,30000,1377507
2696,4380,Md. Salim,RAIGANJ,CPI(M),0,Post Graduate,7868013,0,7868013
2697,5257,Md. Tariq Anwar,KATIHAR,IND,0,12th Pass,113000,0,113000
2698,4431,Md. Zakir Hussain,GAUHATI,IND,0,12th Pass,1823905,0,1823905
2699,4709,Md. Zubair,DHANBAD,All India Minorities Front,0,Graduate,659395,0,659395
2700,4485,Md.Naushad,KISHANGANJ,BSP,0,8th Pass,370000,316000,54000
2701,3289,Md.Samim Aktar,KENDRAPARA,AAP,0,Graduate Professional,850000,0,850000
2702,7227,Medha Patkar,MUMBAI NORTH EAST,AAP,9,Post Graduate,209226,0,209226
2703,2647,Meena,ARRAH,JD(U),0,Graduate,90737486,6915766,83821720
2704,4807,Meena Devid,RATLAM,IND,0,12th Pass,418377,0,418377
2705,1326,Meena Singla,NEW DELHI,Poorvanchal Rashtriya Congress,0,Graduate,13840344,517041,13323303
2706,4202,Meenakshi Natarajan,MANDSOUR,INC,1,Post Graduate,4682146,234415,4447731
2707,4801,Meenakshi Pande,MANDSOUR,IND,0,8th Pass,100548,0,100548
2708,7509,"Meenakshi Sundaram, G.K.",THENI,SP,0,12th Pass,6504269,892475,5611794
2709,7573,Meenashisundaravadivel.T.,TENKASI,CPI(ML) Red Star,2,10th Pass,5000,0,5000
2710,5912,Meera Ashish Sanyal,MUMBAI SOUTH,AAP,0,Post Graduate,509461553,13849761,495611792
2711,1175,Meganada Sabar,KORAPUT,CPI(ML)L,0,10th Pass,200000,0,200000
2712,7482,Megaraj Mallar,SIVAGANGA,IND,0,8th Pass,0,0,0
2713,4319,Megh Singh,FATEHPUR SIKRI,Peace Party,0,12th Pass,6930000,412000,6518000
2714,946,Meghe Sagar Dattatraya,WARDHA,INC,0,Graduate,340138817,118145553,221993264
2715,2447,Meghraj Tawar,UDAIPUR,CPI,0,10th Pass,1405000,0,1405000
2716,1073,Mehaboobsab Pathan,HAVERI,IND,0,5th Pass,8300000,150000,8150000
2717,879,Mehar Manav Bhagat,JAMMU,Bharatiya Bahujan Party,0,Graduate Professional,32000,0,32000
2718,4477,Mehboob Alam,KATIHAR,CPI(ML)L,11,12th Pass,1215962,0,1215962
2719,3927,Mehboob Khan,BHOPAL,IND,0,Graduate,6959000,525000,6434000
2720,4146,Mehbooba Mufti,ANANTNAG,JKPDP,1,Graduate Professional,5200000,0,5200000
2721,7212,Meher A. Mallick,MUMBAI NORTH CENTRAL,Bahujan Mukti Party,0,Post Graduate,13859021,40000,13819021
2722,3447,Mehmooda Begam Abbasi,JODHPUR,IND,0,Literate,1795520,0,1795520
2723,362,Meira Kumar,SASARAM,INC,0,Post Graduate,384751309,0,384751309
2724,220,Meshram Dnyaneshwar Tukaram,YAVATMAL-WASHIM,IND,0,Graduate,133000,39060,93940
2725,426,Mewa Singh,SIRSA,IND,0,5th Pass,5696200,0,5696200
2726,3211,Mewaram,SHAHJAHANPUR,Naitik Party,0,12th Pass,2116552,0,2116552
2727,3538,Mhamane Anil Subhash,KOLHAPUR,IND,1,Post Graduate,4920000,1282195,3637805
2728,5864,Mhaske Dilip Datta,JALNA,AAP,0,Post Graduate,766000,0,766000
2729,4846,Milan Das,MALDAHA UTTAR,SP,0,12th Pass,5502108,1201557,4300551
2730,7198,Milind Shankar Repe,MUMBAI NORTH,IND,0,Graduate,13498923,0,13498923
2731,3690,Milindraje Digambar Bhosale,SHIRUR,IND,0,10th Pass,3274,0,3274
2732,4797,Minakshi Chouhan,MANDSOUR,IND,0,12th Pass,65000,0,65000
2733,7205,Minakshi Mukund Jadhav,MUMBAI NORTH CENTRAL,IND,0,5th Pass,21300,0,21300
2734,4372,Minara Khatun,MALDAHA UTTAR,Hindustan Krantikari Dal,0,10th Pass,1172926,0,1172926
2735,2739,Minendra Kumar Singh,PATALIPUTRA,IND,0,Others,1867902,0,1867902
2736,5566,Mirja Mukarram Baig,FIROZABAD,IND,0,8th Pass,1000,0,1000
2737,2820,Mirnal Kanti Dev,GIRIDIH,Socialist Party (Lohia),0,12th Pass,331000,0,331000
2738,7615,Mirza Afsar Beg,JALNA,Welfare Party Of India,0,5th Pass,1756142,0,1756142
2739,4148,Mirza Mehboob Beg,ANANTNAG,JKNC,0,Graduate Professional,10710000,0,10710000
2740,2130,Mirza Shafee Baig,BIDAR,IND,0,8th Pass,0,0,0
2741,1458,Mirza Vahed Beg Ahmadbeg,BHANDARA-GONDIYA,IND,0,12th Pass,1513581,0,1513581
2742,2746,Misha Bharti,PATALIPUTRA,RJD,1,Graduate Professional,47634901,0,47634901
2743,2503,Miss Patal Kanya Jamatia,TRIPURA EAST,IND,0,Post Graduate,30000,0,30000
2744,1242,Mister Alam Asrafee,CHATRA,Rashtriya Jankranti Morcha,0,Graduate,911000,0,911000
2745,2843,Mithalesh Kumar Mahto,HAZARIBAGH,AAP,1,Doctorate,8251000,0,8251000
2746,3208,Mithilesh Kumar,SHAHJAHANPUR,SP,0,Graduate,28206768,7242790,20963978
2747,5239,Mithilesh Kumar Singh,BANKA,National Loktantrik Party,0,10th Pass,1986983,0,1986983
2748,531,Mithual Kumar,KALIABOR,AIFB,0,8th Pass,1630000,0,1630000
2749,1982,Mittu Mujavar,NORTH GOA,IND,0,12th Pass,6871000,1121500,5749500
2750,4308,Mo Tamajid,FARRUKHABAD,Peace Party,0,5th Pass,350000,0,350000
2751,2390,Mo. Hafiz Khan Varasi,JAIPUR,IND,0,8th Pass,75000,0,75000
2752,2437,Mo. Imtiyaz,CHITTORGARH,IND,0,8th Pass,1756000,0,1756000
2753,5221,Mo. Ismile Jumman,DHULE,IND,1,5th Pass,79000,0,79000
2754,2842,Mo. Shanul Haque,HAZARIBAGH,IUML,0,12th Pass,194500,0,194500
2755,2846,Mobin Khan,JAMSHEDPUR,IND,0,12th Pass,2865000,117000,2748000
2756,3729,Modi Saifulla,BANGALORE CENTRAL,IND,0,5th Pass,285000,0,285000
2757,1756,Mohamad Adeeb,BIJNOR,Rashtrawadi Samaj Party,0,Post Graduate,26241383,0,26241383
2758,7373,"Mohamed Abbas, S. Thiru",SRIPERUMBUDUR,BSP,0,Graduate,200000,0,200000
2759,7157,Mohamed Jaleel .S,RAMANATHAPURAM,DMK,0,Graduate Professional,294761445,47707836,247053609
2760,6898,Mohamed Majasuddin,CHENNAI NORTH,IND,0,8th Pass,3709219,3800000,-90781
2761,7522,"Mohamed Miakhan, P.",THENI,IND,0,5th Pass,1064000,0,1064000
2762,7591,Mohamed Mubarak.V.M.S,TIRUNELVELI,SDPI,1,Graduate,660000,0,660000
2763,4776,Mohamed Tanvir,INDORE,IND,0,5th Pass,10000,0,10000
2764,7192,Mohammad Akhtar Mehboob Shaikh,MUMBAI NORTH,Prabuddha Republican Party,0,8th Pass,2515000,0,2515000
2765,4850,Mohammad Ali,MURSHIDABAD,AITC,1,Post Graduate,16756495,0,16756495
2766,2323,Mohammad Ali Khan,CHURU,Bahujan Sangharshh Dal,0,Literate,3107000,1394000,1713000
2767,5281,Mohammad Amanullah,SUPAUL,IUML,0,Graduate,1000,0,1000
2768,7616,Mohammad Asad Shaikh Ahemad,JALNA,Minorities Democratic Party,0,8th Pass,4523000,442455,4080545
2769,3085,Mohammad Aslam,BAREILLY,Peace Party,0,Graduate Professional,720729,0,720729
2770,4488,Mohammad Asrarul Haque,KISHANGANJ,INC,2,Post Graduate,4616629,0,4616629
2771,4487,Mohammad Gulab Siddiqui,KISHANGANJ,Loktantrik Janata Party (Secular),0,8th Pass,296809,0,296809
2772,4108,Mohammad Hamid Mobarak,KATIHAR,AITC,0,Graduate,2677359,0,2677359
2773,3008,Mohammad Hanif Qurashi,SAGAR,IND,1,Literate,2850500,0,2850500
2774,4775,Mohammad Imtiyaz Khan,INDORE,IND,0,Graduate,338000,0,338000
2775,1017,Mohammad Jahid Husain,NAWADA,AITC,0,Graduate,1657448,0,1657448
2776,1759,Mohammad Moosa,BIJNOR,Peace Party,0,Graduate,8740204,0,8740204
2777,991,Mohammad Shakeel Saifi,EAST DELHI,BSP,1,Literate,29743591,458360,29285231
2778,4689,Mohammad Shrif,ANANTNAG,BSP,0,Graduate Professional,2327215,0,2327215
2779,4111,Mohammad Wasiqur Rahman,KISHANGANJ,IUML,2,12th Pass,4830500,166000,4664500
2780,4687,Mohammad Yaqoob Rather,ANANTNAG,All Jammu and Kashmir Republican Party,0,8th Pass,11450000,500000,10950000
2781,4251,Mohammed Azharuddin,TONK-SAWAI MADHOPUR,INC,0,Graduate,97334682,9901034,87433648
2782,21,Mohammed Faizal.P.P,LAKSHADWEEP,NCP,3,Post Graduate,538119,0,538119
2783,1350,Mohammed Naeem,EAST DELHI,IND,1,10th Pass,2314000,59000,2255000
2784,3740,Mohammed Qutbuddin,BANGALORE NORTH,IND,0,10th Pass,465000,0,465000
2785,7211,Mohammed Rafik Hussain Shaikh,MUMBAI NORTH CENTRAL,National Loktantrik Party,0,5th Pass,1660000,0,1660000
2786,3755,Mohammed Rafiq,BIDAR,IND,0,5th Pass,50000,0,50000
2787,662,Mohammed Yamin,MUZAFFARNAGAR,AAP,0,10th Pass,13243000,0,13243000
2788,5982,Mohan Barku Guhe,PALGHAR,Bharipa Bahujan Mahasangh,0,Graduate Professional,600000,1100000,-500000
2789,7241,Mohan Galvankar,MUMBAI NORTH WEST,The Lok Party of India,0,Graduate Professional,41055000,0,41055000
2790,1291,Mohan Kanuga,SOUTH DELHI,JKNPP,0,Post Graduate,7839000,0,7839000
2791,1609,Mohan Lal,KAIRANA,IND,0,12th Pass,9741331,0,9741331
2792,4658,Mohan Lal Bargahi,KORBA,IND,0,10th Pass,9142637,0,9142637
2793,2413,Mohan Lal Mahawar,KOTA,IND,0,12th Pass,9702000,0,9702000
2794,2801,Mohan Lal Patel,MAHASAMUND,Bhartiya Shakti Chetna Party,0,10th Pass,4383500,0,4383500
2795,353,Mohan Marotrao Karemore,NAGPUR,IND,0,10th Pass,6008449,200000,5808449
2796,1059,Mohan Motannavar,CHIKKODI,IND,0,Graduate,1119300,90000,1029300
2797,4423,Mohan Shyam,MATHURA,Gareeb Aadmi Party,0,Graduate Professional,18066000,6000000,12066000
2798,1825,Mohan Yallappa More,BELGAUM,IND,0,10th Pass,1267950,0,1267950
2799,7102,Mohan. G,NAGAPATTINAM,IND,0,Graduate Professional,191618,52500,139118
2800,4032,Mohan.P.S,DHARMAPURI,AIADMK,0,Graduate Professional,16814138,1200000,15614138
2801,7602,Mohan.T,TIRUNELVELI,IND,0,Graduate,435000,0,435000
2802,2585,Mohana Dasari,CHITRADURGA,AAP,0,Graduate,1549000,63538863,-61989863
2803,1958,Mohanan D,ALAPPUZHA,AAP,0,Post Graduate,21114000,600000,20514000
2804,2251,Mohananda Das,KARIMGANJ,IND,0,10th Pass,600000,0,600000
2805,7533,Mohanraj,VIRUDHUNAGAR,Jebamani janatha,0,Graduate,23380000,1550000,21830000
2806,6982,"Mohanraj, K.",COIMBATORE,IND,0,8th Pass,80000,0,80000
2807,7554,Mohanraj. A,THOOTHUKKUDI,CPI,2,Graduate Professional,8475249,1294500,7180749
2808,4874,Mohar Uddin Mondal,DHUBRI,IND,0,Graduate Professional,4332581,9000,4323581
2809,1004,Mohd Arif Siddique,NORTH EAST DELHI,AITC,0,Illiterate,330000,0,330000
2810,3895,Mohd Arshad Malik,UDHAMPUR,JKPDP,0,10th Pass,7042892,0,7042892
2811,3198,Mohd Aslam Urf Pasha,SAMBHAL,RPI(A),0,Literate,6443300,0,6443300
2812,1001,Mohd Hasnan Khan,NORTH EAST DELHI,JKNPP,0,5th Pass,3700000,0,3700000
2813,977,Mohd Mursaleem,CHANDNI CHOWK,Peace Party,0,12th Pass,470700,0,470700
2814,3168,Mohd Naeem Ansari,PILIBHIT,IND,0,Graduate,355000,0,355000
2815,1360,Mohd Naseer,EAST DELHI,Peace Party,0,8th Pass,4398632,0,4398632
2816,1367,Mohd Shahid Siddiqui,EAST DELHI,AITC,0,12th Pass,40044000,2010000,38034000
2817,4692,Mohd Yousif Ganie,ANANTNAG,Ambedkar Samaj Party,0,Graduate,2020000,0,2020000
2818,3118,Mohd Zafar Iqbal,MORADABAD,Akhil Bharatiya Muslim League (Secular),0,Graduate,1725000,0,1725000
2819,882,Mohd. Abbas Khan,JAMMU,IND,0,Graduate Professional,218316,261000,-42684
2820,1563,Mohd. Adil,JABALPUR,IUML,0,12th Pass,183325,0,183325
2821,751,Mohd. Aftab Alam,JABALPUR,BSP,1,Post Graduate,4282755,14000000,-9717245
2822,945,Mohd. Alim Patel Mohd. Wahid,WARDHA,AAP,0,Post Graduate,2882200,0,2882200
2823,1750,Mohd. Firoz Aftab,SAHARANPUR,IND,1,Graduate Professional,6305818,0,6305818
2824,1371,Mohd. Hasnain,NORTH EAST DELHI,IND,2,10th Pass,30000,0,30000
2825,885,Mohd. Imtiaz,JAMMU,IND,0,Graduate,0,0,0
2826,1551,Mohd. Jahangeer Ansari,SIDHI,IND,0,Not Given,56300,0,56300
2827,3054,Mohd. Jarrar,AONLA,Bhartiya Naujawan Inklav Party,0,8th Pass,5305000,0,5305000
2828,1439,Mohd. Javed Mohd Mustak,NAGPUR,Democratic Secular Party,0,12th Pass,160500,250000,-89500
2829,3321,Mohd. Maroof Ab. Rauf,NANDED,IND,0,12th Pass,568655,112000,456655
2830,1276,Mohd. Mukim,FARIDABAD,National Loktantrik Party,0,10th Pass,3999000,80000,3919000
2831,1717,Mohd. Sabir Ansari,GAUTAM BUDHHA NAGAR,AITC,0,5th Pass,681600,0,681600
2832,1801,Mohd. Sabir Rahi,ALIGARH,AAP,0,10th Pass,15227199,0,15227199
2833,1632,Mohd. Sajid Saifi,MEERUT,Bahujan Mukti Party,1,5th Pass,341178,0,341178
2834,1621,Mohd. Yamin,MUZAFFARNAGAR,All India Ravidas Samata Party,0,Illiterate,12000,0,12000
2835,1633,Mohd.Usman Ghazi,MEERUT,Rashtriya Apna Dal,0,12th Pass,1005000,0,1005000
2836,4873,Mohendra Chandra Roy,DHUBRI,IND,0,8th Pass,161205,0,161205
2837,3565,Mohite Patil Vijaysinh Shankarrao,MADHA,NCP,1,10th Pass,170253390,9774791,160478599
2838,3994,Mohite-Patil Pratapsinh Shankarrao,MADHA,IND,1,Graduate,262989287,23367636,239621651
2839,5170,Mohmmad Kismatwala Kasim Kismatwala,AURANGABAD,Gareeb Aadmi Party,0,8th Pass,635000,0,635000
2840,5937,Moin Sohil Sayyad,MUMBAI SOUTH CENTRAL,IND,0,5th Pass,270000,0,270000
2841,5405,Moinudin Tanvar,RAIPUR,IND,0,5th Pass,400000,0,400000
2842,3478,Moirangthem Nara,INNER MANIPUR,CPI,0,Graduate Professional,1867499,2785815,-918316
2843,2658,Mokaram Hussain,BUXAR,Suheldev Bhartiya Samaj Party,0,10th Pass,2115487,0,2115487
2844,4373,Monatan Hembram,MALDAHA UTTAR,Bahujan Mukti Party,0,Graduate,48000,0,48000
2845,504,Moni Kumar Subba,TEZPUR,IND,2,8th Pass,3067535137,1400740132,1666795005
2846,2667,Monibur Rahman,BUXAR,Janta Dal Rashtravadi,0,12th Pass,3130000,0,3130000
2847,4866,Monirul Hussain,DHUBRI,IND,0,12th Pass,453385,0,453385
2848,4357,Monirul Islam,JANGIPUR,Welfare Party Of India,1,Graduate,539830,0,539830
2849,7179,Mookaiya .S,RAMANATHAPURAM,IND,0,5th Pass,73867,0,73867
2850,3436,Moola Ram,JALORE,IND,0,10th Pass,5430617,0,5430617
2851,2604,Moose Kunhi,DAKSHINA KANNADA,BSP,0,5th Pass,667631,152465,515166
2852,1636,Morarji Nagma Arvind,MEERUT,INC,0,Graduate,117912089,2978643,114933446
2853,1469,Moreshwar Ramaji Meshram,BHANDARA-GONDIYA,IND,0,Graduate,15858255,695510,15162745
2854,5891,Mote Chandrakant Rambhaji,KALYAN,IND,0,10th Pass,5536065,325500,5210565
2855,3907,Moti Lal Sahu S/O Bajaraha Ram Sahu,MAHASAMUND,IND,0,12th Pass,7759000,0,7759000
2856,4065,Moti Lal Sahu S/O Sone Lal Sahu,MAHASAMUND,IND,0,8th Pass,1354000,0,1354000
2857,75,Mrinal Kumar Saikia,KALIABOR,BJP,0,Post Graduate,3360000,50000,3310000
2858,3949,Mu.Anbhalagan,TIRUCHIRAPPALLI,DMK,10,Post Graduate,78217356,12964048,65253308
2859,186,Mu.Venkatesh Simha Bhovi,BANGALORE NORTH,IND,0,Not Given,9945000,0,9945000
2860,581,Muhammed Hamdullah Sayeed,LAKSHADWEEP,INC,0,Graduate Professional,40192946,358156,39834790
2861,1870,Muhammed Riyas,KOZHIKODE,IND,0,10th Pass,441500,0,441500
2862,709,Muhammed Sharafudheen,IDUKKI,SDPI,0,Graduate,415000,280000,135000
2863,4409,Muhar Singh,KANNAUJ,IND,0,10th Pass,6401000,60000,6341000
2864,5125,Mukesh,TONK-SAWAI MADHOPUR,AAP,0,Post Graduate,4035502,0,4035502
2865,1603,Mukesh Babu Ahirwar,HOSHANGABAD,IND,0,10th Pass,1260000,0,1260000
2866,228,Mukesh Kumar,MEERUT,IND,0,Graduate Professional,2150500,1200000,950500
2867,5047,Mukesh Kumar,MAINPURI,IND,0,Graduate,7441200,0,7441200
2868,999,Mukesh Kumar Arora,NORTH EAST DELHI,IND,0,Graduate,13688864,3970000,9718864
2869,2908,Mukesh Kumar Bansal,BHOPAL,Samta Vikas Party,0,10th Pass,36300,0,36300
2870,5050,Mukesh Kumar Shakya,MAINPURI,IND,0,Graduate,3377738,0,3377738
2871,2096,Mukesh Kumar Singh,FARIDABAD,IND,0,12th Pass,1928506,0,1928506
2872,4105,Mukesh Kumar Sinha,BANKA,Bhartiya Ekta Manch Party,0,Doctorate,6905132,2588967,4316165
2873,4310,Mukesh Rajput,FARRUKHABAD,BJP,0,Graduate Professional,26178100,151603,26026497
2874,4979,Mukesh Rajput,FARRUKHABAD,IND,0,10th Pass,725000,0,725000
2875,4963,Mukesh Singh,ETAWAH,Peace Party,0,Doctorate,1467329,0,1467329
2876,2755,Mukul Kumar Sharma,PATALIPUTRA,Sankhyanupati Bhagidari Party,1,10th Pass,2212400,0,2212400
2877,3414,Mukul Mishra,AJMER,Akhil Bharat Hindu Mahasabha,0,12th Pass,51000,0,51000
2878,229,Mukul Upadhyay,GHAZIABAD,BSP,0,10th Pass,167355710,18751971,148603739
2879,936,Mukul Wasnik,RAMTEK,INC,2,Post Graduate,16119417,0,16119417
2880,94,Mul Chand,GURGAON,IND,0,10th Pass,33392000,750000,32642000
2881,3460,Mularam,NAGAUR,IND,0,Literate,3470000,0,3470000
2882,5045,Mulayam Singh Yadav,MAINPURI,SP,0,Post Graduate,159671544,0,159671544
2883,260,Mullappally Ramachandran,VADAKARA,INC,0,Post Graduate,9225000,2160000,7065000
2884,7462,Mummoorthi.S@S.M.Moorthy,THANJAVUR,Namadhu Makkal Katchi,2,Graduate,8005000,1800000,6205000
2885,3849,Munde Gopinathrao Pandurang,BEED,BJP,3,Graduate Professional,380072890,335729817,44343073
2886,7579,Muneeswaran,TENKASI,IND,0,8th Pass,613900,223600,390300
2887,3160,Munesh Singh,PILIBHIT,IND,0,8th Pass,5279115,0,5279115
2888,7067,Muniraj.K,KRISHNAGIRI,Ulzaipali Makkal Katchy,0,5th Pass,172000,0,172000
2889,4679,Munna Chandrakar,DURG,BSP,0,8th Pass,4547946,45000,4502946
2890,2382,Munna Dass Dabodia,JAIPUR,IND,0,12th Pass,3312954,60000,3252954
2891,5003,Munna Lal,FATEHPUR SIKRI,Rashtriya mahan Gantantra Party,0,10th Pass,2971600,0,2971600
2892,2709,Munna Prasad,NALANDA,IND,0,10th Pass,350000,0,350000
2893,3466,Munni,PALI,INC,0,10th Pass,17225722,1297049,15928673
2894,4268,Munni Devi,AKBARPUR,IND,0,10th Pass,768692,0,768692
2895,4708,Munshi Hembram,DHANBAD,IND,0,Literate,2653000,482,2652518
2896,3067,Munshi Lal,BADAUN,IND,0,12th Pass,832251,50000,782251
2897,7089,Munusamy.V,MAYILADUTHURAI,IND,0,5th Pass,110000,0,110000
2898,3911,Murad Bhai,RAJNANDGAON,IND,0,10th Pass,12400000,120000,12280000
2899,5687,Murali.V,NAMAKKAL,IND,0,Graduate,1425800,0,1425800
2900,6850,Muralikrishnan (A) Samaran,CHENNAI CENTRAL,BSP,1,12th Pass,5635750,1037250,4598500
2901,4837,Mursed Sekh,MALDAHA DAKSHIN,RPI(A),0,5th Pass,160500,0,160500
2902,4222,Mursid Ahmed,ALWAR,AITC,0,Graduate,63986428,88000,63898428
2903,7058,"Murugaan, N.",KARUR,IND,0,10th Pass,523120,0,523120
2904,7101,Murugaiyan. K,NAGAPATTINAM,IND,0,5th Pass,167000,0,167000
2905,7481,Murugan P,SIVAGANGA,IND,1,12th Pass,230000,60000,170000
2906,5435,Murugan P,TIRUVANNAMALAI,IND,0,Post Graduate,23000,0,23000
2907,7601,Murugan.S,TIRUNELVELI,IND,0,8th Pass,1620910,205000,1415910
2908,7461,Muruganantham.M,THANJAVUR,BJP,20,10th Pass,102000,0,102000
2909,5440,Murugesan K,TIRUVANNAMALAI,IND,0,12th Pass,4808164,0,4808164
2910,7045,"Murugesan, M.",KARUR,SP,0,Graduate,8190000,1400000,6790000
2911,4040,Murugesan_s,ERODE,IND,0,5th Pass,2566000,0,2566000
2912,7178,Murugeswari,RAMANATHAPURAM,IND,1,10th Pass,538600,0,538600
2913,975,Musarrat Jahan,CHANDNI CHOWK,Rashtriya Janmorcha,0,Graduate,3119753,0,3119753
2914,4149,Mushtaq Ahmad Malik,ANANTNAG,BJP,0,10th Pass,315000,0,315000
2915,272,Musthafa Kommeri,KOZHIKODE,SDPI,1,Graduate,1489200,0,1489200
2916,2627,Muthuraju,BANGALORE NORTH,RPI(A),0,Graduate,4655000,700000,3955000
2917,7523,"Muthuramalingam, M.",THENI,IND,0,Others,368660,333000,35660
2918,2104,Muttappa Channasangappa Angadi,BELGAUM,AAP,0,12th Pass,9470924,1524180,7946744
2919,3721,Muttappa Hirekumbi,BAGALKOT,IND,0,Literate,2887000,500000,2387000
2920,933,Muttemwar Vilasrao Baburao,NAGPUR,INC,0,Graduate,26382690,3569251,22813439
2921,2699,Muzaffar Fakhruddin,MUNGER,IND,0,Graduate,1883100,0,1883100
2922,4358,Muzaffar Hossain,JANGIPUR,CPI(M),0,12th Pass,1130866,0,1130866
2923,1812,N Abdulla Davud,KANNUR,BSP,0,10th Pass,3226369,50000,3176369
2924,7499,N Alagu Muthu Velayudam,MADURAI,IND,0,10th Pass,7200000,2100000,5100000
2925,1188,N B Krishnappa Nayaka,BELLARY,IND,0,Graduate Professional,169500,0,169500
2926,303,N J Pious,ERNAKULAM,IND,0,Graduate,3722750,150000,3572750
2927,470,N K P Nair,ANDAMAN & NICOBAR ISLANDS,CPI(ML)L,0,10th Pass,5287805,43642,5244163
2928,902,N Kannan,ANDAMAN & NICOBAR ISLANDS,IND,0,8th Pass,32400,549313,-516913
2929,1189,N R Mallaiah Swamy,BELLARY,IND,0,12th Pass,1333000,0,1333000
2930,333,N Sadanandan,MAVELIKKARA,AAP,0,Graduate Professional,4309529,0,4309529
2931,2161,N Y Hanumantappa,BELLARY,INC,0,Post Graduate,22848300,0,22848300
2932,2561,N.C.Puttaraju,MANDYA,IND,0,12th Pass,200000,0,200000
2933,361,N.Dharam Singh,BIDAR,INC,1,Post Graduate,236308464,53289216,183019248
2934,7420,N.Dineshkumar,TIRUPPUR,DMDK,3,Post Graduate,132560738,29692857,102867881
2935,7418,N.Gurusamy,TIRUPPUR,BSP,0,Post Graduate,5941492,0,5941492
2936,10,N.K.Biju,KOTTAYAM,SUCI(C),0,12th Pass,750,0,750
2937,14,N.K.Premachandran,KOLLAM,Revolutionary Socialist Party,1,Graduate Professional,16228989,3114638,13114351
2938,5466,N.Muthaiyan,VILUPPURAM,IND,0,8th Pass,20500,0,20500
2939,2586,N.S. Manjunatha Nerenahal,CHITRADURGA,IND,0,10th Pass,450000,0,450000
2940,4345,N.S.Krishnan,KARUR,DMDK,0,Post Graduate,7085000,0,7085000
2941,7421,N.Sivakumar,TIRUPPUR,Ulzaipali Makkal Katchy,0,5th Pass,400000,0,400000
2942,3787,N.Venkatesh,KOLAR,IND,0,10th Pass,6744000,1000000,5744000
2943,4139,Naarad Prasad Nishad,RAIPUR,IND,0,8th Pass,313400,0,313400
2944,1148,Naba Krushna Danta,BOLANGIR,IND,0,Graduate Professional,482285,606700,-124415
2945,4096,Naba Kumar Sarania,KOKRAJHAR,IND,3,12th Pass,2155559,0,2155559
2946,3258,Nabin Kumar Dalai,JAJPUR,IND,0,Graduate,307000,0,307000
2947,7620,Nade Dnyaneshwar Dagduji,JALNA,IND,0,8th Pass,5000,0,5000
2948,7611,Nadeem Rana,AURANGABAD,IND,0,12th Pass,3250000,0,3250000
2949,3855,Nadu Madhav,BEED,AAP,0,Graduate Professional,76855663,875946,75979717
2950,3122,Nafisuddin,MORADABAD,CPI(M),0,8th Pass,9951294,400000,9551294
2951,3575,Nagamani Kisan Jakkan,MADHA,IND,0,5th Pass,1165000,0,1165000
2952,2150,Naganath Patil,BIDAR,IND,0,Graduate,510000,0,510000
2953,3806,Nagappa Karatagi,KOPPAL,IND,0,Graduate,5205986,495000,4710986
2954,1830,Nagappa Shiraguppi,BAGALKOT,IND,0,Literate,45403,0,45403
2955,1068,Nagaraj,RAICHUR,CPI(ML) Red star,0,12th Pass,901500,114611,786889
2956,6981,"Nagaraj, S.",COIMBATORE,IND,0,5th Pass,140000,0,140000
2957,6335,Nagarajan V,DINDIGUL,IND,0,10th Pass,326000,0,326000
2958,6965,"Nagarajan, P.",COIMBATORE,AIADMK,0,Graduate Professional,34306545,2235538,32071007
2959,7086,Nagarajan. M,MAYILADUTHURAI,IND,0,Others,840000,0,840000
2960,1082,Nagarajappa,DAVANAGERE,IND,0,Illiterate,15000,0,15000
2961,2756,Nagendra Kumar,PATALIPUTRA,Bharat Vikas Morcha,0,Graduate,1166489,0,1166489
2962,796,Nagendra Kumar Pradhan,SAMBALPUR,BJD,0,Post Graduate,12796623,1461565,11335058
2963,2962,Nagendra Singh,KHAJURAHO,BJP,0,Graduate,44538002,0,44538002
2964,1236,Nagmani,CHATRA,AJSUP,1,12th Pass,87315758,0,87315758
2965,7031,Nagoor Meeran Peer Mohammed U.,KANNIYAKUMARI,IND,0,10th Pass,2855555,0,2855555
2966,4199,Naharsingh Richhuji Barde,KHARGONE,BSP,0,Graduate,2994951,135000,2859951
2967,653,Nahid Hasan,KAIRANA,SP,2,Graduate,30399449,2105000,28294449
2968,1078,Naik Santosh Omu,UTTARA KANNADA,BSP,0,Post Graduate,2577000,1230000,1347000
2969,3524,Naikwade Digambar Gunaji,HINGOLI,IND,0,5th Pass,100000,0,100000
2970,5641,Najakatali Kabir Ansari,THANE,IND,0,8th Pass,2054916,0,2054916
2971,582,Najmudheen.C.T,LAKSHADWEEP,CPI,7,Graduate,322000,0,322000
2972,646,Najrul Hassan Hashmi,KODARMA,AJSUP,0,Literate,1800614,0,1800614
2973,2494,Nakul Das Rai,SIKKIM,AITC,0,Graduate,22091161,115000,21976161
2974,1221,Nalin Kumar Katil,DAKSHINA KANNADA,BJP,1,10th Pass,8789001,1493367,7295634
2975,5261,Nalini Mandal,KATIHAR,IND,0,12th Pass,351119,0,351119
2976,7030,Nalla Thampy C.,KANNIYAKUMARI,IND,0,8th Pass,600005,0,600005
2977,691,Namdeo Anandrao Kannake,GADCHIROLI-CHIMUR,CPI,0,Graduate,3322000,400000,2922000
2978,540,Namdeo Pundlik Dongardive,BULDHANA,IND,1,Graduate Professional,17500,0,17500
2979,923,Namdeo Shedmake,CHANDRAPUR,IND,1,10th Pass,1074059,425000,649059
2980,4233,Namonarayan,DAUSA,INC,1,Graduate,36642035,0,36642035
2981,4448,Namrata Sarma,MANGALDOI,AAP,0,Post Graduate,219905,0,219905
2982,3379,Nana Kshirsagar,PUNE,Bharipa Bahujan Mahasangh,0,Post Graduate,88792,0,88792
2983,917,Nanabhau Falgunrao Patole,BHANDARA-GONDIYA,BJP,5,12th Pass,12738190,0,12738190
2984,3201,Nanad Ram Khharagwansi,SAMBHAL,IND,0,Literate,7605000,0,7605000
2985,2094,Nanak Chand,FARIDABAD,IND,0,10th Pass,512000,0,512000
2986,3365,Nanaware Pramod Mahadeo,MAVAL,IND,0,Graduate,365491,0,365491
2987,2765,Nand Kishore Singh,PATNA SAHIB,IND,0,Graduate Professional,21239370,654750,20584620
2988,2942,Nand Kishore Tyagi,GUNA,IND,0,8th Pass,171000,0,171000
2989,368,Nand Lal Ram,SASARAM,IND,0,8th Pass,688000,0,688000
2990,4784,Nand Lal Singh Chouhan,KHANDWA,IND,0,10th Pass,3366500,100000,3266500
2991,1582,Nand Lal Uikey,BALAGHAT,Chhattisgarh Swabhiman Manch,0,Post Graduate,8000,0,8000
2992,6312,Nandagopalakrishnan.K.,CUDDALORE,DMK,0,Graduate Professional,41858537,1162495,40696042
2993,4385,Nandakishor Singha,RAIGANJ,Amra Bangalee,0,10th Pass,727000,20000,707000
2994,4296,Nandakumar G,SALEM,IND,0,Others,6137168,0,6137168
2995,611,Nandan Nilekani,BANGALORE SOUTH,INC,0,Graduate Professional,77102957219,0,77102957219
2996,5171,Nandarkar Vishal Uddhav,AURANGABAD,IND,0,10th Pass,1088000,60000,1028000
2997,7399,"Nandha Kumar, V.",VELLORE,SP,0,Graduate,50000,0,50000
2998,3738,Nandini Alva,BANGALORE CENTRAL,JD(S),3,Graduate,807875641,37846084,770029557
2999,1483,Nandkishor Gangaram Rangari,CHANDRAPUR,Aambedkar-right Party of India,0,Post Graduate,4111000,1580000,2531000
3000,4194,Nandkumar Singh Chouhan,KHANDWA,BJP,0,Post Graduate,40188989,9561188,30627801
3001,4211,Nandlal Chauhan,UJJAIN,Bahujan Mukti Party,0,12th Pass,8829056,0,8829056
3002,4783,Nandlal Singh Chouhan (Nandu Bhaiya),KHANDWA,IND,0,5th Pass,420000,450000,-30000
3003,3770,Nanjappa,CHIKKBALLAPUR,IND,0,5th Pass,6350000,0,6350000
3004,2492,Nar Bahadur Khatiwara,SIKKIM,BJP,0,Graduate Professional,41384503,0,41384503
3005,3419,Narain Das Sindhi,AJMER,IND,0,12th Pass,402000,0,402000
3006,3247,Narayan Chandra Jena,BHADRAK,AAP,1,Graduate,2066000,0,2066000
3007,3536,Narayan Gundu Powar,KOLHAPUR,AAP,6,12th Pass,3352800,1120000,2232800
3008,3431,Narayan Lal,JALORE,IND,0,8th Pass,115000,0,115000
3009,2354,Narayan Lal Parihar,JAIPUR RURAL,Bharat Nav Nirman Party,0,8th Pass,1567700,253370,1314330
3010,135,Narayan Singh,RAJGARH,INC,4,12th Pass,13622052,1709097,11912955
3011,4255,Narayan Singh,AGRA,BSP,1,Literate,45103247,9921989,35181258
3012,4079,Narayan Singh Kushwah,GWALIOR,IND,0,12th Pass,338425,0,338425
3013,3794,Narayanaswamy,KOLAR,IND,0,Literate,401390,0,401390
3014,2939,Narayanrao Gupchup,GUNA,IND,0,8th Pass,4055500,0,4055500
3015,2681,Narendar Kumar,JAHANABAD,SHS,0,Graduate,311800,0,311800
3016,2018,Narender,HISAR,IND,1,10th Pass,30260500,700000,29560500
3017,2067,Narender Pichopa-Khurd,BHIWANI-MAHENDRAGARH,IND,0,12th Pass,300000,0,300000
3018,2807,Narendra Bansod,RAJNANDGAON,Ambedkarite Party of India,0,Graduate Professional,1590000,0,1590000
3019,675,Narendra Bhati,GAUTAM BUDHHA NAGAR,SP,0,12th Pass,53617561,0,53617561
3020,2501,Narendra Chandra Deb Barma,TRIPURA EAST,Indigenous Peoples Front of Tripura,0,Graduate,11365500,0,11365500
3021,1406,Narendra Chinduji Meshram,WARDHA,GGP,0,5th Pass,4121000,20000,4101000
3022,5386,Narendra Gupta,DURG,Bhrashtachar Mukti Morcha,0,Graduate Professional,7685000,0,7685000
3023,971,Narendra Kr Pandey,CHANDNI CHOWK,BSP,0,12th Pass,48980150,3166282,45813868
3024,821,Narendra Mohanty,KANDHAMAL,AAP,9,Post Graduate,1217466,287074,930392
3025,5642,Narendra Prabhashankar Pandey,THANE,IND,0,10th Pass,9554000,0,9554000
3026,2650,Narendra Pratap Singh,BUXAR,IND,0,Post Graduate,7294224,0,7294224
3027,26,Narendra Sharma,NORTH EAST DELHI,SUCI(C),0,Post Graduate,112772737,0,112772737
3028,1343,Narendra Singh Rawat,NEW DELHI,IND,0,12th Pass,79000,0,79000
3029,2957,Narendra Singh Tomar,GWALIOR,BJP,1,Graduate,11412622,4531444,6881178
3030,5880,Naresh Arvind Thakur,KALYAN,AAP,0,Post Graduate,3157123,6270,3150853
3031,433,Naresh Batra,HISAR,IND,0,10th Pass,38729000,0,38729000
3032,3039,Naresh Chand,AMROHA,IND,0,10th Pass,11068000,0,11068000
3033,1684,Naresh Gautam,GHAZIABAD,Bahujan Mukti Party,0,Graduate,3660000,0,3660000
3034,3040,Naresh Kumar,AMROHA,IND,0,Post Graduate,2145327,0,2145327
3035,1288,Naresh Kumar,SOUTH DELHI,IND,0,Illiterate,143186,0,143186
3036,2060,Naresh Kumar,BHIWANI-MAHENDRAGARH,SP,0,Not Given,2992100,0,2992100
3037,4104,Naresh Kumar Priyadarshi,BANKA,IND,0,Graduate,3863500,250000,3613500
3038,1425,Naresh Mahadeo Patil,RAMTEK,Bahujan Mukti Party,0,Doctorate,3845000,312000,3533000
3039,1516,Naresh Mahadeorao Gughane,YAVATMAL-WASHIM,IND,0,8th Pass,65000,0,65000
3040,2715,Naresh Prasad Singh,NALANDA,IND,0,Graduate,11387000,2599000,8788000
3041,4842,Naresh Rishi,MALDAHA DAKSHIN,IND,0,12th Pass,528000,0,528000
3042,3053,Naresh Singh Solanki,AONLA,AAP,0,Graduate,32537903,8782000,23755903
3043,5406,Naresh Tandi,RAIPUR,IND,1,5th Pass,551000,0,551000
3044,2017,Narinder Kumar,HISAR,IND,0,Others,8931000,600000,8331000
3045,3430,Naringa Ram Yadav,JALORE,IND,0,Post Graduate,8840490,0,8840490
3046,4822,Narmada Prashad Ahirwar,VIDISHA,Bahujan Mukti Party,0,5th Pass,3862000,0,3862000
3047,3355,Narwekar Rahul Suresh,MAVAL,NCP,0,Graduate Professional,100454484,13436552,87017932
3048,1615,Naseem Ahmad Ansari,MUZAFFARNAGAR,IND,0,Literate,126110,0,126110
3049,3177,Naseer Ahmad Khan,RAMPUR,SP,0,Post Graduate,36512409,0,36512409
3050,509,Nasir Ahmed,JORHAT,AIUDF,0,Graduate,1830000,0,1830000
3051,2105,Nasir Papulsab Bagwan,BELGAUM,JD(S),0,12th Pass,962297866,95826301,866471565
3052,4361,Nasmul Hoque,MALDAHA DAKSHIN,Party for Democratic Socialism,1,10th Pass,625000,0,625000
3053,6964,"Natarajan, P.R.",COIMBATORE,CPI(M),1,12th Pass,4126060,0,4126060
3054,5685,Natarajan.M,NAMAKKAL,IND,0,8th Pass,17205000,1400000,15805000
3055,6988,Natarajan.R,DHARMAPURI,IND,0,10th Pass,3304600,0,3304600
3056,7478,Natchiappan Sp,SIVAGANGA,IND,0,5th Pass,51000,0,51000
3057,5969,Nathekar Pramod Gyaniram,NASHIK,IND,0,10th Pass,253000,96000,157000
3058,1145,Nathu Ram,SAMBALPUR,BSP,0,Graduate,6538687,0,6538687
3059,2310,Natthi Lal Sharma,ALIGARH,IND,0,Graduate,9794000,0,9794000
3060,4474,Naushaba Khanam,BHAGALPUR,BSP,2,10th Pass,6756440,600000,6156440
3061,1243,Naushad Alam,CHATRA,AITC,0,Graduate,4839400,0,4839400
3062,513,Navajyoti Kalita,DIBRUGARH,AITC,0,10th Pass,25004000,32650000,-7646000
3063,3566,Navanath Bhimrao Patil,MADHA,Hindusthan Praja Paksha,1,Graduate,1102500,160000,942500
3064,3186,Naved Mian,RAMPUR,IND,0,Not Given,95000,0,95000
3065,1321,Naveen Chandra,NEW DELHI,Naya Daur Party,0,Graduate,4565000,0,4565000
3066,5407,Naveen Gupta,RAIPUR,SP,0,10th Pass,23829011,4816480,19012531
3067,451,Naveen Jaihind,ROHTAK,AAP,1,Doctorate,340057,0,340057
3068,754,Naveen Jain,JABALPUR,IND,0,Graduate,11687096,50000,11637096
3069,631,Naveen Jindal,KURUKSHETRA,INC,2,Post Graduate,3083154000,49114000,3034040000
3070,4026,Naveen Murmu,SINGHBHUM,Rashtriya Deshaj Party,0,12th Pass,590500,0,590500
3071,5192,Navid Hasan Momin,BHIWANDI,IND,1,Graduate,500157500,0,500157500
3072,4742,Navin Chandra Jha,GODDA,IND,0,Post Graduate,958900,0,958900
3073,2367,Navin Pilania,JAIPUR RURAL,National Peoples Party,0,Graduate Professional,117822738,18022060,99800678
3074,4491,Navlesh Pathak,PURNIA,IND,0,Post Graduate,25060000,10000,25050000
3075,3603,Navnath Dashrath Uplekar,OSMANABAD,IND,0,10th Pass,160000,0,160000
3076,216,Navneet Ravi Rana,AMRAVATI,NCP,3,10th Pass,29496562,1858727,27637835
3077,3179,Nawab Kazim Ali Khan,RAMPUR,INC,0,Post Graduate,571146438,7745000,563401438
3078,1256,Nawal Kishor Singh,LOHARDAGA,IND,0,10th Pass,1733000,0,1733000
3079,2720,Nayeb Ali,NALANDA,AITC,0,Doctorate,1896783,0,1896783
3080,3900,Nazakat Hussain,UDHAMPUR,IND,0,Post Graduate,500000,0,500000
3081,1872,Nazarudheen,MALAPPURAM,SDPI,5,10th Pass,1855691,750000,1105691
3082,3803,Nazeer Hussain,KOPPAL,Rashtriya Krantikari Samajwadi Party,0,10th Pass,582000,0,582000
3083,4077,Neelam Agrwal,GWALIOR,AAP,0,12th Pass,3461200,700000,2761200
3084,3010,Neeraj,TIKAMGARH,CPI,0,8th Pass,461000,0,461000
3085,4260,Neeraj Kumar Advocate,AKBARPUR,IND,0,Graduate Professional,1985000,0,1985000
3086,2385,Neeru Agarwal,JAIPUR,National Unionist Zamindara Party,0,Post Graduate,2665000,0,2665000
3087,2458,Neeru Ram,RAJSAMAND,BSP,0,10th Pass,6866060,90000,6776060
3088,2867,Neil Tirkey,KHUNTI,AJSUP,1,Graduate,23771799,8400000,15371799
3089,407,Neiphiu Rio,NAGALAND,NPF,0,Graduate,315834264,0,315834264
3090,3455,Nemichand,NAGAUR,AARAKSHAN VIRODHI PARTY,0,10th Pass,246000,0,246000
3091,3102,Net Ram,BAREILLY,IND,0,Literate,6525004,0,6525004
3092,3253,Netrananda Mallick,BHADRAK,Aama Odisha Party,0,Graduate,1710000,0,1710000
3093,5220,Nihal Ah A Reheman,DHULE,SP,0,10th Pass,28605000,0,28605000
3094,2281,Nihalchand,GANGANAGAR,BJP,0,Graduate,10861172,1611557,9249615
3095,6872,Nijam Mohaideen .M,CHENNAI NORTH,SDPI,0,Graduate,1394351,79800,1314551
3096,3685,Nikam Devdatta Jaywant,SHIRUR,NCP,3,Graduate,7277063,296000,6981063
3097,3395,Nikam Sopanrao Pandharinath,SHIRUR,AAP,0,Post Graduate,35506712,300000,35206712
3098,4362,Nikhil Chandra Mondal,MALDAHA DAKSHIN,BSP,0,10th Pass,10144432,160000,9984432
3099,372,Nikhil Kumar,AURANGABAD,INC,0,Post Graduate,297302441,0,297302441
3100,3971,Nikhil Kumar Choudhary,KATIHAR,BJP,0,Graduate,25225976,408966,24817010
3101,1323,Nikhil Sablania,NEW DELHI,IND,0,Graduate Professional,38000,0,38000
3102,1227,Nilam Devi,CHATRA,JVM(P),0,5th Pass,9780527,1048964,8731563
3103,3631,Nilesh Dhanave,PUNE,IND,0,Post Graduate,14136754,1950000,12186754
3104,1429,Nilesh Mahadeo Dhoke,RAMTEK,IND,0,8th Pass,0,0,0
3105,3641,Nilesh Narayan Rane,RATNAGIRI SINDHUDURG,INC,2,Doctorate,136811633,49129849,87681784
3106,4803,Nilesh Tiwari,MANDSOUR,IND,0,Post Graduate,1156972,0,1156972
3107,3689,Nilesh Yashwant Mhaskule,SHIRUR,IND,0,12th Pass,819858,210000,609858
3108,3164,Nilima Sharma,PILIBHIT,Peace Party,0,Doctorate,5595570,20000,5575570
3109,2268,Nilu Mandol,SILCHAR,SHS,0,8th Pass,283000,0,283000
3110,2572,Nilufar Jamani,TUMKUR,BSP,0,Graduate,740837798,0,740837798
3111,1796,Nima Lama,DARJEELING,Gorkha Rashtriya Congress,0,Graduate,7664167,155997,7508170
3112,4854,Nimu Bhowmick,RAIGANJ,BJP,0,10th Pass,3200680,0,3200680
3113,1096,Nina P Nayak,BANGALORE SOUTH,AAP,0,Post Graduate,35129117,1000000,34129117
3114,406,Ninong Ering,ARUNACHAL EAST,INC,0,Graduate,88065000,0,88065000
3115,3339,Nirada Barana Khuntia,PURI,AAP,0,Not Given,5004386,0,5004386
3116,2748,Niraj Kumar,PATALIPUTRA,IND,0,Graduate,51500,0,51500
3117,4460,Niraj Kumar,BANKA,AAP,0,12th Pass,1977100,0,1977100
3118,2722,Niraj Sharma,NALANDA,Rajnaitik Vikalp Party,0,Literate,11399238,0,11399238
3119,156,Niranjan Kumar,GAYA,CPI(ML)L,2,Graduate,140000,1384,138616
3120,4734,Niranjan Prasad Yadav,GODDA,IND,0,Post Graduate,1015032,105000,910032
3121,3300,Niranjan Saha,DARJEELING,Amra Bangalee,0,Graduate Professional,1825400,0,1825400
3122,5023,Niranjan Singh,HATHRAS,IND,0,10th Pass,4023000,0,4023000
3123,4404,Niranjan Singh Dhangar,HATHRAS,RLD,1,12th Pass,48777359,2328803,46448556
3124,4410,Nirmal Kumar,KANNAUJ,BSP,0,Post Graduate,47927051,13842793,34084258
3125,3274,Nirmal Samal,DHENKANAL,IND,0,8th Pass,740000,0,740000
3126,578,Nirmal Singh,JAMMU,IND,0,Graduate,30496000,904000,29592000
3127,1279,Nirmala,FARIDABAD,JD(U),0,Illiterate,2914700,0,2914700
3128,3761,Nirmala Kumari,CHAMARAJANAGAR,IND,0,Post Graduate,295000,0,295000
3129,2852,Niroop Mahanty,JAMSHEDPUR,JMM,0,Post Graduate,191088713,0,191088713
3130,2260,Nirupam Mandal,SILCHAR,IND,0,Graduate Professional,25500,0,25500
3131,3342,Nisar Subhan Khan Pathan,PARBHANI,IND,1,12th Pass,3100000,165000,2935000
3132,1660,Nishant Tyagi,BAGHPAT,IND,0,12th Pass,1147000,0,1147000
3133,5076,Nishar Ahmad,ALWAR,Jai Maha Bharath Party,0,Literate,36413916,0,36413916
3134,4476,Nishi Kant Mandal,BHAGALPUR,Bahujan Mukti Party,0,Graduate Professional,1480865,303354,1177511
3135,4164,Nishikant Dubey,GODDA,BJP,5,Post Graduate,155633719,0,155633719
3136,2872,Nitima Bodra Bari,KHUNTI,SP,0,Graduate,6237543,0,6237543
3137,1678,Nitin,GHAZIABAD,IND,0,10th Pass,1000,0,1000
3138,3652,Nitin Ganpatrao Savgave,SANGLI,Bahujan Mukti Party,0,Doctorate,17149503,2630000,14519503
3139,7244,Nitin H. Khare,MUMBAI NORTH WEST,IND,0,Graduate Professional,8395927,2457620,5938307
3140,3406,Nitin Navnath Udmale,SHIRDI,AAP,0,Graduate,3756000,1692146,2063854
3141,7190,Nitin Ravindra Rajvardhan,MUMBAI NORTH,Bahujan Mukti Party,0,10th Pass,5315311,0,5315311
3142,5644,Nitin Shankar Deshpande,THANE,Dharmarajya Paksha,0,Post Graduate,11459035,368337,11090698
3143,1485,Nitin Vasant Pohane,CHANDRAPUR,Lok Bharati,0,Graduate,8529000,2255000,6274000
3144,770,Nitinkumar Sahu,CHHINDWARA,BSP,2,10th Pass,585000,150000,435000
3145,2688,Nityanand Singh,JAHANABAD,IND,2,Literate,1392245,2000000,-607755
3146,7215,Niyaz Ahmed Allauddin Shaikh,MUMBAI NORTH CENTRAL,Awami Vikas Party,0,8th Pass,40851500,171500000,-130648500
3147,306,Noble Mathew,KOTTAYAM,IND,0,Post Graduate,55079708,50000,55029708
3148,5391,Nohar Singh Sonwani,JANJGIR-CHAMPA,SP,0,Graduate,3270000,0,3270000
3149,7159,Noor Jiyavudeen.M.I,RAMANATHAPURAM,SDPI,5,8th Pass,5640727,1245457,4395270
3150,5947,Noor Mohammed Khan,MUMBAI SOUTH CENTRAL,IND,1,10th Pass,47491284,0,47491284
3151,4278,Noor Mohmmad,ETAH,BSP,0,Graduate Professional,27700594,0,27700594
3152,310,Nripendra Narayan Singha Karjee,COOCHBEHAR,SUCI(C),1,12th Pass,368300,0,368300
3153,4354,Nural Islam,BALURGHAT,SUCI(C),0,Graduate,880700,0,880700
3154,3197,Nutan Vijay,SAMBHAL,IND,0,Post Graduate,80200000,0,80200000
3155,348,O M Jyotheendra Nath,THIRUVANANTHAPURAM,IND,0,Graduate,5620000,130000,5490000
3156,346,O Rajagopal,THIRUVANANTHAPURAM,BJP,0,Graduate Professional,1211046,0,1211046
3157,634,O V Sreedath,THIRUVANANTHAPURAM,Socialist Republican Party,4,Graduate,33965814,0,33965814
3158,3482,Oinam Jotin Singh,INNER MANIPUR,Jai Maha Bharath Party,0,Graduate,336000,0,336000
3159,2199,Olwin Mariyan Lopis,UTTARA KANNADA,Bahujan Mukti Party,0,10th Pass,398845,0,398845
3160,2409,Om Birla,KOTA,BJP,2,Post Graduate,25870497,997366,24873131
3161,1005,Om Dutt Sharma,NORTH EAST DELHI,SHS,2,12th Pass,197000,0,197000
3162,2006,Om Parkash,HISAR,Bharatiya Sant Mat Party,0,10th Pass,2024000,0,2024000
3163,2297,Om Parkash,GANGANAGAR,IND,0,Literate,350600,0,350600
3164,4922,Om Prakash,AGRA,IND,0,Literate,1935966,0,1935966
3165,5408,Om Prakash Dande,RAIPUR,IND,0,12th Pass,9814792,400000,9414792
3166,1045,Om Prakash Dhankhad,ROHTAK,BJP,1,Post Graduate,10587916,0,10587916
3167,2331,Om Prakash Jharoda,JHUNJHUNU,CPI(ML)L,3,10th Pass,230500,0,230500
3168,3472,Om Prakash Mali,PALI,IND,0,5th Pass,166500,0,166500
3169,4351,Om Prakash Mishra,BALURGHAT,INC,0,Post Graduate,12670505,1594992,11075513
3170,3153,Om Prakash Ravi,NAGINA,SHS,0,8th Pass,468848,0,468848
3171,1289,Ombir,SOUTH DELHI,Bharatiya Bahujan Party,0,12th Pass,732000,0,732000
3172,868,Ombir,BHIWANI-MAHENDRAGARH,Lok Parivartan Party(DC),0,10th Pass,1040000,0,1040000
3173,2083,Ombir Sharma,GURGAON,IND,0,10th Pass,5496500,0,5496500
3174,4263,Omkar Nath,AKBARPUR,Al-Hind Party,0,Doctorate,1005820,0,1005820
3175,756,Omkar Singh Markam,MANDLA,INC,0,Post Graduate,9618675,0,9618675
3176,1355,Ompal Singh,EAST DELHI,Kalyankari Jantantrik Party,0,Graduate,9063978,550000,8513978
3177,5409,Omprakash Meshram,RAIPUR,Republican Paksha (Khoripa),0,Post Graduate,264000,0,264000
3178,4407,Omprkash,HATHRAS,IND,0,8th Pass,3440000,0,3440000
3179,5918,Omraj Lokish Rathod,MUMBAI SOUTH,IND,0,Graduate Professional,585000,0,585000
3180,3063,Omveer,AONLA,Bhartiya Vikas Party,0,Literate,211000,0,211000
3181,1027,Onkar Singh,KURUKSHETRA,National Janhit Congress (AB),0,Literate,13440157,673667,12766490
3182,3423,Otaram,JALORE,BSP,0,Graduate,26365198,1604589,24760609
3183,289,P C Chacko,CHALAKUDY,INC,0,Post Graduate,28000209,2063744,25936465
3184,168,P C Mohanan Master,KANNUR,BJP,2,12th Pass,12859808,739740,12120068
3185,1955,P C Venugopal,ALAPPUZHA,IND,0,Post Graduate,309510,158235,151275
3186,1807,P K Raman,KASARAGOD,IND,2,10th Pass,616200,0,616200
3187,255,P K Sreemathi,KANNUR,CPI(M),8,Others,16939970,0,16939970
3188,251,P Karunakaran,KASARAGOD,CPI(M),6,Post Graduate,5900345,0,5900345
3189,1223,P Muniraju,BANGALORE RURAL,BJP,0,12th Pass,505854419,76201010,429653409
3190,256,P P Aboobacker,KANNUR,CPI(ML) Red star,0,10th Pass,1375736,0,1375736
3191,3464,P P Choudhary,PALI,BJP,0,Graduate Professional,353503467,7892216,345611251
3192,1808,P P Mohanan,KANNUR,IND,0,12th Pass,13953502,0,13953502
3193,266,P R Rasmilnath,WAYANAD,BJP,0,Graduate,1445000,100000,1345000
3194,325,P V Natesan,ALAPPUZHA,BSP,0,Graduate,3219698,0,3219698
3195,845,P Y Hemanth Kumar,DHARWAD,AAP,0,12th Pass,62688810,0,62688810
3196,6863,P. Ahila,CHENNAI CENTRAL,IND,0,10th Pass,40000,0,40000
3197,4343,P. Asaithambi,TIRUCHIRAPPALLI,CPI(ML)L,0,Graduate,1000,0,1000
3198,5582,P. Asaravel,PONDICHERRY,IND,0,Literate,412500,0,412500
3199,5576,P. Bakkiaraj,PONDICHERRY,IND,1,8th Pass,149100,0,149100
3200,6856,P. Manimaran,CHENNAI CENTRAL,IND,0,5th Pass,61000,0,61000
3201,264,P.Abdul Hameed Master,VADAKARA,SDPI,1,Graduate,4988654,0,4988654
3202,7431,P.Balasubramaniyan,TIRUPPUR,IND,0,Not Given,332000,0,332000
3203,1218,P.C. Gaddigoudar,BAGALKOT,BJP,0,Graduate Professional,36362500,9589199,26773301
3204,187,P.C. Mohan,BANGALORE CENTRAL,BJP,2,12th Pass,475796999,261111285,214685714
3205,707,P.C.Jolly,IDUKKI,IND,0,12th Pass,16991308,5500000,11491308
3206,4326,P.Chandrabose,MADURAI,IND,2,Literate,905000,284000,621000
3207,721,P.D. Chandrabhanu,ERNAKULAM,Socialist Republican Party,0,10th Pass,8306000,884000,7422000
3208,7493,P.Gopalakrishnan,MADURAI,IND,0,Graduate,72803120,7406426,65396694
3209,7486,P.Jeyakumar,MADURAI,IND,0,Graduate Professional,1003650,260000,743650
3210,1900,P.K.Biju,ALATHUR,CPI(M),0,Post Graduate,3231047,341749,2889298
3211,3952,P.Kumar S/O Palanivel,TIRUCHIRAPPALLI,AIADMK,0,Graduate Professional,18522597,1917891,16604706
3212,1843,P.Kumarankutty,VADAKARA,IND,0,Graduate Professional,44347759,0,44347759
3213,6293,P.Loganathan,ARANI,IND,0,8th Pass,1213000,0,1213000
3214,335,P.M. Velayudhan,KOLLAM,BJP,0,10th Pass,5927000,750000,5177000
3215,5463,P.Muthaiyan,VILUPPURAM,IND,0,Illiterate,142500,0,142500
3216,6369,P.Narayansamy,KALLAKURICHI,IND,1,10th Pass,1714800,225000,1489800
3217,4333,P.Ramasubramanian,MADURAI,IND,0,10th Pass,3742169,3012000,730169
3218,7428,P.Selvaboobathi,TIRUPPUR,IND,0,5th Pass,155639,0,155639
3219,7546,P.V.Radhakrishnan,VIRUDHUNAGAR,IND,0,Graduate,5596881,145000,5451881
3220,234,Paban Singh Ghatowar,DIBRUGARH,INC,0,Graduate,49229437,2547986,46681451
3221,4379,Pabitra Ranjan Dasmunshi (Satya),RAIGANJ,AITC,0,Graduate,11557345,3768411,7788934
3222,7125,"Pachamuthu, N.",PERAMBALUR,IND,0,Not Given,2025000,0,2025000
3223,1349,Padam Chand,EAST DELHI,IND,0,10th Pass,2670000,0,2670000
3224,2049,Padam Singh,SONIPAT,IND,0,12th Pass,11672304,0,11672304
3225,443,Padam Singh,SONIPAT,INLD,0,Graduate Professional,30051128,466311,29584817
3226,1333,Padmaja Kandukuri,NEW DELHI,IND,0,Not Given,2367592,180000,2187592
3227,3559,Padmakar Kondiba Ovhal,LATUR,IND,0,Literate,500,0,500
3228,2552,Padmamma M V,MYSORE,AAP,0,Graduate,11627675,478620,11149055
3229,268,Padmanabhan .C.K.,KOZHIKODE,BJP,0,10th Pass,9306000,400000,8906000
3230,7032,Padmanabhan S.,KANNIYAKUMARI,IND,0,Post Graduate,4575197,0,4575197
3231,4028,Padmarajan.K.Dr,DHARMAPURI,IND,0,Post Graduate,1515900,48000,1467900
3232,3604,Padmsinh Vijaysinh Mundhe,OSMANABAD,IND,0,12th Pass,1080000,188000,892000
3233,3844,Paglanand,BADAUN,Mahan Dal,0,10th Pass,1795492,0,1795492
3234,5948,Pal Jitendra Kumar Nanaku,MUMBAI SOUTH CENTRAL,IND,0,12th Pass,1108000,0,1108000
3235,2285,Pala Ram,GANGANAGAR,CPI(M),0,Literate,750500,0,750500
3236,7479,Palani S,SIVAGANGA,IND,0,10th Pass,236000,0,236000
3237,7384,"Palani, A. Thiru",SRIPERUMBUDUR,IND,1,10th Pass,15310000,0,15310000
3238,6342,Palaniappan Josiyar C.M,ERODE,CPI(ML) Red Star,0,Illiterate,20000,0,20000
3239,7543,Palanichamy,VIRUDHUNAGAR,IND,0,Post Graduate,0,0,0
3240,7097,Palanisamy. G,NAGAPATTINAM,CPI,0,5th Pass,3022631,0,3022631
3241,7145,Palanisamy. N,POLLACHI,IND,0,8th Pass,7658116,5200000,2458116
3242,7146,Palanisamy. V,POLLACHI,IND,0,Literate,1486600,325000,1161600
3243,7451,Palanivel.P,TIRUCHIRAPPALLI,IND,0,Post Graduate,24953196,16407645,8545551
3244,2032,Pale Ram Kashyap,KARNAL,Rashtriya Janshakti Party(Eklavya),0,10th Pass,731148,0,731148
3245,2481,Pallickal Surendran,MAVELIKKARA,IND,0,10th Pass,410278,0,410278
3246,7175,Palpandi .C,RAMANATHAPURAM,IND,1,Graduate,120000,0,120000
3247,7550,"Palpandi, S.",VIRUDHUNAGAR,IND,0,Doctorate,0,0,0
3248,2280,Paluskar Krishnarao Tatoba,GANGANAGAR,Prabuddha Republican Party,0,Post Graduate,3461100,1500000,1961100
3249,4188,Pamanand Tolani,INDORE,IND,0,10th Pass,2371000,375000,1996000
3250,7465,Panasai Arangan.N,THANJAVUR,IND,0,10th Pass,30000,0,30000
3251,2741,Pancham Lal,PATALIPUTRA,IND,0,Graduate,29991521,0,29991521
3252,6271,Panchu.Udayakumar,ARAKKONAM,IND,0,Post Graduate,710000,150000,560000
3253,5958,Pandhare Vijay Baliram,NASHIK,AAP,0,Graduate Professional,16620000,0,16620000
3254,6327,Pandi.N,DINDIGUL,CPI(M),1,12th Pass,2920205,604640,2315565
3255,7545,Pandiarajan,VIRUDHUNAGAR,IND,0,8th Pass,1958200,1200000,758200
3256,7087,Pandiyan .R,MAYILADUTHURAI,IND,0,10th Pass,769965,0,769965
3257,5989,Pandurang Jethya Pardhi,PALGHAR,AAP,0,10th Pass,1337700,260000,1077700
3258,3670,Pandurang Ramchandra Shinde,SATARA,IND,2,Post Graduate,52408590,1700753,50707837
3259,3543,Pandurang Tukaram Chougale,KOLHAPUR,IND,0,8th Pass,2522000,0,2522000
3260,660,Pankaj Agarwal,MUZAFFARNAGAR,INC,0,Graduate,242260053,27148000,215112053
3261,4103,Pankaj Kishor Mandal,ARARIA,IND,2,10th Pass,202412,50000,152412
3262,4992,Pankaj Kumar Sharma,FATEHPUR SIKRI,Rashtriya Samanta Dal,0,Post Graduate,14308000,10000,14298000
3263,3974,Pankaj Kumar Singh,PURNIA,CPI(ML)L,3,8th Pass,2837663,0,2837663
3264,2536,Pankaj Prafulkumar Bhansali,NAGPUR,IND,0,12th Pass,20684589,0,20684589
3265,51,Pankaj Sewakram Masurkar,RAMTEK,Hindustan Janta Party,0,10th Pass,30000,0,30000
3266,742,Pankaj Singh Patel,SIDHI,AAP,0,Post Graduate,144766,0,144766
3267,922,Pankajkumar Sharma,CHANDRAPUR,AITC,0,Graduate,9757822,450000,9307822
3268,5706,Panneerselvam N,SALEM,IND,1,8th Pass,1135000,425000,710000
3269,7564,Panneerselvam.C,THOOTHUKKUDI,IND,0,Graduate Professional,146579,0,146579
3270,5689,Panneerselvam.S,NAMAKKAL,IND,0,12th Pass,2086049,0,2086049
3271,3938,Pannerselvam.V,SALEM,AIADMK,0,Graduate Professional,32268097,253282,32014815
3272,810,Parameswar Kand,KALAHANDI,Samata Kranti Dal,1,12th Pass,2270000,100000,2170000
3273,1050,Paramjit Singh,KARNAL,AAP,0,Graduate,2863613,1382819,1480794
3274,1824,Parappa Shankareppa Antakkanavar,BELGAUM,IND,1,Graduate Professional,12751189,1053795,11697394
3275,4794,Paras Dada Saklecha,MANDSOUR,AAP,2,Post Graduate,4657101,136232,4520869
3276,1061,Parashuram Rathod,BAGALKOT,IND,0,12th Pass,776342,84800,691542
3277,2204,Parasuram S,DAVANAGERE,CPI(ML)L,0,Literate,271500,125000,146500
3278,7459,Parasuraman.K,THANJAVUR,AIADMK,0,12th Pass,146049347,27954352,118094995
3279,768,Pardaeshi Lal Uikey,CHHINDWARA,GGP,0,12th Pass,864500,0,864500
3280,2068,Pardeep Singh Tanwar,BHIWANI-MAHENDRAGARH,IND,0,Graduate,17720045,225000,17495045
3281,1607,Pardip,KAIRANA,Bahujan Mukti Party,0,12th Pass,871000,0,871000
3282,4446,Paresh Baishya,MANGALDOI,AIUDF,2,Graduate,459875,0,459875
3283,7012,Pargunan A.,KANCHEEPURAM,IND,0,10th Pass,0,0,0
3284,7115,"Parivendar Pachamuthu, T.R.",PERAMBALUR,BJP,1,Post Graduate,776948435,30885280,746063155
3285,623,Parmendra Kumar Yadav,NAWADA,Bharatiya Ekta Dal,0,12th Pass,1030800,0,1030800
3286,1383,Parmeshwar Hiraman Gawai,BULDHANA,Ambedkarist Republican Party,0,12th Pass,8810000,60000,8750000
3287,5275,Parmeshwar Jha,SUPAUL,AAP,0,Graduate,11516000,0,11516000
3288,748,Parmeshwar Singh,SHAHDOL,CPI,0,5th Pass,515000,200000,315000
3289,2712,Parnav Prakash,NALANDA,AAP,0,Graduate Professional,58483543,16000000,42483543
3290,4153,Parshuram Paswan,DHANBAD,IND,0,Graduate Professional,77400,0,77400
3291,5061,Parsottam,MATHURA,Rashtriya Mahan Ganatantra Party,0,12th Pass,781935,0,781935
3292,818,Parsuram Majhi,NABARANGPUR,BJP,0,Graduate,8274821,61600,8213221
3293,524,Partha Karmakar,TRIPURA WEST,CPI(ML)L,0,Graduate,5540194,0,5540194
3294,7505,"Parthipan, R.",THENI,AIADMK,0,Graduate,22047681,869650,21178031
3295,6959,"Parvathi, S",CHIDAMBARAM,IND,0,Not Given,210000,0,210000
3296,2762,Parveen Amanullah,PATNA SAHIB,AAP,0,Graduate,34292500,0,34292500
3297,70,Parvesh Sahib Singh,WEST DELHI,BJP,1,Post Graduate,107235461,26650000,80585461
3298,1762,Parvez Aqil,BIJNOR,All India Minorities Front,0,Graduate,104992,0,104992
3299,2776,Parwez Ahmad,PATNA SAHIB,Loktantrik Janata Party (Secular),0,Graduate,88692,0,88692
3300,4855,Pasarul Alam,RAIGANJ,AAP,0,Post Graduate,10495835,1636925,8858910
3301,4701,Pashupati Nath Singh,DHANBAD,BJP,1,Graduate,24248150,0,24248150
3302,7436,Pastor A.James,TIRUPPUR,IND,0,10th Pass,31000,0,31000
3303,314,Patel Hidayat Ulla Barkat Ulla,AKOLA,INC,1,12th Pass,12476287,202500,12273787
3304,919,Patel Praful Manoharbhai,BHANDARA-GONDIYA,NCP,0,Graduate,1959685779,40000000,1919685779
3305,2798,Patel Shri Dhar Chandrakar,MAHASAMUND,Apna Dal,1,Post Graduate,24903805,1378101,23525704
3306,5976,Pathan Ayub Maddekhan,NASHIK,IUML,0,Graduate Professional,2842358,84885,2757473
3307,3318,Pathan Jafar Ali Kha Md. Ali Kha,NANDED,IND,0,12th Pass,3642000,0,3642000
3308,5966,Pathan Sakhawatkha Yasinkha,NASHIK,Bahujan Mukti Party,0,Graduate,3610000,325000,3285000
3309,7600,Pathmanaban.K,TIRUNELVELI,IND,0,Graduate,44381,0,44381
3310,5833,Patil Ashok Tapiram,JALGAON,BJP,0,Graduate,226180395,0,226180395
3311,3542,Patil Bajrang Krishna,KOLHAPUR,IND,0,10th Pass,352142,0,352142
3312,5955,Patil Dinkar Dharma,NASHIK,BSP,8,8th Pass,65166950,288076,64878874
3313,5179,Patil Madhukar Vitthal,BHIWANDI,CPI,0,5th Pass,3897131,70000,3827131
3314,3605,Patil Manohar Anandrao,OSMANABAD,IND,0,12th Pass,215000,0,215000
3315,5173,Patil Nitin Suresh,AURANGABAD,INC,7,Graduate,150699930,13163583,137536347
3316,3606,Patil Padmasinha Bajirao,OSMANABAD,NCP,6,Graduate Professional,131918437,10174735,121743702
3317,5870,Patil Pramod Ratan,KALYAN,MNS,0,10th Pass,85592187,27664328,57927859
3318,3656,Patil Pratik Prakashbapu,SANGLI,INC,0,10th Pass,52543606,8891772,43651834
3319,3505,Patil S R Tatya,HATKANANGLE,IND,0,Graduate Professional,3500000,200000,3300000
3320,5846,Patil Sandeep Yuvraj,JALGAON,IND,0,12th Pass,0,0,0
3321,5840,Patil Sangram Gokulsingh,JALGAON,AAP,0,Post Graduate,17098312,3818000,13280312
3322,5839,Patil Suresh Padurang,JALGAON,Hindustan Janta Party,0,10th Pass,50000,0,50000
3323,1506,Patil Upendra Babarao,YAVATMAL-WASHIM,IND,0,Graduate Professional,3675000,315000,3360000
3324,5180,Patil Vishwanath Ramchandra,BHIWANDI,INC,2,10th Pass,25593787,1311000,24282787
3325,1459,Patle Anjali Agastikumar,BHANDARA-GONDIYA,Bharipa Bhahujan Mahasangha,0,Post Graduate,1679100,2425000,-745900
3326,7072,Pattabirama.C,KRISHNAGIRI,IND,0,12th Pass,3993522,0,3993522
3327,1780,Paul Dexion Khariya,ALIPURDUARS,IND,0,Graduate,406000,0,406000
3328,6891,Paul Kanagaraj. R.C,CHENNAI NORTH,IND,0,Graduate Professional,58886378,9840813,49045565
3329,119,Paul Lyngdoh,SHILLONG,UDP,0,Post Graduate,17371929,0,17371929
3330,6336,Pauldurai V K,DINDIGUL,IND,0,12th Pass,1540000,0,1540000
3331,6874,Paulraj .T,CHENNAI NORTH,Makkal Manadu Katchi,0,Graduate,189000,0,189000
3332,7023,Paulraj C.M.,KANNIYAKUMARI,CPI(ML) Red Star,0,Graduate Professional,1900000,25000,1875000
3333,4640,Paulus Kujur,RAIGARH,Bahujan Mukti Party,0,10th Pass,3956000,0,3956000
3334,6354,Pavithravalli H,ERODE,DMK,0,Post Graduate,37629685,3680000,33949685
3335,30,Pawan Kumar Bansal,CHANDIGARH,INC,0,Graduate Professional,77478000,0,77478000
3336,895,Pawan Kumar Sharma,CHANDIGARH,IND,0,12th Pass,9196223,720000,8476223
3337,4712,Pawan Mahato,DHANBAD,IND,1,12th Pass,10512603,1597,10511006
3338,2373,Pawan Singh Shekhawat,JAIPUR,IND,1,10th Pass,418893,154152,264741
3339,3301,Pawar (Patil) Digambar Bapuji,NANDED,BJP,0,12th Pass,43054709,1538191,41516518
3340,5962,Pawar Pradeepchandra Narayan,NASHIK,MNS,12,Others,335123791,38008797,297114994
3341,3407,Pawar Vijay Banderao,SHIRDI,The Lok Party of India,0,10th Pass,110000,0,110000
3342,3700,Pawar Yuvraj Sidram,SOLAPUR,IND,0,Graduate,45000,0,45000
3343,6958,"Pazhanivel, P",CHIDAMBARAM,IND,0,Others,798500,0,798500
3344,1961,Peelipose,PATHANAMTHITTA,IND,0,8th Pass,100205,0,100205
3345,4989,Peetam Singh,FATEHPUR SIKRI,Rashtriya Kranti Party,0,12th Pass,495000,0,495000
3346,2917,Peeyush Soni,BHOPAL,IND,0,12th Pass,639500,550,638950
3347,7176,Periyasamy .P,RAMANATHAPURAM,IND,0,Graduate,1225000,0,1225000
3348,884,Perseen Singh,JAMMU,IND,0,12th Pass,205959,0,205959
3349,3942,Perumal.A,NAMAKKAL,IND,0,12th Pass,4196631,390477,3806154
3350,3487,Petras Kisan Gaware,AHMEDNAGAR,IND,2,Illiterate,366073,20000,346073
3351,644,Phaljit Mahto,KODARMA,IND,0,Illiterate,995000,15000,980000
3352,4856,Phani Bhusan Choudhury,BARPETA,AGP,0,Graduate,9374499,67240,9307259
3353,7214,Phiroze Palkhivala,MUMBAI NORTH CENTRAL,AAP,0,Graduate Professional,34762841,0,34762841
3354,411,Phool Chand,AMBALA,IND,0,8th Pass,3750000,0,3750000
3355,1574,Phool Singh Dhurwey,MANDLA,Chhattisgarh Swabhiman Manch,3,Graduate,2820609,20000,2800609
3356,1624,Phool Singh Pal,MUZAFFARNAGAR,IND,0,12th Pass,17502382,0,17502382
3357,747,Phool Singh Paraste,SHAHDOL,BSP,2,Post Graduate,5694356,120000,5574356
3358,4242,Phoolsingh,KARAULI-DHOLPUR,Jago Party,0,8th Pass,1268000,0,1268000
3359,2896,Phoolsingh Baraiya,BHIND,Bahujan Sangharshh Dal,0,Graduate Professional,21329109,4815877,16513232
3360,429,Phul Singh,HISAR,CPI(M),0,Graduate,14551828,1022496,13529332
3361,5174,Phulare Suresh Asaram,AURANGABAD,IND,0,12th Pass,497750,0,497750
3362,4660,Phuleshwar Prasad Surajhiha,KORBA,IND,0,Not Given,25000,0,25000
3363,2528,Phusey Ghanshyam Ramaji,NAGPUR,RPI,0,Graduate,4987645,577000,4410645
3364,1770,Pijush Barman,COOCHBEHAR,Welfare Party Of India,0,Post Graduate,1670000,0,1670000
3365,3715,Pinaki Mishra,PURI,BJD,0,Graduate Professional,1370991203,19975839,1351015364
3366,5210,Pinjari Jainuddin Husain,DHULE,IND,0,10th Pass,1092000,225000,867000
3367,2244,Pintu Malakar,KARIMGANJ,IND,0,12th Pass,440000,0,440000
3368,704,Piravathoor Sreedharan,MAVELIKKARA,IND,0,Post Graduate,829000,0,829000
3369,4995,Pitam Singh,FATEHPUR SIKRI,JD(U),0,Illiterate,320000,0,320000
3370,728,Pjech Debbarma,TRIPURA WEST,IND,0,10th Pass,15085500,10373,15075127
3371,3576,Pol Sudhir Arjun,MADHA,IND,0,12th Pass,25000,0,25000
3372,6970,Pon Chandran.,COIMBATORE,AAP,1,Post Graduate,6278508,0,6278508
3373,7506,Pon. Muthuramalingam,THENI,DMK,0,Graduate Professional,24443618,0,24443618
3374,6944,Pon. Siva Kumar,CHENNAI SOUTH,IND,0,Graduate,810500,470000,340500
3375,7136,Pongalur Palanisamy.N,POLLACHI,DMK,3,Graduate,406806230,0,406806230
3376,5669,Ponmudi.P,NAMAKKAL,IND,0,Others,488500,0,488500
3377,7110,"Ponnusamy, P.",NILGIRIS,CPI(ML) Red Star,1,Illiterate,0,0,0
3378,6894,Ponraj. P,CHENNAI NORTH,IND,0,5th Pass,1039000,0,1039000
3379,425,Poonam Chand,SIRSA,AAP,0,12th Pass,3825442,0,3825442
3380,5902,Poonam Mahajan Alias Poonam Vajendla Rao,MUMBAI NORTH CENTRAL,BJP,0,Others,1080867626,414479088,666388538
3381,7572,Poongani.J.,TENKASI,Samata Party,0,10th Pass,4974010,1300000,3674010
3382,3399,Popat Manik Fule,AHMEDNAGAR,Maharashtra Parivartan Sena (T),0,5th Pass,500,0,500
3383,2480,Popat Ram,BARMER,IND,0,5th Pass,180000,0,180000
3384,3862,Pournima Vilas Korpale,SANGLI,IND,0,Post Graduate,60000,0,60000
3385,3961,Pr Senthilnathan,SIVAGANGA,AIADMK,0,Graduate Professional,49050835,7459581,41591254
3386,5446,Prabakaran L,TIRUVANNAMALAI,IND,0,10th Pass,535000,0,535000
3387,7586,Prabakaran.K.R.P,TIRUNELVELI,AIADMK,0,Graduate Professional,2764500,0,2764500
3388,7191,Prabhakaran G. Titus,MUMBAI NORTH,Peoples Party of India(secular),0,10th Pass,43500,3500,40000
3389,6893,Prabhakaran. K,CHENNAI NORTH,IND,0,Post Graduate,42000,52000,-10000
3390,789,Prabhas Kumar Singh,BARGARH,BJD,0,Doctorate,5786971,670000,5116971
3391,5826,Prabhat Chindhu Sonawane,DINDORI,Bharipa Bahujan Mahasangh,0,Post Graduate,1280000,55000,1225000
3392,826,Prabhat Kumar Mahanty,ASKA,AAP,1,Graduate,989407,0,989407
3393,3924,Prabhawati Shakya Khot,BHOPAL,IND,0,12th Pass,100000,0,100000
3394,612,Prabhu,BANGALORE SOUTH,IND,0,Literate,90000,0,90000
3395,2129,Prabhu,BIDAR,IND,0,10th Pass,2200000,0,2200000
3396,2438,Prabhu Lal Gujjar,CHITTORGARH,Jai Maha Bharath Party,0,8th Pass,615000,100000,515000
3397,6966,"Prabhu, R.",COIMBATORE,INC,0,Post Graduate,609497080,112606039,496891041
3398,7147,Prabhu. J,POLLACHI,IND,0,12th Pass,145000,0,145000
3399,3234,Prabhudan Marandi,MAYURBHANJ,Aama Odisha Party,0,Graduate Professional,2683854,0,2683854
3400,2451,Prabhulal Meena,UDAIPUR,Bahujan Mukti Party,0,8th Pass,595000,50000,545000
3401,1535,Prabhunath Prasad Saket,REWA,IND,0,Doctorate,316246,0,316246
3402,2499,Prabiddha Reang,TRIPURA EAST,IND,0,10th Pass,402519,0,402519
3403,7126,"Prabu, S.",PERAMBALUR,IND,0,10th Pass,1850000,0,1850000
3404,771,Pradeep,HOSHANGABAD,BSP,0,10th Pass,10082,0,10082
3405,1898,Pradeep,PALAKKAD,IND,0,10th Pass,131500,0,131500
3406,1800,Pradeep Kumar,ALIGARH,Bahujan Mukti Party,0,Graduate Professional,41900,0,41900
3407,5040,Pradeep Kumar,KANNAUJ,IND,0,10th Pass,1170000,0,1170000
3408,1727,Pradeep Kumar Jatav,BULANDSHAHR,BSP,1,12th Pass,25731324,557571,25173753
3409,37,Pradeep Kumar Joshi,KARAKAT,Rashtra Sewa Dal,21,12th Pass,11721162,11908841,-187679
3410,1208,Pradeep Kumar M,CHAMARAJANAGAR,Karunaadu Party,0,12th Pass,45000,0,45000
3411,116,Pradeep Kumar Majhi,NABARANGPUR,INC,0,Graduate,6978000,36000,6942000
3412,2653,Pradeep Kumar Prasad,BUXAR,Pragatisheel Manav Samaj Party,0,10th Pass,1994000,0,1994000
3413,3967,Pradeep Kumar Singh,ARARIA,BJP,4,10th Pass,4291479,802182,3489297
3414,1331,Pradeep Varma,NEW DELHI,Bharat Vishal Party,0,Graduate Professional,4200000,500000,3700000
3415,7527,"Pradeepkumar, D",VIRUDHUNAGAR,Lok Satta Party,0,Post Graduate,7264000,0,7264000
3416,1006,Pradesh Kumar,NORTH EAST DELHI,Ambedkar National Congress,0,Post Graduate,257000,0,257000
3417,4437,Pradip Kalita,GAUHATI,IND,0,12th Pass,3600000,0,3600000
3418,3316,Pradip Kumar Mallick,JAGATSINGHPUR,BSP,0,Post Graduate,1760000,0,1760000
3419,2465,Pradip Singh Bhatnagar,RAJSAMAND,AAP,0,Post Graduate,12368765,520000,11848765
3420,2253,Pradip Suklabaidya,KARIMGANJ,IND,0,8th Pass,299847,0,299847
3421,4736,Pradip Yadav,GODDA,JVM(P),7,Graduate,10128031,38800,10089231
3422,813,Pradipta Kumar Naik,KALAHANDI,BJP,0,Graduate Professional,42970197,0,42970197
3423,3269,Pradyumna Kumar Naik,DHENKANAL,Bahujan Mukti Party,0,Graduate Professional,1427000,0,1427000
3424,3577,Prafull Shivrao Kadam,MADHA,IND,0,Post Graduate,4595131,347241,4247890
3425,2694,Pragati Mehta,MUNGER,RJD,0,Graduate,6422050,0,6422050
3426,2921,Prahlad Singh Patel,DAMOH,BJP,0,Graduate Professional,39586235,12429302,27156933
3427,2928,Prahlad Singh Patel-Mukundilal,DAMOH,IND,0,Illiterate,176000,0,176000
3428,2929,Prahlad-Gabdu,DAMOH,IND,0,Illiterate,857000,0,857000
3429,4080,Prajesh Choudhary,GWALIOR,IND,0,8th Pass,1057799,0,1057799
3430,5696,Prakasam R,SALEM,IND,0,12th Pass,2971359,0,2971359
3431,5911,Prakash Gangaram Reddy,MUMBAI SOUTH,CPI,1,Graduate Professional,23829258,280159,23549099
3432,1170,Prakash Hikaka,KORAPUT,CPI(ML) Red star,0,Literate,2500,0,2500
3433,1815,Prakash Hukkeri,CHIKKODI,INC,0,12th Pass,75717628,3635650,72081978
3434,4641,Prakash Kumar Uranw,RAIGARH,IND,0,8th Pass,835800,0,835800
3435,2912,Prakash Mangilal Sharma,BHOPAL,INC,5,Graduate Professional,27818657,1799934,26018723
3436,586,Prakash Minj,ANDAMAN & NICOBAR ISLANDS,IND,0,Post Graduate,308000,0,308000
3437,1502,Prakash Raghunath Raut,YAVATMAL-WASHIM,IND,0,10th Pass,250000,0,250000
3438,565,Prakash Rathod,BIJAPUR,INC,3,Post Graduate,113403666,27599682,85803984
3439,7225,Prakash Sadashiv Pancharas,MUMBAI NORTH EAST,Maharashtra Parivartan Sena (T),0,5th Pass,235490,0,235490
3440,5877,Prakash Shamrao Telgote,KALYAN,IND,0,10th Pass,612819,0,612819
3441,4503,Prakash Surya,BILASPUR,IND,0,10th Pass,3093472,389952,2703520
3442,7055,"Prakash, N.",KARUR,IND,0,Graduate Professional,175000,0,175000
3443,1075,Pralhad Joshi,DHARWAD,BJP,1,Graduate,41979658,6739989,35239669
3444,3347,Pramila Behera,BHUBANESWAR,CPI(ML) Red star,0,Graduate,166297,0,166297
3445,2705,Pramod Kumar,MUNGER,SUCI(C),0,Post Graduate,1741914,0,1741914
3446,2396,Pramod Kumar,JHALAWAR-BARAN,INC,0,12th Pass,290302756,92884227,197418529
3447,3284,Pramod Kumar Mallick,CUTTACK,BSP,0,Graduate,136000,0,136000
3448,2724,Pramod Kumar Nirala,NALANDA,Sankhyanupati Bhagidari Party,0,Graduate,7929000,67000,7862000
3449,3052,Pramod Kumar Yadav,AONLA,Bhartiya Krishak Dal,0,Post Graduate,477000,0,477000
3450,1494,Pramod Mangaruji Sorte,CHANDRAPUR,IND,0,12th Pass,566100,0,566100
3451,3343,Pramod Maroti Panditkar,PARBHANI,IND,0,Graduate,180000,0,180000
3452,3750,Pramod Mutalik,BANGALORE SOUTH,IND,8,Graduate,268756,0,268756
3453,2193,Pramod Mutalik.,DHARWAD,IND,8,Graduate,268756,0,268756
3454,4497,Pramod Narayan Poddar,PURNIA,Bhartiya Jantantrik Janata Dal,1,Graduate,8642000,750000,7892000
3455,3291,Pramod Sahu,KENDRAPARA,IND,0,Graduate Professional,1263856,0,1263856
3456,1533,Pramod Tiwari,REWA,Bhartiya Shakti Chetna Party,0,Graduate,35000,0,35000
3457,3346,Prana Krushna Dalabehera,BHUBANESWAR,Samruddha Odisha,0,Graduate Professional,2790039,255034,2535005
3458,642,Pranav Kumar Verma,KODARMA,JVM(P),0,Post Graduate,1386131,0,1386131
3459,4880,Pranjal Bordoloy,GAUHATI,AAP,0,Graduate,8726568,7111191,1615377
3460,795,Prasadi Pradhan,SAMBALPUR,SUCI(C),0,8th Pass,485502,36800,448702
3461,3710,"Prasanna Kumar Patasani,",BHUBANESWAR,BJD,0,Post Graduate,13557443,9590067,3967376
3462,3236,Prasanta Kumar Mishra,BALASORE,CPI,1,Graduate Professional,2357346,8000,2349346
3463,59,Prashant Chaudhary,BAGHPAT,BSP,0,Post Graduate,258289957,3950000,254339957
3464,7226,Prashant Dnyaneshwar Gangawane,MUMBAI NORTH EAST,Prabuddha Republican Party,3,Post Graduate,60067552,572151,59495401
3465,7197,Prashant Narsinh Kharatmal,MUMBAI NORTH,IND,0,10th Pass,3235000,2990000,245000
3466,1503,Prashant Pandharinath Surve,YAVATMAL-WASHIM,IND,0,Post Graduate,26770200,4600000,22170200
3467,918,Prashant Shyamsundar Mishra,BHANDARA-GONDIYA,AAP,0,Post Graduate,41306880,559171,40747709
3468,3662,Prashant Vasant Chavan,SATARA,BSP,0,Graduate,1930279,793050,1137229
3469,3880,Prashant Vishnu Sasane,BEED,IND,0,Graduate,0,0,0
3470,1198,Prashanth.S.M,BANGALORE CENTRAL,IND,0,Post Graduate,210000,0,210000
3471,2682,Prashuram Bind,JAHANABAD,Bahujan Mukti Party,0,Graduate,2636206,0,2636206
3472,2662,Prashuram Prasad,BUXAR,Bahujan Mukti Party,1,12th Pass,460000,0,460000
3473,1177,Praska Renga,KORAPUT,BSP,0,8th Pass,352000,0,352000
3474,4127,Pratap Bhanu,KORBA,IND,0,12th Pass,3330217,300000,3030217
3475,3242,Pratap Chandra Sarangi,BALASORE,BJP,10,Graduate,1018629,160,1018469
3476,939,Pratap Goswami,RAMTEK,AAP,0,Graduate,23772549,2075378,21697171
3477,2319,Pratap Singh,CHURU,INC,0,Post Graduate,12282074,1241053,11041021
3478,2349,Pratap Singh,SIKAR,IND,0,8th Pass,3003000,0,3003000
3479,2339,Pratap Singh Jat,SIKAR,INC,0,Graduate Professional,22669772,1123169,21546603
3480,838,Prataprao Alagouda Patil,CHIKKODI,NCP,1,Post Graduate,19483000,37260000,-17777000
3481,271,Prathap Kumar. N. P,KOZHIKODE,IND,0,Graduate Professional,4356708,100000,4256708
3482,1216,Prathap Simha,MYSORE,BJP,0,Post Graduate,6321591,4399048,1922543
3483,7245,Pratik Prabhakar Toraskar,MUMBAI NORTH WEST,IND,0,Graduate,45000,0,45000
3484,2273,Pratima Engheepi,AUTONOMOUS DISTRICT,CPI(ML)L,0,Graduate,469165,365000,104165
3485,1950,Praveen K Mohan,KOTTAYAM,IND,3,10th Pass,512500,0,512500
3486,2338,Praveen Kumar,JHUNJHUNU,IND,0,Post Graduate,10556850,1355300,9201550
3487,1365,Praveen Kumar,EAST DELHI,Bhartiya Jan Manch,0,8th Pass,155178,1700,153478
3488,4770,Praveen Kumar Ajmera Jain,INDORE,IND,0,Post Graduate,624098,0,624098
3489,618,Praveen M S,MYSORE,IND,0,Post Graduate,198500,0,198500
3490,3087,Praveen Singh Aron,BAREILLY,INC,1,Graduate Professional,274576248,383067,274193181
3491,7240,Pravin Chandrakant Kaurpuriya,MUMBAI NORTH WEST,Hindustan Swaraj Congress Party,0,Graduate Professional,409823,0,409823
3492,5411,Pravin Jain,RAIPUR,IND,0,10th Pass,54840493,1350000,53490493
3493,2838,Prayag Prasad,HAZARIBAGH,IND,0,Literate,4063000,150000,3913000
3494,652,Prechard B. M. Basaiawmoit,SHILLONG,IND,0,12th Pass,39194012,0,39194012
3495,2803,Preeti Dhruw,MAHASAMUND,GGP,0,Others,150000,0,150000
3496,5091,Prem Chand Dhamani,BHARATPUR,IND,0,10th Pass,7740000,180000,7560000
3497,4280,Prem Chanra,ETAWAH,Kisan Majdoor Berojgar Sangh,0,12th Pass,557000,0,557000
3498,4962,Prem Das,ETAWAH,SP,1,Graduate,10427522,0,10427522
3499,2490,Prem Das Rai,SIKKIM,SDF,0,Post Graduate,32389223,0,32389223
3500,4706,Prem Prakash Paswan,DHANBAD,IND,0,12th Pass,248371,0,248371
3501,4918,Prem Singh,AGRA,Bahujan Mukti Party,0,10th Pass,20815800,0,20815800
3502,1354,Prem Singh,EAST DELHI,Socialist Party (India),0,Doctorate,13650000,200000,13450000
3503,338,Premachandran,KOLLAM,IND,0,10th Pass,71500,0,71500
3504,2488,Premachandran,KOLLAM,IND,1,10th Pass,2605267,0,2605267
3505,963,Premakumari,ALATHUR,BSP,1,Others,32000,158000,-126000
3506,3264,Premananda Sahoo,DHENKANAL,BSP,0,Post Graduate,1650041,55253,1594788
3507,4812,Premchand Guddu,UJJAIN,INC,3,10th Pass,535213275,2221000,532992275
3508,4122,Premchand Jayasi,JANJGIR-CHAMPA,INC,0,Post Graduate,4422744,553873,3868871
3509,5398,Premshankar Mahilange,JANJGIR-CHAMPA,IND,0,12th Pass,1197500,0,1197500
3510,3517,Principal Dr.Vithal Namdeorao Kadam,HINGOLI,AAP,0,Doctorate,9525025,926227,8598798
3511,3351,Prithiviraj Harichandan,BHUBANESWAR,BJP,1,Post Graduate,10162181,5087000,5075181
3512,3270,Priyabrata Garnaik,DHENKANAL,Samata Kranti Dal,0,Graduate,1191000,350000,841000
3513,4798,Pro. Purushottam Meghwal,MANDSOUR,IND,1,Post Graduate,6150367,2307000,3843367
3514,4472,Pro. Yogendra Mahto,BHAGALPUR,AAP,0,Doctorate,3087000,112000,2975000
3515,2239,Probash Chandra Sarkar,KARIMGANJ,SUCI(C),0,10th Pass,30000,0,30000
3516,141,Prodip Hazarika,JORHAT,AGP,0,Post Graduate,6989852,650000,6339852
3517,7223,Prof. Avinash Dolas,MUMBAI NORTH EAST,Bharipa Bahujan Mahasangh,0,Post Graduate,21912532,0,21912532
3518,2781,Prof. Bhim Singh,UDHAMPUR,JKNPP,0,Post Graduate,3895677,1410000,2485677
3519,5828,Prof. Dnyaneshwar Damu Mali,DINDORI,AAP,0,Post Graduate,14670,0,14670
3520,1423,Prof. Dr. Natthu Madhao Lokhande,RAMTEK,IND,0,Doctorate,5276500,0,5276500
3521,2844,Promod Kumar Mahatha,HAZARIBAGH,Pragatisheel Magahi Samaj,0,12th Pass,3030000,653525,2376475
3522,4767,Pt. Jagdish Chandra Bhatt,INDORE,Jai Maha Bharath Party,0,Graduate,5757342,0,5757342
3523,7386,"Pugazhendi, A. Thiru",SRIPERUMBUDUR,IND,0,Graduate Professional,797000,0,797000
3524,7376,Pulavar. E.Su. Mani. Thiru,SRIPERUMBUDUR,National Organisation Congress,0,Graduate,735000,0,735000
3525,4720,Pulis Hembrom,DUMKA,IND,0,Literate,1227400,0,1227400
3526,93,Puran Mal,BHIWANI-MAHENDRAGARH,IND,0,10th Pass,4158000,290000,3868000
3527,2033,Puran Singh Panwar,KARNAL,Rashtravadi Janata Party,0,Graduate Professional,3621304,296000,3325304
3528,737,Purnanand Tiwari,REWA,AAP,0,Post Graduate,1533286,0,1533286
3529,650,Purno Agitok Sangma,TURA,NPP,0,Post Graduate,215134618,0,215134618
3530,1274,Purshotam,FARIDABAD,AAP,0,10th Pass,27376208,1193221,26182987
3531,5252,Purushottam Choubey,BHAGALPUR,SP,2,10th Pass,1156393030,20310000,1136083030
3532,3671,Purushottam Jadhav,SATARA,IND,5,10th Pass,106966036,4653805,102312231
3533,5032,Pushpa Devi,KANNAUJ,Bhartiya Shakti Chetna Party,0,12th Pass,1976200,0,1976200
3534,1965,Pushpangathan,PATHANAMTHITTA,IND,0,10th Pass,92000,0,92000
3535,6960,"Pushparaj, S",CHIDAMBARAM,IND,0,8th Pass,1097000,0,1097000
3536,1547,Puspendra Singh,SIDHI,GGP,1,Graduate Professional,10453934,2020000,8433934
3537,4464,Putul Kumari,BANKA,BJP,2,Post Graduate,58028261,725973,57302288
3538,5592,Puvala Nageswara Rao,PONDICHERRY,IND,0,Literate,1400000,0,1400000
3539,1724,Pyare Lal,BULANDSHAHR,Bahujan Mukti Party,0,Graduate Professional,11325000,900000,10425000
3540,3210,Pyare Urf Rajkumar Gautam,SHAHJAHANPUR,VANCHITSAMAJ INSAAF PARTY,0,Not Given,65000,0,65000
3541,1907,R Biju,ALATHUR,IND,0,10th Pass,1500,0,1500
3542,2512,R Chandrika Kattakada,THIRUVANANTHAPURAM,RPI,0,10th Pass,150000,0,150000
3543,3743,R Gayathri,BANGALORE SOUTH,Pyramid Party of India,0,Post Graduate,2973000,300000,2673000
3544,1278,R K Anand,FARIDABAD,INLD,0,Graduate Professional,149352852,15495731,133857121
3545,2328,R S Kadyan,JHUNJHUNU,AAP,0,Post Graduate,130227500,0,130227500
3546,3832,R Venkatesan,SALEM,RPI(A),0,5th Pass,175000,0,175000
3547,863,R. Dhruvanarayana,CHAMARAJANAGAR,INC,0,Graduate,31519950,2605818,28914132
3548,6949,R. Kandasamy@Babu,CHENNAI SOUTH,Ambedkar Peoples Movement,0,8th Pass,351747,0,351747
3549,1194,R. Mohan Raju,BANGALORE CENTRAL,BSP,0,Post Graduate,6774000,460000,6314000
3550,1091,R. Prabhakara Reddy,BANGALORE RURAL,JD(S),0,Graduate,2243612066,2218003086,25608980
3551,5578,R. Radhakrishnan,PONDICHERRY,All India N.R. Congress,0,Post Graduate,77724418,7658530,70065888
3552,6920,R. Ravichandran,CHENNAI SOUTH,IND,0,5th Pass,660000,0,660000
3553,2163,R. Ravinayaka,BELLARY,JD(S),2,12th Pass,5286536,273603,5012933
3554,5588,R. Valavan,PONDICHERRY,IND,0,Others,942970,0,942970
3555,5568,R. Viswanathan,PONDICHERRY,CPI,0,10th Pass,27140629,6017909,21122720
3556,5472,R.Arumugam,VILUPPURAM,IND,0,Graduate,350000,200000,150000
3557,4304,R.Chakravarthi Raja Gopala Krishnan,TIRUPPUR,AAP,0,Post Graduate,325925000,0,325925000
3558,1534,R.D. Vishwkarma,REWA,Apna Dal,0,10th Pass,1575000,0,1575000
3559,3965,R.Gopalakrishnan,MADURAI,AIADMK,0,Graduate,72503060,7406366,65096694
3560,4305,R.Gopalsamy,TIRUPPUR,Lok Satta Party,0,Post Graduate,851533,191088,660445
3561,5581,R.K.R. Anantharaman,PONDICHERRY,Pattali Makkal Katchi,3,Graduate Professional,24654438,18044310,6610128
3562,6366,R.Manimaran,KALLAKURICHI,DMK,0,Post Graduate,23653826,1121682,22532144
3563,7422,R.Murugesan,TIRUPPUR,Makkal Manadu Katchi,0,Literate,5000,0,5000
3564,7430,R.Nandhakumar,TIRUPPUR,IND,0,8th Pass,46600,0,46600
3565,3953,R.P.Marutharajaa,PERAMBALUR,AIADMK,0,Post Graduate,24570213,0,24570213
3566,6368,R.Pandiyan,KALLAKURICHI,IND,0,10th Pass,1671563,0,1671563
3567,7433,R.R.Murugan,TIRUPPUR,IND,0,Post Graduate,1158000,0,1158000
3568,3797,R.Ravindra Kumar,KOLAR,Bharatiya Dr. B.R.Ambedkar Janta Party,0,Graduate,10601000,8332000,2269000
3569,123,R.S.Uma Bharatthy,ANDAMAN & NICOBAR ISLANDS,NCP,0,Post Graduate,1380999,253000,1127999
3570,6296,R.Saraswathi,ARANI,IND,0,12th Pass,375000,15000,360000
3571,7424,R.Sathyabama,TIRUPPUR,IND,0,Post Graduate,97000,0,97000
3572,7425,R.Sathyabhama,TIRUPPUR,IND,0,8th Pass,1071000,90000,981000
3573,6285,R.Sivanandam,ARANI,DMK,10,10th Pass,130816910,64526381,66290529
3574,7016,Raajarathinum F.M.,KANNIYAKUMARI,DMK,0,Post Graduate,14280853,3400000,10880853
3575,7524,"Rabeek, K.",THENI,IND,0,Others,946200,35000,911200
3576,3239,Rabindra Kumar Jena,BALASORE,BJD,0,Post Graduate,570139716,55893020,514246696
3577,3353,Rabindra Nath Behera,BHUBANESWAR,SP,0,Post Graduate,4697137,1714853,2982284
3578,2252,Rabindra Nath Choudhury,KARIMGANJ,AGP,0,Graduate Professional,15546810,0,15546810
3579,3028,Rabindra Roy Basunia,DARJEELING,IND,0,Post Graduate,3398828,230346,3168482
3580,2911,Rachna Dhingra,BHOPAL,AAP,3,Graduate Professional,7192772,0,7192772
3581,4681,Radha Bai Yadav,DURG,IND,0,Literate,1359207,0,1359207
3582,2427,Radha Devi,CHITTORGARH,CPI,0,Post Graduate,10625129,125000,10500129
3583,7530,Radhakrishnan,VIRUDHUNAGAR,AIADMK,0,10th Pass,43736485,5273447,38463038
3584,7483,Radhakrishnan A,SIVAGANGA,IND,0,12th Pass,511000,335000,176000
3585,1933,Radhakrishnan P T,ERNAKULAM,IND,0,Graduate Professional,3488000,0,3488000
3586,7015,Radhakrishnan P.,KANNIYAKUMARI,BJP,0,Graduate Professional,40963269,0,40963269
3587,7025,Radhakrishnan T.,KANNIYAKUMARI,IND,0,8th Pass,1290710,80000,1210710
3588,6967,"Radhakrishnan, C.P.",COIMBATORE,BJP,0,Graduate,663198857,35999300,627199557
3589,6984,"Radhakrishnan, R.",COIMBATORE,IND,0,5th Pass,100000,0,100000
3590,6321,Radhakrishnan.K.R,CUDDALORE,IND,0,8th Pass,1645000,271000,1374000
3591,7580,Radhakrishnan.S.,TENKASI,IND,1,Graduate Professional,12814404,1000000,11814404
3592,4816,Radheshayam Panavar,UJJAIN,AIFB,0,10th Pass,5065700,0,5065700
3593,2240,Radheshyam Biswas,KARIMGANJ,AIUDF,0,12th Pass,7068281,0,7068281
3594,4795,Radheshyam Gehlot (Raju Malviya),MANDSOUR,Bahujan Mukti Party,0,Graduate,9536000,3500000,6036000
3595,4179,Radheshyam Malviya,DEWAS,IND,0,Literate,1365144,0,1365144
3596,2420,Radhy Shyam Vaishnav,BHILWARA,Bahujan Sangharshh Dal,0,10th Pass,35000,0,35000
3597,4101,Rafiqul Islam,NOWGONG,AIFB,0,8th Pass,390000,0,390000
3598,7445,Ragavan. R,TIRUCHIRAPPALLI,IND,2,12th Pass,1730000,150000,1580000
3599,685,Raghav Lakhanpal,SAHARANPUR,BJP,0,Post Graduate,35406431,0,35406431
3600,2195,Raghavendra Krishnarao Thane,UTTARA KANNADA,AAP,0,Post Graduate,4952691,5616664,-663973
3601,907,Raghubir Singh,ANDAMAN & NICOBAR ISLANDS,SP,1,8th Pass,1128697,20000,1108697
3602,643,Raghunandan Prasad Vishwakarma,KODARMA,AIFB,0,10th Pass,4822232,487351,4334881
3603,3408,Raghunath Ramji Makasare,SHIRDI,Bharipa Bahujan Mahasangh,0,Post Graduate,2132555,289000,1843555
3604,2590,Raghunath Shankarrao Shelke,YAVATMAL-WASHIM,Ambedkarist Republican Party,0,Graduate,9692000,0,9692000
3605,3499,Raghunathdada Patil,HATKANANGLE,AAP,4,Graduate,20095000,695000,19400000
3606,1732,Raghuraj Pratap Singh,BULANDSHAHR,Rashtriya Kranti Party,0,12th Pass,849500,21000,828500
3607,1736,Raghuveer Singh Bodh,SAHARANPUR,IND,0,8th Pass,2590110,0,2590110
3608,2450,Raghuvir Singh,UDAIPUR,INC,0,Graduate Professional,26644500,3527476,23117024
3609,380,Ragini Lata Singh,AURANGABAD,AAP,0,Post Graduate,14532000,183755,14348245
3610,7090,Raguraman. A,MAYILADUTHURAI,IND,0,10th Pass,552881,0,552881
3611,5555,Rahat Afroz,FIROZABAD,IUML,0,10th Pass,9063214,0,9063214
3612,2333,Rahisa Bano,JHUNJHUNU,BSP,0,Literate,661308,0,661308
3613,528,Rahmat Ullah,KALIABOR,IND,0,Graduate Professional,255300,0,255300
3614,2312,Rahul Kaswan,CHURU,BJP,0,Graduate,25721266,5386104,20335162
3615,3857,Rahul Prabhakar Kamble,BEED,Ambedkarite Party of India,0,Graduate Professional,102000,0,102000
3616,2669,Rahul Ranjan,JAHANABAD,JMM,0,Graduate,3431000,0,3431000
3617,1422,Rahul Sheshraoji Meshram,RAMTEK,IND,0,12th Pass,10938968,0,10938968
3618,1427,Rahulkant Alias Ramesh Sinha,RAMTEK,IND,0,Graduate Professional,6520000,700000,5820000
3619,1685,Raj Babbar,GHAZIABAD,INC,1,12th Pass,197233950,22896345,174337605
3620,572,Raj Kumar,JAMMU,IND,0,12th Pass,2268500,0,2268500
3621,871,Raj Kumar,AMBALA,INC,0,10th Pass,36214599,5883900,30330699
3622,2023,Raj Kumar,HISAR,IND,0,10th Pass,66000,0,66000
3623,3128,Raj Kumar Gupta,MORADABAD,IND,0,8th Pass,1973100,0,1973100
3624,4479,Raj Kumar Mandal,KATIHAR,IND,0,Post Graduate,691300,0,691300
3625,1999,Raj Kumar Nagar,SIRSA,SP,0,Graduate,5675000,3200000,2475000
3626,2738,Raj Kumar Ram,PATALIPUTRA,BSP,0,10th Pass,660000,450000,210000
3627,1034,Raj Kumar Saini,KURUKSHETRA,IND,0,5th Pass,562200,24000,538200
3628,2641,Raj Kumar Singh,ARRAH,BJP,0,Graduate Professional,48403293,0,48403293
3629,4490,Raj Kumar Uraon,PURNIA,BSP,0,12th Pass,4277000,0,4277000
3630,367,Raj Narain Rao,SASARAM,IND,0,12th Pass,558000,100,557900
3631,992,Raj Pal Singh,WEST DELHI,BSP,0,Graduate,30390435,0,30390435
3632,2024,Raj Singh,HISAR,IND,0,Others,708500,0,708500
3633,6903,Raj. N,CHENNAI NORTH,IND,0,5th Pass,300000,0,300000
3634,5704,Raja A,SALEM,IND,1,8th Pass,1971000,0,1971000
3635,7484,Raja A,SIVAGANGA,IND,0,Graduate,309500,0,309500
3636,2966,Raja Pateriya,KHAJURAHO,INC,0,12th Pass,52438292,552639,51885653
3637,5021,Raja Ram,HATHRAS,IND,0,Graduate,575000,0,575000
3638,34,Raja Ram Singh,KARAKAT,CPI(ML)L,4,Graduate Professional,6796970,0,6796970
3639,2121,Raja Thimmappa Nayak,RAICHUR,BSP,0,12th Pass,15732000,100000,15632000
3640,7103,"Raja, A.",NILGIRIS,DMK,1,Graduate,36055771,3965347,32090424
3641,7525,"Raja, V.",THENI,IND,0,12th Pass,4709650,150000,4559650
3642,6904,Raja. B,CHENNAI NORTH,IND,0,Others,387500,0,387500
3643,2582,Rajagiri T.D,CHITRADURGA,BSP,3,Post Graduate,3875000,500000,3375000
3644,7390,"Rajagopal Mallar, P. Thiru",SRIPERUMBUDUR,IND,0,Post Graduate,8584801,1900000,6684801
3645,7003,Rajagopal V,ERODE,IND,0,12th Pass,327000,0,327000
3646,6976,"Rajagopal, M.",COIMBATORE,IND,0,10th Pass,6447504,120000,6327504
3647,5702,Rajakannu A,SALEM,IND,0,8th Pass,691401,0,691401
3648,7603,Rajamaravan @ Manickavasagam.S,TIRUNELVELI,IND,4,Graduate,174500,67601,106899
3649,1369,Rajan Lal,NORTH EAST DELHI,Bharatiya Republican Paksha,0,Graduate Professional,11571000,0,11571000
3650,1934,Rajaneesh Babu,ERNAKULAM,IND,0,10th Pass,1000,0,1000
3651,38,Rajani Dubey,KARAKAT,Akhil Bharatiya Jan Sangh,0,Graduate,8324677,0,8324677
3652,3918,Rajaram Mehar,BHOPAL,Proutist Sarva Samaj,0,Post Graduate,1530000,0,1530000
3653,4267,Rajaram Pal,AKBARPUR,INC,1,Graduate Professional,8888279,18738000,-9849721
3654,7129,"Rajasekar, T.",PERAMBALUR,IND,0,10th Pass,540000,0,540000
3655,4335,Rajasekar.S @ S.R.Thevar,SIVAGANGA,Desiya Forward Bloc,5,8th Pass,16012209,1437300,14574909
3656,7113,"Rajasekaran, M.,",PERAMBALUR,INC,4,Graduate,23598000,0,23598000
3657,2336,Rajbala,JHUNJHUNU,IND,0,8th Pass,816752,0,816752
3658,2326,Rajbala Ola,JHUNJHUNU,INC,0,Doctorate,58115000,500000,57615000
3659,147,Rajballabh Prasad,NAWADA,RJD,3,10th Pass,83137973,1387290,81750683
3660,423,Rajbir Palna,SIRSA,IND,0,Post Graduate,356000,37362,318638
3661,3161,Rajeev Agrawal,PILIBHIT,AAP,1,12th Pass,54959664,2264609,52695055
3662,3491,Rajeev Appasaheb Rajale,AHMEDNAGAR,NCP,3,Graduate Professional,63094594,17101039,45993555
3663,5600,Rajeev Satyendra Sharma,RAVER,AAP,0,Graduate,63431845,0,63431845
3664,3511,Rajeev Shankarrao Satav,HINGOLI,INC,0,Graduate Professional,49681499,584357,49097142
3665,2087,Rajeev Yadav,GURGAON,IND,0,Post Graduate,3963909,0,3963909
3666,84,Rajen Gohain,NOWGONG,BJP,1,Graduate Professional,24736544,5328287,19408257
3667,3296,Rajen Hansda,BALURGHAT,BSP,0,Post Graduate,512524,0,512524
3668,505,Rajen Saikia,TEZPUR,AIFB,0,10th Pass,1318447,0,1318447
3669,2097,Rajender,FARIDABAD,IND,0,10th Pass,940500,0,940500
3670,463,Rajender,FARIDABAD,BSP,0,Graduate,17146020,250000,16896020
3671,1749,Rajender Kumar,SAHARANPUR,Adarsh Rashtriya Vikas Party,0,Graduate,44300,0,44300
3672,1993,Rajender Kumar,AMBALA,Bhartiya Shakti Chetna Party,0,10th Pass,4150500,0,4150500
3673,6338,Rajendhran. R,DINDIGUL,IND,0,8th Pass,360500,0,360500
3674,4272,Rajendra,ETAH,Braj Vikas Party,0,12th Pass,1290000,0,1290000
3675,667,Rajendra Agarwal,MEERUT,BJP,2,Post Graduate,8803517,3074600,5728917
3676,3702,Rajendra Dnyandeo Randive,SOLAPUR,IND,0,Graduate Professional,34000,0,34000
3677,5646,Rajendra Gajbhiye,THANE,Ambedkarite Party of India,0,12th Pass,2011650,81832,1929818
3678,1155,Rajendra Kumar Mund,KALAHANDI,IND,0,Post Graduate,32280000,48000,32232000
3679,2665,Rajendra Kumar Singh Chauhan,BUXAR,Bharat Vikas Morcha,0,Literate,35000,0,35000
3680,3369,Rajendra Maruti Kate,MAVAL,IND,0,Graduate,402000,0,402000
3681,5560,Rajendra Prasad,FIROZABAD,Bahujan Mukti Party,0,Graduate,180000,50000,130000
3682,2889,Rajendra Purty,SINGHBHUM,Jharkhand Party,0,12th Pass,551520,15000,536520
3683,1016,Rajendra Singh,NAWADA,AAP,0,Graduate Professional,1455858,858745,597113
3684,4661,Rajendra Singh Kanwar,KORBA,Chhattisgarh Swabhiman Manch,0,Graduate,2737000,300000,2437000
3685,2878,Rajendra Singh Munda,RANCHI,CPI(M),0,10th Pass,8243730,3000,8240730
3686,1452,Rajendrakumar Punjabrao Kanphade,NAGPUR,IND,0,Graduate,1841093,0,1841093
3687,7151,Rajendran. M,POLLACHI,IND,0,12th Pass,129378,0,129378
3688,6309,Rajendran.K,CHIDAMBARAM,BSP,0,10th Pass,557000,0,557000
3689,744,Rajes Nandini Singh - Dalvir,SHAHDOL,INC,0,Graduate,41389440,645000,40744440
3690,2088,Rajesh,GURGAON,IND,0,10th Pass,36429409,880000,35549409
3691,1357,Rajesh,EAST DELHI,Ambedkar National Congress,0,Graduate,83220,0,83220
3692,1617,Rajesh Devi Urf Radhika,MUZAFFARNAGAR,AITC,0,Graduate Professional,7370060,0,7370060
3693,3919,Rajesh Keer,BHOPAL,Bahujan Mukti Party,0,Graduate Professional,2215850,15000,2200850
3694,2410,Rajesh Kumar,KOTA,Jai Maha Bharath Party,0,10th Pass,364000,0,364000
3695,2038,Rajesh Kumar,KARNAL,IND,0,Graduate,18210000,225000,17985000
3696,1318,Rajesh Kumar,NORTH WEST DELHI,Rashtriya Bahujan Hitay Party,0,10th Pass,1141000,0,1141000
3697,5235,Rajesh Kumar,ARARIA,Bharat Vikas Morcha,0,10th Pass,1475000,50000,1425000
3698,5018,Rajesh Kumar,HATHRAS,BJP,0,Graduate Professional,5651457,0,5651457
3699,7035,Rajesh Kumar K.R.,KANNIYAKUMARI,IND,0,Graduate,1121500,0,1121500
3700,4662,Rajesh Kumar Mahant,KORBA,JD(U),0,8th Pass,466000,0,466000
3701,4663,Rajesh Kumar Pandey,KORBA,IND,2,10th Pass,390250,0,390250
3702,2981,Rajesh Kushwah,MORENA,SP,0,Graduate Professional,491500,0,491500
3703,1890,Rajesh S,PALAKKAD,SHS,0,10th Pass,0,255390,-255390
3704,4177,Rajesh Sariyam,BETUL,AAP,0,Post Graduate,1797958,184853,1613105
3705,1453,Rajesh Suresh Sadhankar,NAGPUR,IND,0,Not Given,0,0,0
3706,6259,"Rajesh, R",ARAKKONAM,INC,0,Post Graduate,196025973,3000000,193025973
3707,6260,"Rajesh, S.",ARAKKONAM,AAP,0,Graduate Professional,7716,0,7716
3708,7605,Rajeshkannan,TIRUNELVELI,IND,0,8th Pass,2140000,0,2140000
3709,5048,Rajeshwari,MAINPURI,IND,0,Post Graduate,5331700,430000,4901700
3710,7604,Raji Yadav,TIRUNELVELI,IND,0,10th Pass,47955,0,47955
3711,6919,Rajini Nivetha,CHENNAI SOUTH,IND,0,12th Pass,151457,0,151457
3712,6997,Rajinikanth.S,DHARMAPURI,BSP,0,Graduate Professional,145000,0,145000
3713,2061,Rajiv,BHIWANI-MAHENDRAGARH,Bahujan Mukti Party,0,12th Pass,161000,0,161000
3714,2697,Rajiv Ranjan Singh Alias Lalan Singh,MUNGER,JD(U),1,Graduate,55757926,3512083,52245843
3715,1525,Rajkumar,SATNA,Bhartiya Shakti Chetna Party,0,10th Pass,790000,600000,190000
3716,3562,Rajkumar Bhimrao Chandanshive,LATUR,IND,0,8th Pass,108500,120000,-11500
3717,510,Rajkumar Dowarah,JORHAT,IND,0,Graduate,487600,0,487600
3718,1237,Rajkumar Pahan,CHATRA,Rashtriya Deshaj Party,0,Graduate,8851813,0,8851813
3719,3479,Rajkumar Ranjan Singh,INNER MANIPUR,BJP,0,Doctorate,13350861,0,13350861
3720,90,Rajkumar Saini,KURUKSHETRA,BJP,0,Graduate,132880476,23262108,109618368
3721,6961,"Rajkumar, S",CHIDAMBARAM,IND,0,12th Pass,3811500,0,3811500
3722,7467,Rajkumar.R,THANJAVUR,IND,0,Post Graduate,114000,0,114000
3723,6316,Rajkumar.V,CUDDALORE,IND,0,Graduate,368000,0,368000
3724,2103,Rajmahendra Sakharam Gaonkar,BELGAUM,IND,0,Post Graduate,3620123,0,3620123
3725,494,Rajmohan Gandhi,EAST DELHI,AAP,0,Post Graduate,48208736,0,48208736
3726,5421,Rajnath,SURGUJA,IND,0,10th Pass,732000,0,732000
3727,2321,Rajpal,CHURU,IND,0,Post Graduate,25500,0,25500
3728,3036,Rajpal,AMROHA,Adarsh Rashtriya Vikas Party,0,10th Pass,2901400,30000,2871400
3729,3304,Rajratna Ambedkar,NANDED,Bahujan Mukti Party,0,Post Graduate,4040148,450000,3590148
3730,5176,Raju Baburao Dole,AURANGABAD,IND,0,Graduate,16149796,3435981,12713815
3731,1561,Raju Baiga,SHAHDOL,IND,1,10th Pass,5177500,120000,5057500
3732,1985,Raju Dsouza,NORTH GOA,Samajwadi Janata Party (Rashtriya),0,10th Pass,9352368,5050000,4302368
3733,2377,Raju Lal Bairwa,JAIPUR,Ambedkarite Party of India,0,10th Pass,4327500,96000,4231500
3734,1111,Raju Mahadeorao Sonone,AMRAVATI,IND,0,Graduate,674000,0,674000
3735,1522,Raju Or Bharatraje Uddhaorao Patil,YAVATMAL-WASHIM,MNS,6,Graduate,25700000,1400000,24300000
3736,1838,Raju Padaganur,BIJAPUR,IND,0,10th Pass,680000,10000,670000
3737,48,Raju S. Mankar,AMRAVATI,IND,0,Literate,13736000,150000,13586000
3738,3501,Raju Shetty,HATKANANGLE,Swabhimani Paksha,12,10th Pass,16152914,1504152,14648762
3739,5647,Raju Shravan Chavan,THANE,Republican Bahujan Sena,0,Literate,3326553,325000,3001553
3740,2642,Raju Yadav,ARRAH,CPI(ML)L,1,Post Graduate,491000,0,491000
3741,4733,Rajvardhan Azad,GODDA,JD(U),0,Post Graduate,26048342,0,26048342
3742,5562,Rajveer,FIROZABAD,IND,0,10th Pass,394000,0,394000
3743,4952,Rajveer Singh,ETAH,IND,0,Graduate,2752626,0,2752626
3744,4277,Rajvir Singh,ETAH,BJP,0,Graduate Professional,251921157,46898091,205023066
3745,2360,Rajyavardhan Singh Rathore,JAIPUR RURAL,BJP,0,Graduate,83734044,117065,83616979
3746,1628,Rakesh,MUZAFFARNAGAR,IND,0,12th Pass,1818316,28990,1789326
3747,1714,Rakesh,GAUTAM BUDHHA NAGAR,IND,0,12th Pass,19913600,0,19913600
3748,3049,Rakesh,AMROHA,Peace Party,1,8th Pass,4005000,40000,3965000
3749,3216,Rakesh,SHAHJAHANPUR,IND,0,Not Given,90000,0,90000
3750,2308,Rakesh Chandra Rawat,ALIGARH,Rashtriya Sawarn Dal,0,Post Graduate,23000000,0,23000000
3751,4273,Rakesh Gandhi,ETAH,IND,0,Graduate,3578000,0,3578000
3752,2070,Rakesh Kumar,BHIWANI-MAHENDRAGARH,IND,0,Graduate Professional,8693411,1050000,7643411
3753,1305,Rakesh Kumar,WEST DELHI,Bhartiya Janta Dal (Integrated),0,10th Pass,40000,0,40000
3754,1292,Rakesh Kumar,SOUTH DELHI,IND,0,10th Pass,660800,0,660800
3755,2022,Rakesh Kumar (Rinku Bhai),HISAR,IND,0,12th Pass,451122,28102,423020
3756,4186,Rakesh Kumar Patel,INDORE,IND,0,Graduate Professional,180000,0,180000
3757,5024,Rakesh Kumar Tiwari Advocate,KANNAUJ,IND,0,Graduate Professional,2856442,0,2856442
3758,2719,Rakesh Ranjan Sinha,NALANDA,RPI(A),0,Graduate,3748727,16599,3732128
3759,373,Rakesh Sharma,AURANGABAD,IND,0,Doctorate,12693861,828288,11865573
3760,750,Rakesh Singh Urf Ghanshyam Singh,JABALPUR,BJP,1,Graduate,27823610,0,27823610
3761,3035,Rakesh Tikait,AMROHA,RLD,3,Graduate,42518038,1095120,41422918
3762,4395,Rakesh Yadav,FIROZABAD,AAP,0,Post Graduate,55947000,3400000,52547000
3763,166,Rakhal Raj Datta,TRIPURA WEST,Amra Bangalee,0,Post Graduate,6549960,0,6549960
3764,496,Rakhi Birla,NORTH WEST DELHI,AAP,0,Post Graduate,163467,230000,-66533
3765,5905,Rakhi Sawant,MUMBAI NORTH WEST,Rashtriya Aam Party,1,Illiterate,146946664,32528125,114418539
3766,3163,Ram Autar,PILIBHIT,CPI(ML)L,0,12th Pass,2345938,0,2345938
3767,2703,Ram Badan Rai,MUNGER,SP,0,Post Graduate,23860981,1000000,22860981
3768,1706,Ram Bilash,GAUTAM BUDHHA NAGAR,Bahujan Mukti Party,0,5th Pass,6470000,0,6470000
3769,1363,Ram Briksh Mall,EAST DELHI,Hindusthan Nirman Dal,0,Post Graduate,18234000,956912,17277088
3770,3015,Ram Charan Ahirwar,TIKAMGARH,Poorvanchal Rashtriya Congress,0,12th Pass,4650000,0,4650000
3771,3448,Ram Dayal,JODHPUR,IND,0,12th Pass,1231000,0,1231000
3772,5010,Ram Dayal,HARDOI,Peace Party,0,Post Graduate,24264635,732,24263903
3773,561,Ram Dayal Singh,KARAKAT,IND,0,Graduate,3256600,0,3256600
3774,4867,Ram Ekbal Shahani,DHUBRI,IND,0,5th Pass,2755078,0,2755078
3775,3106,Ram Gopal Mishra,KHERI,IND,0,8th Pass,27258000,5000,27253000
3776,1557,Ram Gopal Singh,SHAHDOL,Bhartiya Shakti Chetna Party,0,8th Pass,1475529,0,1475529
3777,5129,Ram Hans,TONK-SAWAI MADHOPUR,Naya Daur Party,0,10th Pass,320000,0,320000
3778,1025,Ram Jawari,AMBALA,Rashtriya Karmyog Party,0,Graduate,245500,0,245500
3779,1319,Ram Karan Sauran,NORTH WEST DELHI,IND,0,Graduate,11854000,1257000,10597000
3780,1995,Ram Kishan,KURUKSHETRA,Lok Parivartan Party(DC),0,10th Pass,1785984,0,1785984
3781,1544,Ram Kishan Nirat (Saket),REWA,RPI(A),1,Post Graduate,897056,100000,797056
3782,4981,Ram Kishore Dwivedi,FARRUKHABAD,IND,0,Not Given,309300,0,309300
3783,2750,Ram Kripal Yadav,PATALIPUTRA,BJP,1,Graduate,13989431,2100000,11889431
3784,5014,Ram Lakhan Gautam,HARDOI,Indian Savaran Samaj Party,0,10th Pass,660000,0,660000
3785,2964,Ram Lakhan Singh,KHAJURAHO,BSP,1,Post Graduate,8657688,497625,8160063
3786,4011,Ram Lal Mahto,RANCHI,SUCI(C),0,Graduate,521590,0,521590
3787,3213,Ram Lal Verma,SHAHJAHANPUR,Bahujan Mukti Party,0,Graduate,2029000,28000,2001000
3788,3212,Ram Murti,SHAHJAHANPUR,Bhartiya Krishak Dal,0,Not Given,534000,0,534000
3789,4645,Ram Narayan Ayam,RAIGARH,Ambedkarite Party of India,0,Graduate,1811000,0,1811000
3790,2987,Ram Naresh,MORENA,IND,0,Literate,220000,0,220000
3791,2968,Ram Nath,KHAJURAHO,IND,0,8th Pass,420000,330000,90000
3792,1162,Ram Nayak,KANDHAMAL,BSP,0,5th Pass,1774911,713000,1061911
3793,5011,Ram Pal,HARDOI,IND,0,8th Pass,1601000,0,1601000
3794,5137,Ram Parkash,TONK-SAWAI MADHOPUR,IND,0,8th Pass,2650000,0,2650000
3795,2956,Ram Pathwar Kori (Ramsebak),GWALIOR,IND,0,12th Pass,53200,0,53200
3796,80,Ram Prasad Sharma,TEZPUR,BJP,0,Graduate Professional,6655300,0,6655300
3797,2302,Ram Ratan,BIKANER,Bahujan Mukti Party,0,8th Pass,477590,0,477590
3798,4936,Ram Sevak,AKBARPUR,IND,0,Graduate,43000,0,43000
3799,5117,Ram Singh,KARAULI-DHOLPUR,National Peoples Party,0,Graduate,862500,0,862500
3800,1559,Ram Singh,SHAHDOL,Chhattisgarh Swabhiman Manch,0,8th Pass,186000,0,186000
3801,2383,Ram Singh,JAIPUR,IND,0,Graduate,730306,0,730306
3802,4509,Ram Singh Pandram,BILASPUR,IND,0,12th Pass,691542,7000,684542
3803,3228,Rama Chandra Hansdah,MAYURBHANJ,BJD,0,Graduate,3630888,0,3630888
3804,99,Rama Chandra Panda,BERHAMPUR,BJP,0,Post Graduate,5552220,0,5552220
3805,4713,Rama Kant Verma,DHANBAD,AAP,0,8th Pass,1703826,0,1703826
3806,2485,Rama Ram,BARMER,IND,0,5th Pass,365485,36000,329485
3807,5422,Rama Sapna Singh,SURGUJA,Ambedkarite Party of India,0,Graduate,1478276,13209,1465067
3808,5225,Rama Singh Patel,DHAR,IND,0,8th Pass,700852,0,700852
3809,6996,Rama Suganthan,DHARMAPURI,INC,0,Post Graduate,207501877,1100000,206401877
3810,7389,"Ramachandiran, K. Thiru",SRIPERUMBUDUR,IND,0,5th Pass,762000,0,762000
3811,7372,"Ramachandran, K.N. Thiru",SRIPERUMBUDUR,AIADMK,0,Post Graduate,936721057,80806268,855914789
3812,2673,Ramadhar Chaudhary,JAHANABAD,CPI(ML)L,3,10th Pass,577037,0,577037
3813,5684,Ramajeyam.G,NAMAKKAL,IND,0,12th Pass,996000,0,996000
3814,4259,Ramakant,AKBARPUR,Peace Party,0,Graduate Professional,6928000,3400000,3528000
3815,1554,Ramakant Pandey Malaihna,SIDHI,IND,0,Post Graduate,515000,0,515000
3816,5577,Ramamurthi,PONDICHERRY,IND,0,8th Pass,4000,0,4000
3817,1128,Raman Motiram Bansod,BHANDARA-GONDIYA,Ambedkarite Party of India,0,Post Graduate,58800,50000,8800
3818,5234,Ramanand Rishideo,ARARIA,Lok Dal,0,12th Pass,10000,0,10000
3819,2155,Ramanna,BIDAR,Hindustan Janta Party,0,5th Pass,435000,0,435000
3820,1344,Ramanuj Patel,NEW DELHI,Samyak Parivartan Party,0,12th Pass,100,0,100
3821,3727,Ramanuj Singh,BANGALORE CENTRAL,IND,0,Graduate Professional,84383,56000,28383
3822,1826,Ramappa Mareppa Chalawadi,BELGAUM,IND,1,10th Pass,1620326,50000,1570326
3823,7118,"Ramar Yadav, K.",PERAMBALUR,Tamil Nadu Makkal Congress,0,Not Given,805000,0,805000
3824,7150,Ramasamy. K,POLLACHI,IND,0,Graduate,7571000,0,7571000
3825,6902,Ramasamy. M.D.,CHENNAI NORTH,IND,0,8th Pass,7243000,0,7243000
3826,4039,Ramasamy.N,NAMAKKAL,IND,0,Illiterate,30000,0,30000
3827,5675,Ramasamy.P,NAMAKKAL,IND,0,12th Pass,605332,0,605332
3828,743,Ramashankar Shahwal,SIDHI,BSP,0,Post Graduate,9743656,1092000,8651656
3829,7587,Ramasubbu.S.S,TIRUNELVELI,INC,0,Post Graduate,42408738,8590027,33818711
3830,2845,Ramavtar Mahto,HAZARIBAGH,IND,0,12th Pass,1863000,0,1863000
3831,7513,"Ramaya, R.",THENI,IND,0,5th Pass,188926,45000,143926
3832,1264,Rambadan Ram,PALAMAU,SP,0,Post Graduate,2450000,800000,1650000
3833,7623,Rambhau Vitthal Chinchore,JALNA,IND,0,10th Pass,50000,200000,-150000
3834,4764,Ramchand Vasaini,INDORE,IND,0,10th Pass,3703000,0,3703000
3835,4190,Ramchandr Parmar,INDORE,Bahujan Mukti Party,2,10th Pass,130000,0,130000
3836,5648,Ramchandra Bhagoji Gawade,THANE,IND,0,Literate,660000,175000,485000
3837,3322,Ramchandra Gangaram Bharande,NANDED,IND,0,Post Graduate,100000,0,100000
3838,3305,Ramchandra Gyanoba Sawant,NANDED,Bharipa Bahujan Mahasangh,0,10th Pass,176000,0,176000
3839,2371,Ramcharan Bohara,JAIPUR,BJP,0,12th Pass,135809546,23871000,111938546
3840,944,Ramdas Chandrabhanji Tadas,WARDHA,BJP,5,10th Pass,33628998,1749314,31879684
3841,4821,Ramdayal Kori,VIDISHA,IND,0,10th Pass,1117500,0,1117500
3842,5419,Ramdeo Tirkey,SURGUJA,INC,0,12th Pass,7254485,1408815,5845670
3843,5279,Ramdev Sharma,SUPAUL,IND,0,12th Pass,250000,0,250000
3844,83,Ramen Deka,MANGALDOI,BJP,0,Graduate,14782357,5400953,9381404
3845,4270,Ramendra Singh Tomar,AKBARPUR,Bhartiya Shakti Chetna Party,0,10th Pass,4818007,0,4818007
3846,4925,Ramesh,AGRA,JD(U),2,Graduate Professional,431000,0,431000
3847,5112,Ramesh,KARAULI-DHOLPUR,Bharatiya Yuva Shakti,0,12th Pass,835000,0,835000
3848,2053,Ramesh,SONIPAT,IND,0,Graduate Professional,42376491,425241,41951250
3849,2136,Ramesh,BIDAR,Ambedkar National Congress,1,10th Pass,1957000,0,1957000
3850,1592,Ramesh,CHHINDWARA,Ambedkarite Party of India,0,8th Pass,0,0,0
3851,1823,Ramesh Alias Suresh Guruling Kadalaskar,BELGAUM,BSP,0,12th Pass,479000,0,479000
3852,109,Ramesh Bais,RAIPUR,BJP,0,12th Pass,73190135,274902,72915233
3853,4698,Ramesh Bharati,DHANBAD,IND,2,Graduate Professional,6053500,0,6053500
3854,71,Ramesh Bidhuri,SOUTH DELHI,BJP,4,Graduate Professional,147493056,0,147493056
3855,1023,Ramesh Chand,AMBALA,IND,0,10th Pass,1110000,0,1110000
3856,5132,Ramesh Chand,TONK-SAWAI MADHOPUR,Lok Dal,0,12th Pass,48000,0,48000
3857,677,Ramesh Chand Tomar,GAUTAM BUDHHA NAGAR,INC,4,Doctorate,61617189,0,61617189
3858,3014,Ramesh Chand Verma,TIKAMGARH,AAP,0,Graduate Professional,1698238,325000,1373238
3859,891,Ramesh Chander,CHANDIGARH,IND,0,Graduate,3324,0,3324
3860,2640,Ramesh Chandra Badal,ARRAH,BSP,1,Literate,726000,0,726000
3861,2346,Ramesh Chandra Sharma,SIKAR,Bhartiya Party,0,Graduate Professional,9353600,0,9353600
3862,4198,Ramesh Chensingh,KHARGONE,INC,1,5th Pass,5264289,720473,4543816
3863,3248,Ramesh Jena,BHADRAK,CPI,0,Graduate,346987,0,346987
3864,840,Ramesh Jigajinagi,BIJAPUR,BJP,2,Graduate,89429828,5305043,84124785
3865,6875,Ramesh Kannan .G,CHENNAI NORTH,Republican Party of India,0,Graduate,6306550,495000,5811550
3866,91,Ramesh Kaushik,SONIPAT,BJP,0,Graduate Professional,142840716,0,142840716
3867,3800,Ramesh Koti,KOPPAL,RPI(A),0,Graduate Professional,491000,0,491000
3868,1018,Ramesh Kumar,SOUTH DELHI,INC,0,10th Pass,172314296,0,172314296
3869,2787,Ramesh Kumar Gawde,KANKER,CPI,1,8th Pass,65000,100000,-35000
3870,4711,Ramesh Kumar Ray,DHANBAD,IND,0,12th Pass,239715,0,239715
3871,5433,Ramesh P,TIRUVANNAMALAI,IND,0,Others,247000,0,247000
3872,5082,Ramesh Panaval,ALWAR,IND,0,12th Pass,16000,0,16000
3873,5208,Ramesh Ragho More,DHULE,IND,0,10th Pass,5704000,0,5704000
3874,1368,Ramesh Singh Siral,NORTH EAST DELHI,Naya Daur Party,0,8th Pass,2490000,0,2490000
3875,1041,Ramesh Vishwanath Katti,CHIKKODI,BJP,0,12th Pass,89216294,598000,88618294
3876,3912,Ramesh Yadav,RAJNANDGAON,IND,0,12th Pass,1930155,0,1930155
3877,7388,"Ramesh, Thiru",SRIPERUMBUDUR,IND,0,Graduate,3249079,862500,2386579
3878,5377,Rameshwar Kewat,BILASPUR,IND,0,Post Graduate,630031,30000,600031
3879,1028,Rameshwar Kumar,KURUKSHETRA,Bhartiya Shakti Chetna Party,0,10th Pass,7416637,0,7416637
3880,479,Rameshwar Oraon,LOHARDAGA,INC,0,Doctorate,262697987,0,262697987
3881,2745,Rameshwar Prasad,PATALIPUTRA,CPI(ML)L,6,8th Pass,2386000,0,2386000
3882,645,Rameshwar Prasad Yadav,KODARMA,IND,0,Post Graduate,1488300,45000,1443300
3883,2833,Rameshwar Ram Kushwaha,HAZARIBAGH,AIFB,1,Graduate,946596,0,946596
3884,4307,Rameshwar Singh,FARRUKHABAD,SP,13,10th Pass,135820923,3878042,131942881
3885,81,Rameshwar Teli,DIBRUGARH,BJP,0,10th Pass,977943,0,977943
3886,3116,Rameshwari,KHERI,IND,0,Literate,202000,0,202000
3887,5413,Ramgopal Verma,RAIPUR,AITC,0,5th Pass,1100000,0,1100000
3888,5019,Ramji Lal Suman,HATHRAS,SP,2,Graduate Professional,29953498,0,29953498
3889,5253,Ramji Mandal,BHAGALPUR,IND,0,10th Pass,3631000,0,3631000
3890,32,Ramji Manjhi,GAYA,RJD,0,Graduate,11115000,0,11115000
3891,3983,Ramji Sahu,BILASPUR,Chhattisgarh Swabhiman Manch,0,12th Pass,2597500,0,2597500
3892,377,Ramji Singh,AURANGABAD,IND,0,Post Graduate,1310000,50000,1260000
3893,1611,Ramkaran,KAIRANA,Bhartiya Vanchitsamaj Party,0,Post Graduate,2659619,0,2659619
3894,4138,Ramkrishna Verma,RAIPUR,IND,0,8th Pass,12168,0,12168
3895,7563,Ramkumar. V,THOOTHUKKUDI,IND,0,10th Pass,240000,0,240000
3896,172,Ramla Mampad,WAYANAD,Welfare Party of India,0,12th Pass,2401057,0,2401057
3897,3415,Ramlal,AJMER,Akhil Bhartiya Aamjan Party,0,8th Pass,110000,0,110000
3898,3475,Ramlal,PALI,IND,0,Doctorate,11493000,600000,10893000
3899,2526,Rammurti Keshvrao Chimote,NAGPUR,GGP,0,12th Pass,2792000,0,2792000
3900,476,Ramnaresh Singh,CHATRA,CPI(ML)L,4,10th Pass,1255000,0,1255000
3901,4515,Ramnath Cherwa,SURGUJA,Shoshit Samaj Dal,0,8th Pass,9000,0,9000
3902,4968,Ramniwas Katheria,FARRUKHABAD,Bahujan Mukti Party,0,Post Graduate,5102500,0,5102500
3903,486,Rampati Ranjan,PALAMAU,BSP,0,Graduate,4445000,0,4445000
3904,203,Ramphal,HISAR,IND,0,12th Pass,26200,0,26200
3905,1697,Ramphal Shakya,GHAZIABAD,IND,0,Not Given,3200000,1077,3198923
3906,2039,Ramphal Sharma,KARNAL,IND,0,10th Pass,4537000,0,4537000
3907,4023,Rampodo Mahto,RANCHI,IND,6,8th Pass,7296004,300000,6996004
3908,7510,"Ramprakash, J.",THENI,AAP,0,Post Graduate,24102861,2725330,21377531
3909,4210,Ramprasad Jatwa,UJJAIN,BSP,0,Graduate,200900,0,200900
3910,3345,Ramrao Dhansing Rathod Sir Nirankari,PARBHANI,IND,0,Post Graduate,9330000,0,9330000
3911,1477,Ramrao Govinda Nannaware,GADCHIROLI-CHIMUR,BSP,0,Graduate,2671687,1030335,1641352
3912,3515,Ramrao Harising Rathod,HINGOLI,Bharipa Bahujan Mahasangh,1,10th Pass,8884209,0,8884209
3913,1558,Ramratan Singh Pawley,SHAHDOL,GGP,0,Post Graduate,227724,0,227724
3914,2788,Ramsay Korram,KANKER,BSP,0,12th Pass,1070000,9594,1060406
3915,2875,Ramtahal Choudhary,RANCHI,BJP,0,10th Pass,10743950,0,10743950
3916,1442,Ramteke Jivan Namdeorao,NAGPUR,IND,0,10th Pass,390000,0,390000
3917,1395,Ramteke Ramesh Devidasrao,AMRAVATI,Republican Party of India (Khobragade),0,12th Pass,5770500,300000,5470500
3918,2113,Ramu Chatru,GULBARGA,IND,0,Graduate,1100000,0,1100000
3919,3739,Ramu S,BANGALORE NORTH,IND,0,12th Pass,807570,0,807570
3920,2159,Ramudu,BELLARY,BSP,0,5th Pass,0,0,0
3921,3427,Ran Singh Rajpurohit,JALORE,Jago Party,0,10th Pass,1675000,0,1675000
3922,808,Rana Nag,BOLANGIR,BSP,0,Graduate,13940000,1700000,12240000
3923,4150,Ranbir Singh,DHANBAD,IND,0,Literate,47000,0,47000
3924,415,Ranbir Singh Sharma,KURUKSHETRA,IND,0,Graduate Professional,14604045,300000,14304045
3925,235,Ranee Narah,LAKHIMPUR,INC,0,Graduate,88519819,1118242,87401577
3926,3820,Ranendra Nath Mali,BALURGHAT,Bahujan Mukti Party,0,12th Pass,1128000,0,1128000
3927,3818,Ranganayak,RAICHUR,Pyramid Party of India,0,10th Pass,555000,16000,539000
3928,7184,Rangarajan Mohan Kumaramangalam,SALEM,INC,0,Post Graduate,240204511,26229574,213974937
3929,4986,Rani Pakshalika Singh,FATEHPUR SIKRI,SP,0,Graduate,121911632,4507031,117404601
3930,7107,"Rani, M.T.",NILGIRIS,AAP,0,Post Graduate,6000000,0,6000000
3931,5248,Ranjan Kumar,BHAGALPUR,IND,0,8th Pass,355833,0,355833
3932,2737,Ranjan Prasad Yadav,PATALIPUTRA,JD(U),0,Doctorate,55327154,1766678,53560476
3933,1135,Ranjeet Amardas Sukhdeve,BHANDARA-GONDIYA,Ambedkar samaj Party,0,12th Pass,1854500,225000,1629500
3934,4499,Ranjeet Ranjan,SUPAUL,INC,5,12th Pass,81242965,0,81242965
3935,7252,Ranjit Jugla Padvi,NANDURBAR,Bahujan Mukti Party,0,12th Pass,0,0,0
3936,2881,Ranjit Mahto,RANCHI,Bahujan Mukti Party,0,Post Graduate,254840,0,254840
3937,3262,Ranjit Malik,JAJPUR,Bahujan Mukti Party,1,Graduate,1316991,270889,1046102
3938,1255,Ranjit Oraon,LOHARDAGA,IND,0,12th Pass,2024021,0,2024021
3939,3979,Ranjit Shekhar Mooshahary,KOKRAJHAR,AITC,0,Graduate,31461513,0,31461513
3940,86,Ranjit Singh Gorh,LAKHIMPUR,IND,0,Graduate,4611700,0,4611700
3941,6983,"Ranjithkumar, M.",COIMBATORE,IND,0,5th Pass,1641250,226000,1415250
3942,2005,Ranvir Khobra,SIRSA,IND,0,Graduate,7896000,1450000,6446000
3943,5874,Rasal Shashikant Dada,KALYAN,IND,0,8th Pass,70000,0,70000
3944,7077,Rasavelu.K,MAYILADUTHURAI,BSP,3,Graduate,12500,0,12500
3945,2266,Rashid Ahmed Laskar,SILCHAR,SP,0,12th Pass,785000,0,785000
3946,3204,Rashid Hussain,SAMBHAL,IND,5,Literate,5907000,1000000,4907000
3947,1374,Rashmi Kashyap,CHANDNI CHOWK,Bhartiya Pragatisheel Congress,0,10th Pass,3123000,0,3123000
3948,167,Ratan Chakraborti,TRIPURA WEST,AITC,0,Graduate,3314729,0,3314729
3949,5919,Ratan Devram Bodake,MUMBAI SOUTH,IND,0,10th Pass,6560000,0,6560000
3950,2424,Ratan Lal Dhobi,BHILWARA,IND,0,Literate,1000,0,1000
3951,1742,Ratan Singh,SAHARANPUR,Bahujan Mukti Party,0,Others,46134617,0,46134617
3952,1348,Ratheesh,NEW DELHI,IND,0,Graduate,45200,0,45200
3953,1949,Ratheesh Perumal,KOTTAYAM,IND,0,10th Pass,1000,0,1000
3954,3815,Rathi Poovaiah,MYSORE,Karunaadu Party,0,Graduate,410000,0,410000
3955,7534,Rathinavelu,VIRUDHUNAGAR,DMK,0,Graduate Professional,91534108,4384420,87149688
3956,5649,Rathod Babusingh Vasram,THANE,Maharashtra Parivartan Sena (T),0,Not Given,100000,0,100000
3957,1510,Rathod Baliram Parashram,YAVATMAL-WASHIM,BSP,0,Graduate Professional,26249301,2106000,24143301
3958,1500,Rathod Induwar Kashiram,YAVATMAL-WASHIM,Bahujan Mukti Party,0,12th Pass,5950000,210000,5740000
3959,1515,Rathod Mohan Mallu,YAVATMAL-WASHIM,Bharipa Bahujan Mahasangh,0,Post Graduate,34013105,1750000,32263105
3960,1517,Rathod Naresh Fulsing,YAVATMAL-WASHIM,AAP,0,Graduate Professional,2030000,0,2030000
3961,5861,Rathod Ramesh Lalsing,JALNA,Bahujan Mukti Party,0,10th Pass,1958026,81000,1877026
3962,89,Rattan Lal Kataria,AMBALA,BJP,0,Post Graduate,42150634,843229,41307405
3963,4447,Ratul Kumar Choudhury,MANGALDOI,SP,1,Graduate,780000,80000,700000
3964,322,Raut Jaganath Nilkanth,WARDHA,IND,0,Graduate Professional,5940000,0,5940000
3965,7180,Ravi .K,RAMANATHAPURAM,IND,0,5th Pass,75000,0,75000
3966,1396,Ravi Alias Shailesh Ganeshrao Yelne,WARDHA,IND,0,Graduate,1671754,0,1671754
3967,3442,Ravi Garg,JODHPUR,Bharat Nav Nirman Party,0,12th Pass,1382000,0,1382000
3968,858,Ravi Krishna Reddy,BANGALORE RURAL,AAP,0,Post Graduate,54433258,0,54433258
3969,1346,Ravi Kumar Gupta,NEW DELHI,IND,0,12th Pass,17057930,15000,17042930
3970,1071,Ravi Menasinakai,HAVERI,JD(S),0,Graduate Professional,21964323,2395704,19568619
3971,1980,Ravi Naik,NORTH GOA,INC,0,Post Graduate,81066000,3126000,77940000
3972,6901,Ravi Pariyanar. D,CHENNAI NORTH,IND,0,10th Pass,100000,0,100000
3973,3105,Ravi Prakash Verma,KHERI,SP,1,Graduate Professional,8213389,18800,8194589
3974,4766,Ravi Sirwaiya,INDORE,IND,0,12th Pass,256000,0,256000
3975,6276,"Ravi, N.D.",ARAKKONAM,IND,0,Illiterate,55000,0,55000
3976,7054,"Ravi, S.P.",KARUR,IND,0,Graduate Professional,392000,0,392000
3977,6266,"Ravi, V.",ARAKKONAM,IND,0,12th Pass,281800,0,281800
3978,7440,Ravi.P,TIRUCHIRAPPALLI,AAP,1,Post Graduate,137774,81869,55905
3979,363,Ravikant Chaudhary,SASARAM,IND,0,10th Pass,225500,0,225500
3980,7364,Ravikumar. D,TIRUVALLUR,Viduthalal Chiruthaigal Katchi,1,Post Graduate,5886482,2472629,3413853
3981,6900,Ravikumar. T,CHENNAI NORTH,IND,0,Graduate Professional,1128300,0,1128300
3982,7368,Ravikumar.M,TIRUVALLUR,IND,0,12th Pass,160000,0,160000
3983,3745,Ravikumara T,BANGALORE SOUTH,SP,0,Graduate Professional,25140,28000,-2860
3984,1277,Ravinder,FARIDABAD,Akhil Bharat Hindu Mahasabha,0,12th Pass,327600,0,327600
3985,1271,Ravinder Kumar,ROHTAK,Indian Bahujan Sandesh Party (Kanshiram),0,12th Pass,1245000,0,1245000
3986,1709,Ravinder Sharma,GAUTAM BUDHHA NAGAR,Rashtriya Kranti Party,0,8th Pass,5992835,0,5992835
3987,3387,Ravindra Bhimrao Takale,BARAMATI,Bahujan Mukti Party,2,Graduate,294748,0,294748
3988,3368,Ravindra Kashinath Patil,MAVAL,IND,1,Graduate Professional,10563000,0,10563000
3989,2676,Ravindra Kumar,JAHANABAD,BSP,1,Graduate,1252000,0,1252000
3990,3158,Ravindra Kumar Devnath,PILIBHIT,IND,0,Graduate,2495450,0,2495450
3991,2814,Ravindra Kumar Pandey,GIRIDIH,BJP,0,Graduate,73376970,1970628,71406342
3992,1266,Ravindra Kumar Ravi,PALAMAU,IND,0,12th Pass,200000,0,200000
3993,47,Ravindra Kumar Ray,KODARMA,BJP,0,Doctorate,10564046,200000,10364046
3994,4257,Ravindra Singh,AGRA,AAP,0,Post Graduate,6501178,1500000,5001178
3995,5459,Ravindran T,TIRUVANNAMALAI,Tamil Nadu Makkal Congress,0,10th Pass,280000,114000,166000
3996,1378,Ravindrasing Ramsing Pawar,BULDHANA,Lok Bharati,0,12th Pass,160000,0,160000
3997,607,Reddy G K C,CHIKKBALLAPUR,JD(U),0,Doctorate,6302974,0,6302974
3998,3076,Reena,BADAUN,Rashtriya Samanta Dal,0,Post Graduate,93856,0,93856
3999,3214,Reeta Singh Urf Reeta Bharti,SHAHJAHANPUR,AAP,0,Graduate,591671,154000,437671
4000,2256,Rejamond Ali Barbhuiya,SILCHAR,CPI(M),0,Graduate Professional,1164212,0,1164212
4001,3195,Rekha Devi Yadav,SAMBHAL,Sanyukt Samajwadi Dal,0,Not Given,202000,0,202000
4002,7130,"Rengaraju, M.",PERAMBALUR,IND,0,8th Pass,1350950,0,1350950
4003,1766,Renuka Sinha,COOCHBEHAR,AITC,0,Graduate Professional,13017282,0,13017282
4004,2443,Resham Malviya,BANSWARA,INC,0,12th Pass,25370874,6079932,19290942
4005,1063,Revasing Loku,GULBARGA,BJP,0,5th Pass,33293923,3500000,29793923
4006,7091,Revathi.A,MAYILADUTHURAI,IND,0,10th Pass,6097180,3045000,3052180
4007,403,Ribulaya Gogoi,JORHAT,AITC,0,10th Pass,1383171,0,1383171
4008,539,Richard D. Shabong,SHILLONG,CPI,0,12th Pass,1328273,0,1328273
4009,5414,Rijhendra Dahariya,RAIPUR,IND,0,10th Pass,180000,0,180000
4010,7246,Rina Mahendrakumar Zaveri,MUMBAI NORTH WEST,IND,0,Graduate Professional,4591000,50000,4541000
4011,4469,Rinki Kumari,BHAGALPUR,CPI(ML)L,7,Post Graduate,22192,0,22192
4012,1674,Rinku Kumar Tyagi,GHAZIABAD,IND,0,Others,31501000,4000000,27501000
4013,2241,Rinku Malakar,KARIMGANJ,SP,0,8th Pass,533500,13000,520500
4014,381,Rita Devi,AURANGABAD,SP,0,10th Pass,5136715,800000,4336715
4015,3255,Rita Tarai,JAJPUR,BJD,0,12th Pass,1622003,0,1622003
4016,741,Riti Pathak,SIDHI,BJP,0,Post Graduate,33416561,0,33416561
4017,4705,Ritu Rani Singh,DHANBAD,IND,2,10th Pass,1260459,728268,532191
4018,609,Rizwan Arshad,BANGALORE CENTRAL,INC,2,Graduate,31400000,0,31400000
4019,1179,Robert Romawia Royte,MIZORAM,IND,0,Post Graduate,346499910,0,346499910
4020,1099,Robin Mathews Narekattu,CHIKKBALLAPUR,SP,0,Post Graduate,251460907,97836250,153624657
4021,1241,Robin Singh,CHATRA,IND,0,10th Pass,6430000,0,6430000
4022,2998,Rod Ji,RAJGARH,IND,0,Literate,676000,0,676000
4023,2993,Rodmal Nagar,RAJGARH,BJP,0,Graduate,28569974,3586473,24983501
4024,4323,Rohan Singh,FATEHPUR SIKRI,Bahujan Mukti Party,0,5th Pass,1668371,0,1668371
4025,3591,Rohan Subhash Deshmukh,OSMANABAD,IND,0,Graduate,7275515,7510376,-234861
4026,3584,Rohit Ramrushna More,MADHA,IND,0,Graduate Professional,342105,842166,-500061
4027,3607,Rokade Milind Somnath,OSMANABAD,Bharipa Bahujan Mahasangh,0,Post Graduate,1112500,226000,886500
4028,3126,Roopa Chandra Singh,MORADABAD,IND,0,10th Pass,7677881,21833,7656048
4029,1002,Roshan Ali,NORTH EAST DELHI,National Loktantrik Party,0,Not Given,3351382,0,3351382
4030,3217,Roshan Lal Urf Roshan Kanaujia,SHAHJAHANPUR,IND,0,Graduate Professional,991198,0,991198
4031,3850,Rothod Digambar Ramrao,BEED,BSP,0,Graduate,11325000,1060000,10265000
4032,307,Roy Arackal,KOTTAYAM,SDPI,0,10th Pass,513300,0,513300
4033,1345,Rubina Khan,NEW DELHI,IND,0,Graduate,602439,0,602439
4034,1282,Ruby Yadav,SOUTH DELHI,IND,0,Post Graduate,10797222,0,10797222
4035,3265,Rudranarayan Pany,DHENKANAL,BJP,5,Graduate,267145,0,267145
4036,3778,Rudregowda,HASSAN,Jai Vijaya Bharathi Party,0,Graduate Professional,3640000,1450000,2190000
4037,1842,Rudresh Dayappa Dodamani,BIJAPUR,IND,0,Post Graduate,2090000,400000,1690000
4038,2178,Rudresh Ramanna Hadagali,HAVERI,IND,0,Graduate,4006360,176924,3829436
4039,3449,Rugha Ram Choudhary Advocate,JODHPUR,IND,0,Graduate Professional,4180402,0,4180402
4040,4236,Rukmani,DAUSA,Socialist Party (India),0,Literate,2767391,175000,2592391
4041,1663,Ruksana,BAGHPAT,IND,0,Illiterate,562000,0,562000
4042,3635,Rupali Tamboli,PUNE,IND,0,Graduate,14136754,1950000,12186754
4043,3906,Rupanand Soi,MAHASAMUND,IND,0,12th Pass,185433,0,185433
4044,2892,Rupsingh Hembrom,SINGHBHUM,IND,0,10th Pass,4305000,0,4305000
4045,3742,Ruth Manorama,BANGALORE SOUTH,JD(S),0,Post Graduate,14950943,1189000,13761943
4046,1703,Ruvez Alam Rahi,GAUTAM BUDHHA NAGAR,National Loktantrik Party,0,12th Pass,337000,0,337000
4047,2164,S Bheemappa,BELLARY,CPI(ML) Red star,0,8th Pass,18900,0,18900
4048,2548,S P Mahadevappa,MYSORE,JD(U),0,10th Pass,925000,150000,775000
4049,4054,S Periyakaruppan,SIVAGANGA,IND,0,10th Pass,4190000,1566338,2623662
4050,1969,S Radhakrishnan,PATHANAMTHITTA,IND,0,12th Pass,1875000,0,1875000
4051,1959,S Radhamani,PATHANAMTHITTA,SUCI(C),0,Graduate,16880,0,16880
4052,601,S S Mallikarjun,DAVANAGERE,INC,6,Graduate,645637999,66208771,579429228
4053,6935,S. Balamurali,CHENNAI SOUTH,IND,0,Graduate,289100,0,289100
4054,6915,S. Balu,CHENNAI SOUTH,IND,0,Graduate Professional,845000,263732,581268
4055,3432,S. Buta Singh,JALORE,IND,0,Doctorate,59509479,1132860,58376619
4056,6945,S. Charumathi,CHENNAI SOUTH,IND,0,8th Pass,850000,0,850000
4057,5585,S. Chitrakala,PONDICHERRY,JD(U),0,Graduate,5255000,1460000,3795000
4058,6924,S. Devadoss,CHENNAI SOUTH,IND,0,12th Pass,25000,0,25000
4059,5573,S. Ezhilarasan,PONDICHERRY,IND,0,Graduate,70500,30000,40500
4060,3760,S. Govinda Nayaka,CHAMARAJANAGAR,IND,0,10th Pass,2151000,100000,2051000
4061,4064,S. Krishnamoorthy,PONDICHERRY,BSP,0,8th Pass,990200,10000,980200
4062,2589,S. Meetyanaik,CHITRADURGA,SP,0,Graduate,890000,100000,790000
4063,6927,S. Parthiban,CHENNAI SOUTH,IND,0,10th Pass,14805512,0,14805512
4064,6941,S. Pragasam,CHENNAI SOUTH,IND,0,Graduate Professional,10902944,0,10902944
4065,3930,S. Rajendran,VILUPPURAM,AIADMK,0,Graduate,6200000,2371331,3828669
4066,6936,S. Rajeshwari,CHENNAI SOUTH,IND,0,5th Pass,0,0,0
4067,5569,S. Sanjivganthi,PONDICHERRY,IND,0,Graduate Professional,750,0,750
4068,2221,S. Satish Salian,SHIMOGA,IND,0,12th Pass,617300,80750,536550
4069,6925,S. Seethalakshmi,CHENNAI SOUTH,Tamil Nadu Makkal Congress,0,Doctorate,4180000,1900000,2280000
4070,6946,S. Sesu Raj,CHENNAI SOUTH,IND,0,Others,500000,50000,450000
4071,5579,S. Sudarsanan,PONDICHERRY,IND,0,8th Pass,261000,0,261000
4072,6937,S. Veeramani,CHENNAI SOUTH,IND,0,Post Graduate,2242000,0,2242000
4073,7498,S.Arivudainambi,MADURAI,IND,0,Graduate Professional,261000,0,261000
4074,3782,S.B. Rajegowda,HASSAN,IND,0,Others,25000,0,25000
4075,1952,S.B.Basheer,ALAPPUZHA,IND,0,5th Pass,50000,0,50000
4076,2577,S.B.Hanumantharayappa,TUMKUR,IND,0,12th Pass,787507,0,787507
4077,6845,S.D. Krishnakumar,CHENNAI CENTRAL,RPI(A),0,12th Pass,1960000,822000,1138000
4078,5465,S.Devi,VILUPPURAM,IND,8,10th Pass,5575000,1200000,4375000
4079,6294,S.Elumalai,ARANI,IND,0,5th Pass,6362653,0,6362653
4080,7497,S.Ganesan,MADURAI,IND,0,10th Pass,230000,0,230000
4081,3835,S.Girija,CUDDALORE,IND,0,Post Graduate,370000,0,370000
4082,7429,S.K.Dineshkumar,TIRUPPUR,IND,0,10th Pass,92000,0,92000
4083,4288,S.Lakshmanan,KALLAKURICHI,IND,0,8th Pass,575000,0,575000
4084,6365,S.Madhaiyan,KALLAKURICHI,IND,0,Illiterate,550000,44000,506000
4085,4334,S.Manickavasagam,MADURAI,IND,0,Illiterate,20000,0,20000
4086,6301,S.Manikandan,ARANI,IND,0,12th Pass,165324,0,165324
4087,3781,S.N. Mallappa,HASSAN,IND,0,12th Pass,3765750,255000,3510750
4088,4043,S.Natarajan,TIRUCHIRAPPALLI,BSP,0,12th Pass,6585500,1050000,5535500
4089,605,S.P.Muddahanumegowda,TUMKUR,INC,0,Graduate Professional,30273812,0,30273812
4090,4665,S.R. Anchal,KORBA,IND,0,Post Graduate,230000,0,230000
4091,6846,S.R. Vijayakumar,CHENNAI CENTRAL,AIADMK,0,Graduate Professional,13401510,350483,13051027
4092,6305,S.Ramamoorthy,ARANI,IND,0,10th Pass,230000,0,230000
4093,3993,S.S. Subhan Khan,DAVANAGERE,IND,0,Post Graduate,76000,0,76000
4094,6922,S.S.Radhakrishnan,CHENNAI SOUTH,IND,0,Post Graduate,42980572,1359520,41621052
4095,6362,S.Sakthivel,KALLAKURICHI,BSP,0,Others,1355000,0,1355000
4096,6298,S.Senthilnathan,ARANI,IND,0,Post Graduate,6676752,1837784,4838968
4097,2523,S.Siddaramaiah Heggade,BANGALORE RURAL,IND,1,12th Pass,477000,0,477000
4098,4045,S.Sridhar,TIRUCHIRAPPALLI,CPI(M),0,Post Graduate,199925,89859,110066
4099,6938,S.V. Ramani,CHENNAI SOUTH,INC,0,Graduate,1598751,255309,1343442
4100,2816,Saba Ahmad,GIRIDIH,JVM(P),1,Graduate Professional,5820782,0,5820782
4101,4443,Sabda Ram Rabha,KOKRAJHAR,IND,0,Graduate Professional,3607000,0,3607000
4102,1681,Sabir,GHAZIABAD,IND,0,Others,1836155,16555,1819600
4103,7237,Sabir Mehandi Hasan,MUMBAI NORTH EAST,IND,0,5th Pass,11506000,500000,11006000
4104,5944,Sable Namdev Sahebrao,MUMBAI SOUTH CENTRAL,IND,0,Graduate,6935466,1259570,5675896
4105,708,Sabu Varghese,IDUKKI,BJP,0,Graduate Professional,9755000,386540,9368460
4106,2242,Sabuj Das,KARIMGANJ,IND,0,10th Pass,332000,0,332000
4107,1960,Sabukutty Joy (Sabu Puthuchera),PATHANAMTHITTA,Social Action Party,1,Post Graduate,21739967,2025000,19714967
4108,3277,Sabyasachi Mahapatra,CUTTACK,CPI(ML) Red star,0,Graduate,600,0,600
4109,3336,Sabyasachi Mohapatra,PURI,Kalinga Sena,0,Graduate Professional,484637,21840,462797
4110,7258,Sachin Damodar Shingda,PALGHAR,IND,0,10th Pass,42874357,5223972,37650385
4111,5920,Sachin Narayan Pawar,MUMBAI SOUTH,Bahujan Mukti Party,0,12th Pass,914709,0,914709
4112,1401,Sachin Pandurangji Raut Alias Gurubhau,WARDHA,IND,0,12th Pass,600000,0,600000
4113,3411,Sachin Pilot,AJMER,INC,0,Post Graduate,53934000,0,53934000
4114,4984,Sachin Singh,FARRUKHABAD,IND,1,Graduate,30876925,895209,29981716
4115,2500,Sachintra Debbarma,TRIPURA EAST,INC,0,Graduate Professional,28560336,0,28560336
4116,2197,Sadanand Deshbhandari,UTTARA KANNADA,IND,0,Graduate,3348114,598550,2749564
4117,3990,Sadhan Chatterjee,MALDAHA DAKSHIN,IND,0,Graduate Professional,14981015,0,14981015
4118,6274,"Sadhu Muthu Kristnan Erajandran, T.M.S.",ARAKKONAM,IND,0,Doctorate,0,0,0
4119,3886,Sadulla Asdulla Inamdar,BEED,IND,0,10th Pass,200000,0,200000
4120,151,Safdar Ismail,NAWADA,IND,0,Graduate Professional,8605000,25000,8580000
4121,1712,Safruddin,GAUTAM BUDHHA NAGAR,IND,0,10th Pass,17029000,0,17029000
4122,1229,Sagar Ram,CHATRA,Akhil Bharat Hindu Mahasabha,0,Literate,700000,0,700000
4123,802,Sagar Singh Manaki,SUNDARGARH,Kosal Kranti Dal,0,Graduate,5069000,0,5069000
4124,532,Sahaba Ahmed,KALIABOR,IND,0,Graduate Professional,10104000,0,10104000
4125,4723,Sahadeo Soren,DUMKA,AAP,0,Post Graduate,10977580,0,10977580
4126,4449,Sahadev Das,MANGALDOI,BPF,0,Post Graduate,1036784,0,1036784
4127,1156,Sahadev Jal,KALAHANDI,Bahujan Mukti Party,0,Graduate,1199800,0,1199800
4128,749,Sahdev Singh Paraste,SHAHDOL,National Peoples Party,0,Post Graduate,1586000,150000,1436000
4129,4886,Sahnur Ali,MANGALDOI,IND,0,10th Pass,2001874,215000,1786874
4130,3914,Sahukar Bhaskar,RAJNANDGAON,IND,0,8th Pass,2335477,150000,2185477
4131,3380,Saiyyad Afser Ibrahim,PUNE,SP,0,8th Pass,80991201,619000,80372201
4132,2243,Sajalendu Malakar,KARIMGANJ,IND,0,10th Pass,417000,0,417000
4133,4760,Sajan Singh,DEWAS,IND,0,5th Pass,320000,0,320000
4134,1925,Saji Thuruthikunnel,CHALAKUDY,SHS,3,12th Pass,3017995,1206000,1811995
4135,4024,Sajiya Haidar,RANCHI,IND,0,12th Pass,22851217,6348982,16502235
4136,2825,Sajjadur Rab Hasami,GIRIDIH,IND,0,12th Pass,550000,0,550000
4137,453,Sajjan Singh,ROHTAK,IND,0,Illiterate,2761000,250000,2511000
4138,4755,Sajjan Singh Verma,DEWAS,INC,0,Post Graduate,65670004,250694,65419310
4139,7193,Sakharam Pandurang Dunghav,MUMBAI NORTH,Maharashtra Parivartan Sena (T),0,10th Pass,50000,0,50000
4140,3860,Saksamudre Bhagwan Kachruba,BEED,Bahujan Mukti Party,0,Others,2407094,535000,1872094
4141,4294,Sakthivel S,SALEM,IND,0,8th Pass,3100000,0,3100000
4142,5683,Sakthivel.S.P,NAMAKKAL,IND,0,5th Pass,1265000,0,1265000
4143,3220,Sakuntala Laguri,KEONJHAR,BJD,0,10th Pass,101531625,0,101531625
4144,2171,Saleem Azeez Ahmed,HAVERI,INC,0,Post Graduate,59573517,0,59573517
4145,3057,Saleem Iqbal Shervani,AONLA,INC,7,Graduate,353932000,0,353932000
4146,1682,Saleem Malik,GHAZIABAD,IND,0,8th Pass,10000,0,10000
4147,4510,Salik Ram Jogi,BILASPUR,IND,0,Post Graduate,650000,67000,583000
4148,525,Salil Saha,TRIPURA WEST,AAP,0,Post Graduate,41153192,1973987,39179205
4149,2322,Salim Gujar,CHURU,IND,0,Literate,201000,0,201000
4150,2888,Salkhan Murmu,SINGHBHUM,Jharkhand Disom Party,3,Post Graduate,6252094,500000,5752094
4151,3333,Salma Shriniwas Kulkarni,PARBHANI,AAP,0,Post Graduate,1956452,470000,1486452
4152,5651,Salman Ajimullah Hasmi,THANE,Rashtriya Aam Party,0,8th Pass,877400,0,877400
4153,4313,Salman Khursheed,FARRUKHABAD,INC,0,Post Graduate,123886145,2855000,121031145
4154,170,Sam P Mathew,WAYANAD,CPI(ML) Red star,4,12th Pass,1934280,0,1934280
4155,1789,Saman Pathak,DARJEELING,CPI(M),4,Graduate,1959732,2142,1957590
4156,4157,Samaresh Singh,DHANBAD,JVM(P),15,10th Pass,9949808,672954,9276854
4157,1379,Sambare Dinkar Tukaram,BULDHANA,IND,0,10th Pass,10000,0,10000
4158,6989,Sambath.M,DHARMAPURI,IND,0,8th Pass,485060,0,485060
4159,5213,Sambhaji Devidas Patil,DHULE,Bahujan Mukti Party,0,8th Pass,932080,0,932080
4160,3280,Samir Dey,CUTTACK,BJP,1,Graduate Professional,19960747,6719742,13241005
4161,1267,Sampat Singh,HISAR,INC,0,Post Graduate,62661560,14371778,48289782
4162,1205,Sampath Kumar,CHAMARAJANAGAR,AAP,0,Graduate Professional,20951240,2190000,18761240
4163,7383,Sampath. K. Thiru,SRIPERUMBUDUR,IND,0,Graduate,95596,28500,67096
4164,1089,Sampathu N,MYSORE,IND,0,Graduate Professional,16127000,1200000,14927000
4165,3537,Sampatrao Shamrao Pawar Patil,KOLHAPUR,Peasants And Workers Party of India,2,Graduate,11600046,2192330,9407716
4166,5134,Sampatti Bai Alias Sunita Verma,TONK-SAWAI MADHOPUR,IND,0,10th Pass,950500,0,950500
4167,3822,Samrat Ghosh,JANGIPUR,BJP,0,Graduate Professional,3771352,1250000,2521352
4168,2062,Samser,BHIWANI-MAHENDRAGARH,National Loktantrik Party,0,Literate,161000,0,161000
4169,529,Samsul Alam,KALIABOR,AITC,0,Graduate,605000,0,605000
4170,4858,Samsul Hoque,BARPETA,IND,0,8th Pass,732000,0,732000
4171,7556,Samuel. A.S.,THOOTHUKKUDI,IND,0,Literate,150000,0,150000
4172,1549,Sanat Kumar Tripathi,SIDHI,Bhartiya Shakti Chetna Party,1,12th Pass,1615000,0,1615000
4173,2696,Sandeep,MUNGER,AAP,0,Graduate Professional,5790000,750000,5040000
4174,493,Sandeep Dikshit,EAST DELHI,INC,0,Post Graduate,73671067,8872174,64798893
4175,3545,Sandeep Gundopant Sankpal,KOLHAPUR,IND,0,10th Pass,419925,8410,411515
4176,3124,Sandeep Kumar,MORADABAD,Sarva Samaj Kalyan Party,0,Graduate,1160000,0,1160000
4177,6005,Sandeep Pandurang Parte,RAIGAD,Hindustan Janta Party,0,Literate,271966000,203000,271763000
4178,1589,Sandeep Soni,BALAGHAT,IND,1,Graduate,31006,0,31006
4179,5415,Sandeep Tiwari,RAIPUR,AAP,1,Post Graduate,950818,0,950818
4180,1387,Sandesh Ashok Ambedkar,BULDHANA,Bahujan Mukti Party,0,Post Graduate,1280500,0,1280500
4181,941,Sandesh Bhivram Bhalekar,RAMTEK,AIFB,0,Graduate Professional,1003000,0,1003000
4182,3672,Sandip Amrutrao Mozar,SATARA,IND,10,Graduate Professional,6204277,1745000,4459277
4183,1108,Sandip Kisanrao Wankhede,AKOLA,IND,0,Graduate,50000,0,50000
4184,1186,Sanganna A. Karadi,KOPPAL,BJP,1,10th Pass,12127000,6848000,5279000
4185,806,Sangeeta Kumari Singh Deo,BOLANGIR,BJP,3,Graduate,62357000,3817340,58539660
4186,5935,Sanghapal Hirachand Gadekar,MUMBAI SOUTH CENTRAL,Ambedkarite Party of India,0,Graduate,42083,0,42083
4187,4415,Sanghmitra Maurya,MAINPURI,BSP,1,Graduate Professional,17494581,0,17494581
4188,3249,Sangram Keshari Jena,BHADRAK,INC,5,Post Graduate,10108428,23025000,-12916572
4189,4747,Saniram Hembrom,RAJMAHAL,IND,0,10th Pass,1090000,0,1090000
4190,2054,Sanjay,SONIPAT,IND,0,10th Pass,15800000,0,15800000
4191,790,Sanjay Bhoi,BARGARH,INC,0,Graduate,25786368,3000000,22786368
4192,2462,Sanjay Choudhary,RAJSAMAND,IND,0,Graduate,9990000,420000,9570000
4193,5652,Sanjay Dilip Kumar Das,THANE,IND,0,Graduate,11518516,555000,10963516
4194,7222,Sanjay Dina Patil,MUMBAI NORTH EAST,NCP,3,Graduate,19904204,0,19904204
4195,985,Sanjay Gandhi,CHANDNI CHOWK,Braj Vikas Party,0,12th Pass,151747504,0,151747504
4196,3159,Sanjay Kapoor,PILIBHIT,INC,0,Graduate Professional,76385000,3330000,73055000
4197,35,Sanjay Kewat,KARAKAT,BSP,0,Graduate,1997000,0,1997000
4198,596,Sanjay Kothari,DHARWAD,IND,0,Graduate,2958023,0,2958023
4199,2433,Sanjay Kumar,CHITTORGARH,BSP,0,10th Pass,5560400,700000,4860400
4200,2311,Sanjay Kumar,ALIGARH,IND,0,5th Pass,1000,0,1000
4201,3162,Sanjay Kumar,PILIBHIT,Naitik Party,0,Literate,47000,32000,15000
4202,2713,Sanjay Kumar,NALANDA,BSP,0,10th Pass,920000,25000,895000
4203,4463,Sanjay Kumar,BANKA,CPI,3,Post Graduate,23633247,9460885,14172362
4204,4461,Sanjay Kumar,BANKA,BSP,1,10th Pass,1800000,1200000,600000
4205,4397,Sanjay Kumar,HARDOI,Bhartiya Krishak Dal,0,Graduate,552200,0,552200
4206,502,Sanjay Kumar Rai,SOUTH DELHI,BSP,1,12th Pass,5839937,0,5839937
4207,4457,Sanjay Kumar Rishidev,ARARIA,CPI(ML)L,1,Literate,14175,0,14175
4208,3279,Sanjay Kumar Sahoo,CUTTACK,IND,0,Others,1050960,0,1050960
4209,3382,Sanjay Laxman Padwal,PUNE,Bhartiya Navjawan Sena (Paksha),0,10th Pass,95000,0,95000
4210,1388,Sanjay Mahadev Wankhade,BULDHANA,IND,0,Graduate,2037000,260000,1777000
4211,17,Sanjay Maurya,FARIDABAD,IND,0,8th Pass,143541,0,143541
4212,469,Sanjay Meshack,ANDAMAN & NICOBAR ISLANDS,AAP,0,10th Pass,57497526,633088,56864438
4213,1493,Sanjay Nilkanth Gawande,CHANDRAPUR,IND,0,12th Pass,2170000,0,2170000
4214,5895,Sanjay Nirupam,MUMBAI NORTH,INC,9,Graduate,57290996,3739000,53551996
4215,5856,Sanjay Nivrutti Hivrale,JALNA,Ambedkar National Congress,0,8th Pass,401000,0,401000
4216,4197,Sanjay S/O Laxman Solanki,KHANDWA,BSP,1,Graduate,3646000,830000,2816000
4217,3533,Sanjay Sadashiv Mandalik,KOLHAPUR,SHS,0,Post Graduate,11672709,920570,10752139
4218,7238,Sanjay Saoji Deshpande,MUMBAI NORTH EAST,IND,0,10th Pass,6818000,1423000,5395000
4219,5025,Sanjay Shakya,KANNAUJ,IND,0,Graduate Professional,1636000,600000,1036000
4220,5269,Sanjay Singh,PURNIA,IND,0,10th Pass,106700,0,106700
4221,4480,Sanjay Singh,KATIHAR,IND,0,Post Graduate,10830016,202000,10628016
4222,1399,Sanjaybhau Narayanrao Chidam,WARDHA,IND,0,12th Pass,5610091,50000,5560091
4223,3655,Sanjaykaka Patil,SANGLI,BJP,0,10th Pass,108791027,19198050,89592977
4224,5104,Sanjeet Kumar,DAUSA,AAP,0,Doctorate,4465861,1823880,2641981
4225,5653,Sanjeev Ganesh Naik,THANE,NCP,0,12th Pass,148635752,43986747,104649005
4226,1679,Sanjeev Kumar,GHAZIABAD,IND,0,Post Graduate,5671309,0,5671309
4227,2822,Sanjeev Kumar Mahato,GIRIDIH,IND,0,12th Pass,813000,0,813000
4228,2974,Sanjeev Kumar Mishra,KHAJURAHO,AIFB,0,12th Pass,401000,0,401000
4229,5654,Sanjeev Vishnu Sane,THANE,AAP,0,10th Pass,12971518,611559,12359959
4230,2249,Sanjit Kumar Das,KARIMGANJ,IND,0,10th Pass,640607,0,640607
4231,4832,Sanjit Singh,JANGIPUR,BSP,0,8th Pass,945000,0,945000
4232,2000,Sanjiv Bhojraj,SIRSA,VANCHITSAMAJ INSAAF PARTY,1,10th Pass,106000,0,106000
4233,2819,Sanjiv Kumar Sinha,GIRIDIH,AIFB,0,Graduate,646296,120000,526296
4234,7202,Sanju Verma,MUMBAI NORTH CENTRAL,IND,0,Post Graduate,183100000,3738000,179362000
4235,7541,Sankar,VIRUDHUNAGAR,IND,0,Post Graduate,405000,0,405000
4236,45,Sankar Prasad Datta,TRIPURA WEST,CPI(M),1,Post Graduate,1320900,0,1320900
4237,824,Sankar Sahu,ASKA,CPI(ML) Red star,0,Post Graduate,1294992,0,1294992
4238,6955,"Sanmugam, A",CHIDAMBARAM,IND,0,5th Pass,1731000,0,1731000
4239,4442,Sansuma Khunggur Bwiswmuthiary,KOKRAJHAR,IND,0,Graduate,21117979,571917,20546062
4240,444,Sant Dharamvir Chotiwala,SONIPAT,IND,0,Graduate Professional,30110000,50000,30060000
4241,5013,Sant Ram,HARDOI,Bahujan Mukti Party,0,Literate,717400,0,717400
4242,5928,Santan Daigo Farnandis,MUMBAI SOUTH,IND,0,12th Pass,149000,0,149000
4243,7555,Santhadevi. S,THOOTHUKKUDI,IND,0,Graduate,679000,0,679000
4244,7532,Santhanakrishnan,VIRUDHUNAGAR,Tamil Nadu Makkal Congress,0,10th Pass,1153247,2437,1150810
4245,1966,Santhosh Kumar,PATHANAMTHITTA,IND,3,Graduate Professional,1081000,0,1081000
4246,1202,Santhoshmohan,HASSAN,AAP,0,Graduate Professional,23700200,100000,23600200
4247,2332,Santosh Ahlawat,JHUNJHUNU,BJP,0,Post Graduate,35897048,5704000,30193048
4248,2923,Santosh Bharti,DAMOH,AAP,3,Others,15854961,5569039,10285922
4249,2810,Santosh Chandrakar,RAJNANDGAON,GGP,0,10th Pass,4656512,325188,4331324
4250,5416,Santosh Dahariya,RAIPUR,IND,0,12th Pass,490000,200000,290000
4251,3084,Santosh Gangwar,BAREILLY,BJP,0,Graduate Professional,38602862,1777215,36825647
4252,3975,Santosh Kumar,PURNIA,JD(U),3,12th Pass,22316594,1406515,20910079
4253,3068,Santosh Kumar,BADAUN,RPI(A),0,Not Given,857849,0,857849
4254,378,Santosh Kumar,AURANGABAD,BSP,2,Graduate,130000,0,130000
4255,2791,Santosh Kumar Dhruw,KANKER,AAP,0,Graduate,195543,0,195543
4256,4192,Santosh Kumar Garg,INDORE,IND,0,12th Pass,695000,0,695000
4257,3678,Santosh Madhukar Roham,SHIRDI,Bahujan Mukti Party,0,Graduate,3430530,901903,2528627
4258,2109,Santosh Manjunath Shet(Raikar),BELGAUM,IND,0,10th Pass,3592220,0,3592220
4259,2102,Santosh Manohar Bavadekar,BELGAUM,IND,1,Graduate,115082,0,115082
4260,3868,Santosh Namdeorao Sagne,HINGOLI,Awami Vikas Party,0,Others,1671000,1035000,636000
4261,3640,Santosh Pawar,PUNE,IND,0,Graduate,3229500,0,3229500
4262,3413,Sanwar Lal,AJMER,NCP,0,5th Pass,1092020,0,1092020
4263,3412,Sanwar Lal Jat,AJMER,BJP,0,Doctorate,18064656,0,18064656
4264,7624,Sapkal Lilabai Dharma,JALNA,IND,0,Not Given,410000,0,410000
4265,1911,Sarah Joseph,THRISSUR,AAP,0,Post Graduate,4122398,0,4122398
4266,3480,Sarangthem Manaobi,INNER MANIPUR,AITC,0,Post Graduate,920000,0,920000
4267,7028,Saraswathi S.,KANNIYAKUMARI,IND,0,10th Pass,560000,0,560000
4268,7043,"Saraswathy, K.",KARUR,CPI(ML) Red Star,0,Illiterate,735815,0,735815
4269,1147,Saraswati Nanda,BOLANGIR,AAP,0,Post Graduate,279095,0,279095
4270,3250,Sarat Das,BHADRAK,BJP,0,Post Graduate,1241350,309933,931417
4271,222,Sarat Pattnayak,BOLANGIR,INC,0,Graduate Professional,43999656,818572,43181084
4272,583,Saravanan,ANDAMAN & NICOBAR ISLANDS,IND,0,Graduate,236000,0,236000
4273,7594,Saravanan.P,TIRUNELVELI,IND,0,12th Pass,83586,0,83586
4274,7070,Saravanan.V,KRISHNAGIRI,IND,0,10th Pass,6166935,1950000,4216935
4275,517,Sarbananda Sonowal,LAKHIMPUR,BJP,0,Graduate Professional,14497515,0,14497515
4276,4466,Sargun Sah,BANKA,IND,0,8th Pass,1824000,0,1824000
4277,3147,Sarika,NAGINA,AAP,2,Graduate,400000,0,400000
4278,4511,Sarita Soni,BILASPUR,IND,0,12th Pass,1676000,0,1676000
4279,5390,Sarju Prasad Shukla,DURG,IND,0,10th Pass,15887210,770000,15117210
4280,5954,Sarkate Devidas Piraji,NASHIK,IND,0,12th Pass,57301,0,57301
4281,3409,Sarode Popat Rambhau,SHIRDI,Lok Bharati,0,12th Pass,272400,250000,22400
4282,3003,Saroj Katiyar Kurmi,SAGAR,BSP,0,Post Graduate,24415594,1590878,22824716
4283,5012,Saroj Kumar,HARDOI,IND,0,12th Pass,2776000,1520000,1256000
4284,1157,Saroj Kumar Naik,KALAHANDI,BSP,0,Graduate,5880000,120000,5760000
4285,3238,Saroj Kumar Panda,BALASORE,IND,0,Graduate,570000,0,570000
4286,365,Saroj Ram,SASARAM,Bahujan Mukti Party,0,Graduate Professional,2255786,80350,2175436
4287,7437,Sarubala R Thondaiman,TIRUCHIRAPPALLI,INC,0,Post Graduate,570772432,1513575,569258857
4288,5009,Sarvesh,HARDOI,IND,0,10th Pass,3956424,270000,3686424
4289,4398,Sarvesh Kumar,HARDOI,INC,2,Graduate,2917101,0,2917101
4290,4085,Sarvesh Kumar Saini,AMROHA,SHS,2,10th Pass,12800000,800000,12000000
4291,4458,Sarwat Jahre Ansari,ARARIA,Samajwadi Janata Party (Rashtriya),0,Post Graduate,296000,0,296000
4292,1845,Saseendran,VADAKARA,BSP,0,5th Pass,3271000,250000,3021000
4293,7169,Sasi Kumar .S,RAMANATHAPURAM,IND,0,Not Given,279000,0,279000
4294,1810,Sasidharan K V,KANNUR,AAP,0,Post Graduate,2730285,360000,2370285
4295,12,Sasikala K S,MAVELIKKARA,SUCI(C),0,12th Pass,2700,0,2700
4296,705,Sasikkuttan Vakathanam,KOTTAYAM,CPI(ML) Red star,0,10th Pass,361750,0,361750
4297,4829,Sasti Chandra Sarkar,BALURGHAT,Rashtriya Janadhikar Suraksha Party,0,10th Pass,488095,203335,284760
4298,2985,Satandra Singh (Tony Tomar),MORENA,IND,0,Literate,238000,0,238000
4299,3527,Satav Atmaram Raghoji,HINGOLI,IND,0,8th Pass,500,500,0
4300,3528,Satav Raju Shankar,HINGOLI,IND,1,Literate,139000,0,139000
4301,431,Satbir,HISAR,IND,0,5th Pass,4959708,0,4959708
4302,5049,Satendra Veer Singh Chauhan,MAINPURI,AIFB,0,Post Graduate,2621288,40000,2581288
4303,1851,Satheesh Chandran,WAYANAD,AITC,0,Literate,112000,0,112000
4304,4292,Satheesh Kumar E,SALEM,AAP,0,Post Graduate,11428000,2416872,9011128
4305,3579,Sathi Bashir Ahmed Bashamiyan Shaikh,MADHA,IND,0,Literate,2054596,16968,2037628
4306,7170,Sathiah .G,RAMANATHAPURAM,IND,0,Graduate,940000,0,940000
4307,7139,Sathish Kumar .L,POLLACHI,SP,0,Post Graduate,497545,0,497545
4308,7010,"Sathiyanathan, N.",KANCHEEPURAM,IND,0,5th Pass,578000,0,578000
4309,7004,Sathiyaraj J.S,KANCHEEPURAM,BSP,0,Doctorate,1205000,400000,805000
4310,7008,Sathya C.E.,KANCHEEPURAM,MDMK,0,Graduate,20582544,60000,20522544
4311,7358,Sathyamurthy.C,TIRUVALLUR,BSP,0,Graduate Professional,2322609,0,2322609
4312,265,Sathyan Mokeri,WAYANAD,CPI,2,Graduate,3697322,502699,3194623
4313,1857,Sathyan Puthanveettil,WAYANAD,IND,0,8th Pass,226000,0,226000
4314,1859,Sathyan Thazhemangad,WAYANAD,IND,0,Literate,47000,0,47000
4315,1834,Satish Asangihal,BIJAPUR,IND,0,Graduate Professional,20500,0,20500
4316,3928,Satish Babu Naidu,BHOPAL,IND,0,10th Pass,142015,0,142015
4317,5853,"Satish Bhaskar Patil (Mudi Pra Dangri, Tal.Amalner)",JALGAON,IND,0,12th Pass,50000,0,50000
4318,5851,"Satish Bhaskar Patil (Nandgaon Bk, Tal.Erandol)",JALGAON,IND,0,Not Given,100000,0,100000
4319,5852,"Satish Bhaskar Patil (Varkhedi, Tal.Erandol)",JALGAON,IND,0,5th Pass,100000,0,100000
4320,3129,Satish Chandra Sharma,MORADABAD,Naitik Party,0,8th Pass,937285,711000,226285
4321,932,Satish Gokuldas Pendam,GADCHIROLI-CHIMUR,AITC,0,Graduate Professional,16000,0,16000
4322,676,Satish Kumar,GAUTAM BUDHHA NAGAR,BSP,1,12th Pass,599501967,201428322,398073645
4323,619,Satish Kumar,NAWADA,IND,0,10th Pass,11610000,0,11610000
4324,682,Satish Kumar,ALIGARH,BJP,1,10th Pass,52180006,754800,51425206
4325,1139,Satish Kumar Minz,SUNDARGARH,IND,0,Post Graduate,3008000,0,3008000
4326,2341,Satish Kumar Sharma,SIKAR,Jago Party,0,Post Graduate,903500,5000,898500
4327,1029,Satish Kumar Singal,KURUKSHETRA,IND,0,Post Graduate,8105000,0,8105000
4328,5899,Satish Parasmal Jain,MUMBAI NORTH,AAP,0,Graduate,201971234,65006000,136965234
4329,886,Satish Poonchi,JAMMU,IND,0,10th Pass,2513000,0,2513000
4330,452,Satpal,ROHTAK,IND,0,10th Pass,3998000,0,3998000
4331,2073,Satpal S/O Lokram,BHIWANI-MAHENDRAGARH,IND,0,12th Pass,1754500,1945000,-190500
4332,2074,Satpal S/O Sube,BHIWANI-MAHENDRAGARH,IND,0,12th Pass,2766000,1700000,1066000
4333,2718,Satya Nand Sharma,NALANDA,LJP,0,Literate,12818500,0,12818500
4334,2055,Satya Narayan,SONIPAT,IND,0,10th Pass,14173000,0,14173000
4335,5256,Satya Narayan Bhagat,KATIHAR,Proutist Sarva Samaj,0,Graduate,1062200,0,1062200
4336,811,Satya Narayan Mahar,KALAHANDI,AAP,1,Graduate,32332,0,32332
4337,4136,Satya Narayan Sharma (Sattu Bhaiya),RAIPUR,INC,1,12th Pass,44901667,2259662,42642005
4338,41,Satya Narayan Singh,KARAKAT,IND,0,Graduate,19450824,2396194,17054630
4339,3189,Satya Pal Singh,SAMBHAL,BJP,0,Post Graduate,19904379,0,19904379
4340,2426,Satya Prakash Sharma,BHILWARA,IND,0,12th Pass,536875,0,536875
4341,1786,Satyalal Sarkar,JALPAIGURI,BJP,0,Graduate,12290350,1267598,11022752
4342,4773,Satyanarayan Patel,INDORE,INC,0,12th Pass,699196061,8162155,691033906
4343,4390,Satyapal Singh,FIROZABAD,BJP,1,Doctorate,33097756,944483,32153273
4344,7200,Satyavijay Vithoba Chavan,MUMBAI NORTH,IND,0,8th Pass,2385347,0,2385347
4345,5393,Satyendra,JANJGIR-CHAMPA,Ambedkarite Party of India,0,Others,565700,70000,495700
4346,5837,Sau.Asha Sahebrao Patil,JALGAON,Maharashtra Parivartan Sena (T),0,12th Pass,115000,0,115000
4347,2836,Saurabh Narain Singh,HAZARIBAGH,INC,2,Post Graduate,415506982,0,415506982
4348,3131,Saurabh Pratap Singh,MORADABAD,AITC,0,Post Graduate,729238,0,729238
4349,3023,Savio Oliver Rodrigues,SOUTH GOA,Goa Su-Raj Party,0,Graduate Professional,1892000,0,1892000
4350,6994,Savithiri.K,DHARMAPURI,Ulzaipali Makkal Katchy,0,5th Pass,260000,0,260000
4351,1708,Savitri,GAUTAM BUDHHA NAGAR,IND,0,10th Pass,20577047,0,20577047
4352,2041,Savitri,KARNAL,IND,0,Illiterate,3700000,200000,3500000
4353,4183,Savitri Thakur,DHAR,BJP,0,10th Pass,9606464,1582845,8023619
4354,1521,Sawake Ramkrushna Pundlikrao,YAVATMAL-WASHIM,CPI(ML) Red star,0,10th Pass,612264,0,612264
4355,5913,Sawant Arvind Ganpat,MUMBAI SOUTH,SHS,1,Graduate,13067446,0,13067446
4356,3083,Sayad Rashid Ali,BAREILLY,IND,0,Post Graduate,6894000,0,6894000
4357,3684,Sayaji Shankar Kharat,SHIRDI,IND,0,Post Graduate,4602900,1222000,3380900
4358,3332,Sayed Abdul Rahim,PARBHANI,Welfare Party Of India,0,Graduate,259400,0,259400
4359,7228,Sayed Gulamhusain Amirhamza,MUMBAI NORTH EAST,Republican Party of India,0,Graduate,142000,1708849,-1566849
4360,4635,Sayeed Javed Ali,RAIPUR,IND,0,5th Pass,250500,0,250500
4361,1460,Sayyad Afjalali Alias Chhanubhai,BHANDARA-GONDIYA,Minorities democratic party,0,5th Pass,1093000,0,1093000
4362,5868,Sayyad Husain Ahmad,JALNA,IND,0,Literate,490000,0,490000
4363,5214,Sayyad Mo. Kayam,DHULE,IND,0,8th Pass,66000,0,66000
4364,3609,Sayyad Mohamd Sayyad Ibrahim,OSMANABAD,Bahujan Mukti Party,0,Post Graduate,402248,0,402248
4365,5199,Sayyad Salim Sayyad Alim,DHULE,IND,0,12th Pass,109000,0,109000
4366,7613,Sayyad Shafiyoddin Vahiyoddin,AURANGABAD,Welfare Party Of India,0,10th Pass,75000,0,75000
4367,3308,Sayyad Tanvir Sayyad Hamja,NANDED,Majlis Bachao Tahreek,0,8th Pass,50000,0,50000
4368,3888,Sayyed Minhaj Ali Sayyad Wajed Ali (Pendkhajurwale),BEED,IND,0,12th Pass,1125000,235000,890000
4369,3889,Sayyed Mubin Rahimtulla,BEED,IND,0,10th Pass,871000,2300000,-1429000
4370,3887,Sayyed Navidujjamma,BEED,IND,1,Graduate,2539615,0,2539615
4371,3890,Sayyed Salim Fattu,BEED,IND,1,Illiterate,60000,275000,-215000
4372,4990,Seema Upadhyay,FATEHPUR SIKRI,BSP,0,Graduate,98220327,11340556,86879771
4373,7116,"Seemanur Prabu, S.",PERAMBALUR,DMK,0,Others,18402538,0,18402538
4374,6884,Seetha Mallar. A,CHENNAI NORTH,IND,0,Others,1770000,0,1770000
4375,7029,Seetharamadhas,KANNIYAKUMARI,IND,0,Others,1238000,0,1238000
4376,610,Seetharaman.E,BANGALORE CENTRAL,IND,0,10th Pass,1283611,0,1283611
4377,2850,Sekh Akhiruddin,JAMSHEDPUR,Jharkhand Party (Naren),0,8th Pass,1535000,0,1535000
4378,965,Seleena Prakkanam,PATHANAMTHITTA,BSP,2,12th Pass,25500,0,25500
4379,4890,Selima Sultana,NOWGONG,IND,0,10th Pass,677952,18404,659548
4380,7598,Selvaganapathy.G,TIRUNELVELI,IND,0,Graduate,190000,0,190000
4381,5951,Selvakumar Perin Baraj Nadar,MUMBAI SOUTH CENTRAL,IND,0,5th Pass,2353210,0,2353210
4382,6350,Selvakumara Chinnayan S,ERODE,AIADMK,0,Post Graduate,47459708,0,47459708
4383,7005,Selvam G,KANCHEEPURAM,DMK,0,Post Graduate,7304895,563000,6741895
4384,5686,Selvam.G,NAMAKKAL,IND,0,Post Graduate,91614000,2000000,89614000
4385,7135,Selvaraj,POLLACHI,INC,0,Post Graduate,54282853,8800000,45482853
4386,7477,Selvaraj A,SIVAGANGA,IND,0,8th Pass,185400,0,185400
4387,7052,"Selvaraj, S.",KARUR,IND,0,Graduate Professional,260000,0,260000
4388,7114,"Selvaraj, V.M.",PERAMBALUR,BSP,0,Post Graduate,2152232,38000,2114232
4389,5672,Selvaraj.R,NAMAKKAL,BSP,0,8th Pass,201000,0,201000
4390,5680,Selvaraj.S,NAMAKKAL,IND,0,8th Pass,3271000,0,3271000
4391,1444,Senapati Uttam Sapan,NAGPUR,IND,1,5th Pass,398038,0,398038
4392,7393,"Senguttuvan, B.",VELLORE,AIADMK,0,Post Graduate,9197355,440478,8756877
4393,6318,Senguttuvan.R,CUDDALORE,IND,0,5th Pass,408500,0,408500
4394,4050,Senthamizhselvi,CHIDAMBARAM,IND,0,5th Pass,116422,44500,71922
4395,5701,Senthil Kumar M,SALEM,IND,0,Graduate,149900,0,149900
4396,6887,Senthil Kumar. K,CHENNAI NORTH,IND,0,Others,190500,0,190500
4397,7519,"Senthil Rajan Mallar, K.",THENI,IND,1,Post Graduate,682600,0,682600
4398,5428,Senthil S,TIRUVANNAMALAI,IND,0,Others,3714000,0,3714000
4399,6311,Senthilmurugan.S,CUDDALORE,BSP,0,Graduate Professional,517700,0,517700
4400,7095,Senthilpandian. Thalai. T.A.P,NAGAPATTINAM,INC,0,Graduate Professional,4240000,93000,4147000
4401,1738,Seshraj,SAHARANPUR,IND,0,Others,106068354,0,106068354
4402,6340,Sethupathy,ERODE,BSP,1,Graduate,14267730,100000,14167730
4403,3012,Sewak Ram Ahirwar,TIKAMGARH,BSP,1,12th Pass,1982450,29199,1953251
4404,909,Seyyed Mohammed Khasim.K,LAKSHADWEEP,SP,2,12th Pass,5236685,0,5236685
4405,1629,Shabnam,MUZAFFARNAGAR,IND,0,Literate,805000,0,805000
4406,4445,Shachindra Nath Brahma,MANGALDOI,IND,0,10th Pass,41000,0,41000
4407,1918,Shafeer Muhammed,CHALAKUDY,SDPI,3,10th Pass,1435046,170695,1264351
4408,3725,Shafi Ahmed,BANGALORE CENTRAL,IND,0,5th Pass,1025000,0,1025000
4409,5655,Shafik Ahamad Sadat Khan,THANE,IND,0,Others,8479287,0,8479287
4410,5188,Shah Abrar Ahmed Nazeer Ahmed,BHIWANDI,Peace Party,0,Graduate Professional,197500,0,197500
4411,4109,Shah Tariq Anwar,KATIHAR,NCP,1,Graduate,104600951,20454853,84146098
4412,1737,Shahanavaj,SAHARANPUR,Rashtriya Janmorcha,0,12th Pass,919230,0,919230
4413,1281,Shahid,SOUTH DELHI,IND,0,10th Pass,5305000,0,5305000
4414,1635,Shahid Manzoor,MEERUT,SP,0,Post Graduate,34814614,231000,34583614
4415,2530,Shahid Sharif,NAGPUR,JD(U),0,Graduate,1450325,0,1450325
4416,54,Shahjan Masood Urf Shahdan,SAHARANPUR,SP,2,Graduate,11192498,0,11192498
4417,57,Shahnawaj Rana,BIJNOR,SP,11,Graduate Professional,145562257,54311908,91250349
4418,5921,Shahzad Shamsher Khan Pathan,MUMBAI SOUTH,Awami Vikas Party,0,Graduate,30604689,1275000,29329689
4419,7612,Shaik Sayyad Shaik Mahmood,AURANGABAD,IND,0,5th Pass,451000,0,451000
4420,3307,Shaikh Afajaloddin Azimoddin,NANDED,Lok Bharati,0,Not Given,1650000,0,1650000
4421,4799,Shaikh Azizuddin Quraishi,MANDSOUR,AIFB,0,Post Graduate,5000,0,5000
4422,3883,Shaikh Chand Shiakh Miya,BEED,IND,0,Literate,50000,0,50000
4423,7199,Shaikh Fateh Mohammad,MUMBAI NORTH,IND,4,5th Pass,13300000,0,13300000
4424,3859,Shaikh Iptekhar Zakeebaba,BEED,Welfare Party Of India,0,12th Pass,35000,0,35000
4425,1499,Shaikh Jabbar Shaikh Usuf,YAVATMAL-WASHIM,IND,0,8th Pass,500,0,500
4426,5602,Shaikh Mo. Asgar Sakhawat,RAVER,Republican Party of India,1,12th Pass,50000,0,50000
4427,3610,Shaikh Mubarak Mainoddin,OSMANABAD,IND,0,5th Pass,80000,0,80000
4428,5204,Shaikh Mukhatar Ah. Mo. Qasim,DHULE,Welfare Party Of India,0,Graduate Professional,3718797,0,3718797
4429,3518,Shaikh Nayeem Shaikhlal,HINGOLI,SP,0,12th Pass,9355936,270817,9085119
4430,3371,Shaikh Nurjaha Yasin,MAVAL,IND,0,8th Pass,18451152,0,18451152
4431,3500,Shaikh Shabbir Nabi,HATKANANGLE,Maharashtra Parivartan Sena (T),0,Literate,150000,150000,0
4432,3884,Shaikh Shafiq Shabbir,BEED,IND,1,10th Pass,109000,0,109000
4433,3586,Shaikh Shahajan Paigambar,MADHA,IND,0,5th Pass,145000,0,145000
4434,5621,Shaikh Shakir,RAVER,IND,0,Graduate Professional,500,0,500
4435,5622,Shaikhh Shaherabi Jainoddin Shaikh,RAVER,IND,0,5th Pass,10120,1040,9080
4436,1314,Shailender Kumar,NORTH WEST DELHI,IND,0,Graduate,620000,10000,610000
4437,4682,Shailendra Kumar Banjare,DURG,Shakti Sena (Bharat Desh),0,Post Graduate,51260000,0,51260000
4438,2909,Shailendra Kumar Shaili,BHOPAL,CPI,0,Post Graduate,8582000,0,8582000
4439,2937,Shailendra Singh Kushwah,GUNA,AAP,0,Graduate,3626314,2075000,1551314
4440,846,Shailendrakumar Patil,DHARWAD,IND,1,Graduate,35000,0,35000
4441,2716,Shailesh Kumar,NALANDA,Ati Picchara party,0,Graduate Professional,4445777,0,4445777
4442,4470,Shailesh Kumar Urph Bulo Mandal,BHAGALPUR,RJD,1,12th Pass,20216734,0,20216734
4443,15,Shajar Khan,THIRUVANANTHAPURAM,SUCI(C),0,Post Graduate,26800,0,26800
4444,957,Shajumon Vattekad,ALATHUR,BJP,0,10th Pass,1772801,32653,1740148
4445,5276,Shakaldev Mandal,SUPAUL,Samajwadi Janata Party (Rashtriya),1,Graduate Professional,82854500,0,82854500
4446,1366,Shakeel Ahmed,EAST DELHI,Jai Maha Bharath Party,0,12th Pass,882000,0,882000
4447,2190,Shakil Dodawad,DHARWAD,IND,0,5th Pass,97000,0,97000
4448,2539,Shakil Wasi Ahamad,NAGPUR,IND,0,Not Given,0,0,0
4449,2991,Shakti Singh Tomar,MORENA,Rashtriya Ahinsa Manch,0,12th Pass,607700,0,607700
4450,4771,Shakti Sudha,INDORE,IND,0,Post Graduate,253032,0,253032
4451,7024,Shalin Richard J.,KANNIYAKUMARI,Indians Victory Party,0,Graduate,824292,0,824292
4452,3024,Shalom Mathew Francisco Sardinha,SOUTH GOA,IND,0,Graduate Professional,32828000,2340017,30487983
4453,2782,Sham Lal,UDHAMPUR,All J & K Kisan Majdoor Party,0,8th Pass,817000,0,817000
4454,2133,Shamala,BIDAR,IND,0,Not Given,9178000,1000000,8178000
4455,1400,Shambaba Alias Shamsundar Panjabrao Nichit,WARDHA,IND,0,Post Graduate,4155000,700000,3455000
4456,1402,Shambharkar Rajendra Gulabrao,WARDHA,IND,3,Doctorate,174963,0,174963
4457,2639,Shambhu Prasad Sharma,ARRAH,Hindustan Vikas Dal,0,Graduate Professional,300000,0,300000
4458,4666,Shambhu Sharma,KORBA,IND,0,Graduate Professional,3898542,0,3898542
4459,855,Shambulingegowda,BANGALORE SOUTH,IND,0,8th Pass,1222243,0,1222243
4460,3152,Shamsher,NAGINA,IND,0,8th Pass,101000,0,101000
4461,4396,Shamsher Kha,FIROZABAD,Peace Party,0,10th Pass,1973200,300000,1673200
4462,209,Shamsher Singh Kharkara,ROHTAK,INLD,0,Post Graduate,242943888,0,242943888
4463,7083,Shamsudeen. M,MAYILADUTHURAI,IND,0,8th Pass,352590,0,352590
4464,5894,Shamu Ramu Bhosale,KALYAN,Bharipa Bahujan Mahasangh,0,10th Pass,3278000,111684,3166316
4465,758,Shanbhulal,MANDLA,BSP,0,10th Pass,1275000,0,1275000
4466,20,Shandar Gufran,MUZAFFARNAGAR,IND,0,Post Graduate,7268197,661855,6606342
4467,6947,Shankar,CHENNAI SOUTH,IND,0,Not Given,450000,0,450000
4468,2645,Shankar Dayal Paswan,ARRAH,IND,4,Others,1525000,2500,1522500
4469,5910,Shankar Gangadhar Sonawane,MUMBAI SOUTH,IND,0,10th Pass,4237600,16663,4220937
4470,175,Shankar Jadhav,GULBARGA,Bharatiya Peoples Party,0,Graduate,3400000,0,3400000
4471,1587,Shankar Kansre,BALAGHAT,IND,0,Graduate Professional,5925841,1500000,4425841
4472,1150,Shankar Kumar Patra,BOLANGIR,Aama Odisha Party,0,Post Graduate,10380000,0,10380000
4473,3437,Shankar Lal Darji,JALORE,IND,0,5th Pass,543500,0,543500
4474,4634,Shankar Lal Varandaani,RAIPUR,IND,0,10th Pass,492000,0,492000
4475,2704,Shankar Prasad,MUNGER,Bahujan Mukti Party,2,Graduate,40253000,0,40253000
4476,595,Shankar Ram Thakur,BASTAR,SP,0,Graduate,12430000,8000,12422000
4477,1184,Shankar Rathod,BELGAUM,IND,0,10th Pass,4650000,0,4650000
4478,2522,Shankarappa,BANGALORE RURAL,Jai Vijaya Bharathi Party,0,10th Pass,45000,0,45000
4479,1146,Shankarlal Agrawala,SAMBALPUR,"Proutist Bloc, India",0,12th Pass,16466020,0,16466020
4480,2137,Shanker Bhayya,BIDAR,BSP,0,Others,7520141,0,7520141
4481,5692,Shanmugam G,SALEM,Makkal Manadu Katchi,0,8th Pass,25000,0,25000
4482,7392,"Shanmugam, A.C.",VELLORE,BJP,0,Graduate Professional,1061039972,344686084,716353888
4483,7559,"Shanmugam, A.P.C.V.",THOOTHUKKUDI,INC,0,Graduate,29971850,2532797,27439053
4484,7382,"Shanmugam, G. Thiru",SRIPERUMBUDUR,IND,0,Not Given,1153,0,1153
4485,7381,"Shanmugam, K. Thiru",SRIPERUMBUDUR,IND,0,Graduate,419000,0,419000
4486,2434,Shanti Lal Trivedi,CHITTORGARH,CPI(ML)L,0,10th Pass,2289690,96000,2193690
4487,3692,Sharad Bansode,SOLAPUR,BJP,1,Graduate Professional,60152887,7604375,52548512
4488,263,Sharafudheen,VADAKARA,IND,0,12th Pass,1119368,0,1119368
4489,567,Sharanabasappa Malakajappa,GULBARGA,SUCI(C),0,Graduate,12500,0,12500
4490,7401,"Shareef Basha, H.",VELLORE,Samata Party,0,Illiterate,1073337,0,1073337
4491,3151,Sharishtha Kumar Singh,NAGINA,Jai Maha Bharath Party,0,Graduate,5632000,0,5632000
4492,5922,Sharma Gaurav Shrinivas,MUMBAI SOUTH,IND,0,8th Pass,318305,0,318305
4493,3864,Sharmila Baba Wakshe,SANGLI,IND,0,Graduate,723500,0,723500
4494,2698,Sharwan Kumar Anand,MUNGER,IND,0,Post Graduate,5750,0,5750
4495,2040,Shashi Saini,KARNAL,IND,0,Post Graduate,73585000,0,73585000
4496,2734,Shashi Yadav,NALANDA,CPI(ML)L,1,Graduate,14000,0,14000
4497,3637,Shashikant Bhikaji Owhal,PUNE,IND,0,Graduate,1318000,0,1318000
4498,3716,Shatrudhan Shah,PATALIPUTRA,Bharatiya Ekta Dal,0,10th Pass,2030000,50000,1980000
4499,5044,Shatrughan Singh,MAINPURI,BJP,0,Graduate,12850273,0,12850273
4500,88,Shatrughan Sinha,PATNA SAHIB,BJP,1,Graduate,1317405961,168760929,1148645032
4501,2357,Shayam Singh Rathore,JAIPUR RURAL,Lok Shakti,0,Others,20778000,3400,20774600
4502,674,Shazia Ilmi Malik,GHAZIABAD,AAP,1,Post Graduate,303342609,41846167,261496442
4503,962,Sheeba K A,ALATHUR,INC,0,Post Graduate,2903410,1310606,1592804
4504,2905,Sheeba Malik,BHOPAL,SP,3,12th Pass,5775435,0,5775435
4505,3021,Sheel Chandra Ahirwar,TIKAMGARH,IND,0,10th Pass,373600,34000,339600
4506,5388,Sheema Rahangdale,DURG,Ambedkarite Party of India,0,Graduate,22714000,0,22714000
4507,3149,Sheesh Ram Singh Ravi,NAGINA,Peace Party,0,Graduate,21393387,3830925,17562462
4508,5093,Sheetal,BHARATPUR,IND,0,Post Graduate,566241,0,566241
4509,5924,Shehbaj Allahuddin Rathod,MUMBAI SOUTH,Jai Maha Bharath Party,0,5th Pass,11873000,0,11873000
4510,4787,Sheikh Sharif,KHANDWA,Akhil Bhartiya Vikas Congress Party,1,Literate,414351,0,414351
4511,3286,Shekh Faruk,KENDRAPARA,BSP,1,10th Pass,1346000,0,1346000
4512,1110,Shekh Hamid Imam,AKOLA,Bahujan Mukti Party,0,Graduate,3736459,483872,3252587
4513,4667,Shekh Rauf,KORBA,IND,0,12th Pass,482686,0,482686
4514,3683,Shende Ravindra Vitthal,SHIRDI,IND,0,8th Pass,6316274,2363899,3952375
4515,2660,Sheo Gopal Chaudhry,BUXAR,IND,0,Graduate,1010000,0,1010000
4516,3476,Sher Singh,PALI,IND,0,8th Pass,6271914,752000,5519914
4517,2072,Sher Singh,BHIWANI-MAHENDRAGARH,IND,0,10th Pass,1200000,500000,700000
4518,3544,Sheregar Chetan Venkatesh,KOLHAPUR,IND,0,12th Pass,825000,173475,651525
4519,6275,"Shettu, S.",ARAKKONAM,IND,0,Post Graduate,100000,0,100000
4520,5950,Shewale Rahul Ramesh,MUMBAI SOUTH CENTRAL,SHS,1,Others,13304397,10502345,2802052
4521,4160,Shibu Soren,DUMKA,JMM,0,10th Pass,46760684,1479721,45280963
4522,651,Shibun Lyngdoh,SHILLONG,BJP,0,Graduate,75894099,7061466,68832633
4523,2173,Shiddappa Kallappa Pujar,HAVERI,IND,0,10th Pass,50500,0,50500
4524,1968,Shilvin Kottackakathu,PATHANAMTHITTA,IND,0,Others,33956316,1491421,32464895
4525,2284,Shimla Devi Nayak,GANGANAGAR,National Unionist Zamindara Party,0,Post Graduate,3466420,784068,2682352
4526,5903,Shinde Anand Vyankatrao,MUMBAI NORTH CENTRAL,BSP,0,10th Pass,35000,0,35000
4527,3306,Shinde Balaji Vishwanathrao,NANDED,SP,0,Graduate Professional,18406800,3237539,15169261
4528,3612,Shinde Rajendra Bhairavnath,OSMANABAD,Maharashtra Parivartan Sena (T),0,Graduate,500000,0,500000
4529,3704,Shinde Rajkumar Laxmanrao,SOLAPUR,IND,0,12th Pass,879456,0,879456
4530,5930,Shinde Sarjerao Mahadev,MUMBAI SOUTH CENTRAL,IND,0,Post Graduate,535181794,0,535181794
4531,3563,Shinde Sudhir Shripatrao,LATUR,IND,0,Graduate Professional,330626,300000,30626
4532,3693,Shinde Sushilkumar Sambhajirao,SOLAPUR,INC,0,Graduate Professional,234700792,150000,234550792
4533,4412,Shishupal Singh,MAINPURI,Bhartiya Shakti Chetna Party,0,Post Graduate,4335000,0,4335000
4534,7204,Shital Kumar Jain,MUMBAI NORTH CENTRAL,IND,0,10th Pass,19300000,0,19300000
4535,3007,Shitin Kesherwani,SAGAR,IND,0,12th Pass,331000,0,331000
4536,6823,Shitkaran Mahilvar,DURG,IND,0,5th Pass,1557000,300000,1257000
4537,4399,Shiv Kumar,HARDOI,IND,0,Graduate,148039,0,148039
4538,2027,Shiv Kumar,HISAR,IND,0,10th Pass,305500,0,305500
4539,1745,Shiv Kumar,SAHARANPUR,Ambedkar Samaj Party,0,8th Pass,220619,0,220619
4540,388,Shiv Kumar Kant,GAYA,BSP,0,Graduate,5232500,200000,5032500
4541,384,Shiv Shankar Kumar,GAYA,Bharat Bhrashtachar Mitao Party,0,Graduate,1067800,0,1067800
4542,2960,Shiv Singh Kushawah,GWALIOR,Mahanwadi Party,0,8th Pass,5469000,0,5469000
4543,5872,Shiva Krishnamurthy Iyar,KALYAN,IND,0,Post Graduate,17557000,0,17557000
4544,2831,Shiva Mahto,GIRIDIH,IND,0,8th Pass,2050000,0,2050000
4545,563,Shivagoudappa Balappa Khanagoudar,BELGAUM,IND,0,Graduate Professional,1828000,0,1828000
4546,3638,Shivaji Pandurang Adhav,PUNE,IND,0,Graduate Professional,2459700,715000,1744700
4547,3293,Shivakumar,TUMKUR,IND,0,10th Pass,1850000,0,1850000
4548,180,Shivakumar Chakari Urf Talawar,HAVERI,IND,0,Post Graduate,1180000,0,1180000
4549,3799,Shivakumar Navalisiddappa Tontapur,KOPPAL,AAP,0,Graduate,2725000,460000,2265000
4550,1215,Shivalingaiah,MANDYA,BJP,0,Doctorate,130363533,16531000,113832533
4551,3758,Shivamallu,CHAMARAJANAGAR,BSP,0,Post Graduate,1471630,266375,1205255
4552,1199,Shivashankar. G. R.,BANGALORE SOUTH,AIFB,0,Post Graduate,32522829,7800000,24722829
4553,4403,Shive Prasad Verma,HARDOI,BSP,6,8th Pass,26102946,5572545,20530401
4554,4478,Shivendra Kumar,KATIHAR,BSP,0,Post Graduate,495400,118033,377367
4555,3552,Shivkhandeshwar Narayan Dahge,LATUR,Bharatiya Jawala Shakti Paksha,0,10th Pass,1032000,30000,1002000
4556,5423,Shivkumar Singh Shyam,SURGUJA,Rashtriya Gondvana Party,0,Post Graduate,235245,0,235245
4557,1248,Shivnath Sav,KODARMA,IND,0,8th Pass,911000,121000,790000
4558,5100,Shivpal Singh Gujjar,DAUSA,IND,2,12th Pass,252107430,11833122,240274308
4559,182,Shobha Karandlaje,UDUPI CHIKMAGALUR,BJP,0,Post Graduate,72089452,38119792,33969660
4560,3470,Shobharam Mali,PALI,Jai Maha Bharath Party,0,10th Pass,2690500,0,2690500
4561,1941,Shoby Joseph,IDUKKI,IND,1,Others,10500,151600,-141100
4562,4824,Shoiab Khan,VIDISHA,Prajatantrik Samadhan Party,0,12th Pass,50000,0,50000
4563,2151,Shravan,BIDAR,Rashtriya Samaj Paksha,0,12th Pass,503900,50000,453900
4564,2028,Shravan Kumar Asija,HISAR,IND,0,12th Pass,2380000,0,2380000
4565,2774,Shree Kant Labh,PATNA SAHIB,Samajwadi Janata Party (Rashtriya),2,Post Graduate,57881,0,57881
4566,1077,Shreekant Kabadi,DHARWAD,IND,0,Graduate,9950010,427000,9523010
4567,4240,Shrelal Khare,KARAULI-DHOLPUR,Jai Maha Bharath Party,0,Literate,580000,0,580000
4568,501,Shri Chand Tanwar,SOUTH DELHI,CPI,0,8th Pass,7002415,0,7002415
4569,79,Shri Chandra Mohan Patowari,BARPETA,BJP,0,Post Graduate,12110465,1977898,10132567
4570,3590,Shri Chavan Ashokrao Shankarrao,NANDED,INC,0,Post Graduate,388758910,30513286,358245624
4571,2975,Shri Dhar Khare,KHAJURAHO,IND,0,8th Pass,5271817,0,5271817
4572,4436,Shri Manash Borah,GAUHATI,INC,0,Graduate Professional,44721819,19121889,25599930
4573,2505,Shri Parikshit Debbarma,TRIPURA EAST,BJP,0,10th Pass,1382000,30900,1351100
4574,1532,Shri Ram,SATNA,IND,0,Post Graduate,5309000,0,5309000
4575,765,Shri Subhash Shukla,CHHINDWARA,SP,0,12th Pass,380000,0,380000
4576,3485,Shridhar Jakhuji Darekar,AHMEDNAGAR,IND,0,Graduate Professional,15269913,864552,14405361
4577,1833,Shridhar Narayankar,BIJAPUR,AAP,0,Others,9261841,2133500,7128341
4578,2540,Shridhar Salve,NAGPUR,IND,0,12th Pass,300000,0,300000
4579,6824,Shrikant Shah,DURG,JD(U),1,10th Pass,994309,0,994309
4580,3885,Shrikant Vishnu Gadale,BEED,IND,0,10th Pass,45071,0,45071
4581,3240,Shrikanta Kumar Jena,BALASORE,INC,0,Graduate,11729649,5454370,6275279
4582,4724,Shrilal Kisku,DUMKA,IND,0,Graduate Professional,3050000,82000,2968000
4583,2219,Shrilatha Shetty,SHIMOGA,IND,0,10th Pass,1268000,337000,931000
4584,1813,Shrimant Balasaheb Patil,CHIKKODI,JD(S),5,Graduate,223524192,136392288,87131904
4585,5659,Shrinath Mithanthaya,THANE,Hindustan Janta Party,0,Post Graduate,50603500,11822000,38781500
4586,562,Shrinik Annasaheb Jangate,CHIKKODI,IND,0,12th Pass,500500,0,500500
4587,1979,Shripad Yesso Naik,NORTH GOA,BJP,0,Graduate,37019154,837843,36181311
4588,3865,Shrirang Baburao Pakhare,SANGLI,IND,0,5th Pass,550000,0,550000
4589,867,Shruti Choudhry,BHIWANI-MAHENDRAGARH,INC,0,Graduate Professional,1083115000,106873000,976242000
4590,6320,Shruti Mishra,CUDDALORE,Union Party of India,0,Graduate Professional,5205760,0,5205760
4591,2101,Shushila,FARIDABAD,IND,0,10th Pass,40072745,0,40072745
4592,2269,Shuvadip Datta,SILCHAR,IND,0,12th Pass,6123000,365707,5757293
4593,2651,Shweta Pathak,BUXAR,AAP,0,Graduate,6953992,0,6953992
4594,1262,Shyam Lal Ram,PALAMAU,IND,0,Graduate,31205,0,31205
4595,2422,Shyam Lal Salvi,BHILWARA,IND,0,Post Graduate,999000,55000,944000
4596,2652,Shyam Lal Singh Kushwaha,BUXAR,JD(U),0,10th Pass,81811000,1932000,79879000
4597,2773,Shyam Nandan Prasad,PATNA SAHIB,IND,1,Doctorate,36572000,943000,35629000
4598,3713,Shyam Sundar Hansdah,MAYURBHANJ,INC,0,Graduate,32158487,9116999,23041488
4599,2401,Shyam Sunder Sharma,KOTA,IND,0,Graduate,1078797,0,1078797
4600,2599,Shyamkumar Bapurao Lokhande,YAVATMAL-WASHIM,IND,0,Graduate,3564000,0,3564000
4601,1527,Shyamlal Kushwaha,SATNA,GGP,0,Post Graduate,2689000,0,2689000
4602,1882,Shylock P.V.,PONNANI,AAP,1,Graduate,3748638,3000000,748638
4603,1158,Siba Hati,KALAHANDI,SP,0,8th Pass,1474000,100000,1374000
4604,1173,Sibasankar Ulaka,KORAPUT,BJP,1,Others,16500000,1750000,14750000
4605,4353,Sibendra Nath Sarkar,BALURGHAT,IND,1,8th Pass,419006,0,419006
4606,359,Siddappa Ganji,BIJAPUR,IND,0,12th Pass,128000,0,128000
4607,2152,Siddaramappa,BIDAR,IND,0,10th Pass,102000,0,102000
4608,3775,Siddesh,DAVANAGERE,IND,0,12th Pass,19035000,400000,18635000
4609,3866,Siddha Shivappa Bhosale,SANGLI,IND,0,5th Pass,126813,0,126813
4610,2967,Siddharth Kushwaha,KHAJURAHO,SP,1,Graduate,16254183,3200000,13054183
4611,1481,Siddharth Raut,CHANDRAPUR,Prabuddha Republican Party,0,Post Graduate,3927422,1000000,2927422
4612,3613,Siddik Ibrahim Boudiwali,OSMANABAD,IND,0,10th Pass,690000,50000,640000
4613,118,Sidhant Mohapatra,BERHAMPUR,BJD,0,Post Graduate,16462430,1183828,15278602
4614,3705,Sidram Krishna Dhobale,SOLAPUR,IND,0,5th Pass,66447,0,66447
4615,5247,Sikandar Tanti,BHAGALPUR,IND,0,8th Pass,805834,0,805834
4616,714,Silvi Sunil,IDUKKI,AAP,0,Others,3080470,45000,3035470
4617,1239,Sima Chandravansi,CHATRA,AAP,0,Graduate Professional,1535000,120000,1415000
4618,3361,Sima Dharmanna Manikadi,MAVAL,Prabuddha Republican Party,0,5th Pass,0,0,0
4619,5897,Singh Ashok Chandrapal,MUMBAI NORTH,BSP,0,Graduate,20480514,97109,20383405
4620,4857,Siraj Uddin Ajmal,BARPETA,AIUDF,0,Graduate,670806607,0,670806607
4621,1112,Sirsat Haridas Ankush,AMRAVATI,IND,0,5th Pass,686000,70000,616000
4622,2029,Sita Ram,HISAR,IND,0,Graduate,1200500,400000,800500
4623,1599,Sita Ram Sareyam,CHHINDWARA,IND,0,10th Pass,180000,0,180000
4624,2857,Sita Ram Tudu,JAMSHEDPUR,SUCI(C),0,12th Pass,373970,0,373970
4625,2056,Sitender Singh,SONIPAT,IND,0,Post Graduate,50000,0,50000
4626,7155,Sivagurunathan .K,RAMANATHAPURAM,BSP,0,Post Graduate,695000,0,695000
4627,5679,Sivaji.S.M,NAMAKKAL,IND,0,5th Pass,0,0,0
4628,6871,Sivakumar . V,CHENNAI NORTH,SUCI(C),0,Others,266000,0,266000
4629,7464,Sivakumar.V,THANJAVUR,IND,0,10th Pass,6607342,2000000,4607342
4630,7583,Sivananenthaperumal.S.,TIRUNELVELI,DMDK,0,10th Pass,13577518,4272637,9304881
4631,7121,"Sivaperumal, K.",PERAMBALUR,IND,0,12th Pass,391003,0,391003
4632,7409,"Sivaprakasam, R.S.",VELLORE,IND,1,12th Pass,250500000,127200000,123300000
4633,6883,Sivashanmuga Perumal. S,CHENNAI NORTH,IND,0,Post Graduate,1866500,0,1866500
4634,5123,Siya Ram,TONK-SAWAI MADHOPUR,IND,0,8th Pass,151000,0,151000
4635,4282,Siya Ram Paswan,ETAWAH,Al-Hind Party,0,12th Pass,514030,40000,474030
4636,2982,Siyaram Singh Choudri,MORENA,IND,0,10th Pass,162500,0,162500
4637,4833,Sk Nurul Islam,JANGIPUR,AITC,0,12th Pass,7489730,480000,7009730
4638,3334,Sk. Saleem,PARBHANI,Majlis Bachao Tahreek,0,5th Pass,60000,0,60000
4639,2779,Smt. Amrit Barsha,UDHAMPUR,SP,0,12th Pass,1500000,0,1500000
4640,4633,Smt. Basmati Kshatriyaa,RAIPUR,IND,0,8th Pass,337000,0,337000
4641,82,Smt. Bijoya Chakraborty,GAUHATI,BJP,0,Post Graduate,12574493,0,12574493
4642,3614,Smt. Jadhav Ujvala Eknath,OSMANABAD,IND,0,Graduate,1508000,600000,908000
4643,104,Smt. Kamla Patle,JANJGIR-CHAMPA,BJP,0,12th Pass,18224350,0,18224350
4644,72,Smt. Kirron Kher,CHANDIGARH,BJP,0,Post Graduate,335343871,1886187,333457684
4645,68,Smt. Meenakshi Lekhi,NEW DELHI,BJP,0,Graduate Professional,349916470,3275562,346640908
4646,4632,Smt. Meera Sharma,RAIPUR,IND,0,Post Graduate,210000,0,210000
4647,4100,Smt. Mridula Barkakoty,NOWGONG,AGP,0,Post Graduate,8081937,752111,7329826
4648,776,Smt. Prabhatai Madhukar Parlewar,BULDHANA,Narayani Sena,0,Post Graduate,11619000,0,11619000
4649,344,Smt. Priya K S,ATTINGAL,Welfare Party Of India,0,Post Graduate,4530512,0,4530512
4650,1702,Smt. Seema,GAUTAM BUDHHA NAGAR,Rashtriya Naujawan Dal,0,12th Pass,12201000,0,12201000
4651,956,Smt. Shobha Surendran,PALAKKAD,BJP,4,12th Pass,2027210,0,2027210
4652,230,Smt. Sumeeti,GAUTAM BUDHHA NAGAR,IND,0,8th Pass,1201712,675000,526712
4653,2890,Snehlata Jojo,SINGHBHUM,IND,0,Graduate Professional,2444000,0,2444000
4654,4759,Sobhal Singh,DEWAS,Samata Samadhan Party,0,5th Pass,445000,0,445000
4655,4758,Sodan Singh Dalmiya,DEWAS,Bahujan Mukti Party,0,Post Graduate,22000,0,22000
4656,153,Sohail Anwer,NAWADA,BSP,0,Literate,415000,85000,330000
4657,3450,Sohan Lal Goyal,JODHPUR,IND,0,Graduate,13682000,277000,13405000
4658,4751,Sohan Lal Uikey,BETUL,BSP,0,Post Graduate,271560,75000,196560
4659,5660,Sohanlal Purohit,THANE,IND,0,Others,1131348,300,1131048
4660,2830,Sohrab Shah,GIRIDIH,Bahujan Mukti Party,0,Literate,50000,0,50000
4661,4163,Sokol Hansda,DUMKA,BSP,0,10th Pass,1834000,0,1834000
4662,3892,Solanke Parmeshwar Kalyanrao,BEED,IND,0,Not Given,1683000,70000,1613000
4663,3893,Solanke Prkash Bhagwanrao,BEED,IND,0,5th Pass,1593500,0,1593500
4664,1324,Solomon George,NEW DELHI,BSP,0,Post Graduate,1501750,0,1501750
4665,4827,Som Hemram,BALURGHAT,Jharkhand Disom Party,0,Graduate,50500,0,50500
4666,2444,Soma Lal Koted,BANSWARA,Bahujan Mukti Party,0,12th Pass,12080300,0,12080300
4667,1913,Soman Pillai,THRISSUR,Indian Gandhiyan Party,0,Not Given,0,0,0
4668,382,Somaru Paswan,AURANGABAD,IND,0,Literate,3269500,0,3269500
4669,1938,Somini Prabhakaran,IDUKKI,IND,0,10th Pass,67800,10000,57800
4670,354,Somkuvar Vijay Sitaram,NAGPUR,IND,0,Not Given,104000,0,104000
4671,3691,Sonali Chandrashekhar Thorat,SHIRUR,IND,0,8th Pass,630000,0,630000
4672,3707,Sonawane Shivaji Chandrakant,SOLAPUR,IND,1,10th Pass,1289714,0,1289714
4673,5627,Sonawane Vandana Shivaji,RAVER,IND,0,Graduate,20000,0,20000
4674,888,Soni Soree,BASTAR,AAP,2,12th Pass,195000,250000,-55000
4675,1705,Sonia Sharma,GAUTAM BUDHHA NAGAR,Akhil Bharatiya Samajwadi Congress,0,Graduate,3327000,160000,3167000
4676,7247,Sonkamble Gajanan Tukaram,MUMBAI NORTH WEST,IND,0,12th Pass,128100,0,128100
4677,3697,Sonkamble Gautam Vijaykumar,SOLAPUR,Bharipa Bahujan Mahasangh,0,Graduate Professional,1729000,200000,1529000
4678,5871,Sonkamble Sulochana Dharmendra,KALYAN,Republican Bahujan Sena,1,Literate,1289000,0,1289000
4679,3324,Sontakke Laxman Kishan,NANDED,IND,0,12th Pass,10000,0,10000
4680,535,Soso Lorho,OUTER MANIPUR,NPF,0,Graduate,13445800,0,13445800
4681,4369,Soumitra Ray,MALDAHA UTTAR,AITC,0,Graduate,5516468,0,5516468
4682,7071,Soundarajan.M,KRISHNAGIRI,IND,0,10th Pass,1608000,0,1608000
4683,6866,Soundarapandian .M,CHENNAI NORTH,DMDK,0,12th Pass,111177861,21244538,89933323
4684,7544,Soundhirapandian,VIRUDHUNAGAR,IND,0,5th Pass,705000,0,705000
4685,1878,Sreedharan,MALAPPURAM,IND,0,5th Pass,409000,0,409000
4686,1893,Sreejith,PALAKKAD,IND,0,Post Graduate,304185,158610,145575
4687,1809,Sreemathi Puthalath,KANNUR,IND,0,10th Pass,4840148,0,4840148
4688,309,Sreeni Jacob,KOTTAYAM,BSP,0,12th Pass,4000,0,4000
4689,1293,Sreerupa Mitra Chaudhury,SOUTH DELHI,AITC,0,Post Graduate,11823944,3788624,8035320
4690,3287,Sri Baijayant Panda,KENDRAPARA,BJD,0,Graduate Professional,312432726,300000,312132726
4691,2593,Sri Basavanagideva Sharanaru,CHITRADURGA,IND,0,Post Graduate,489561,0,489561
4692,2644,Sri Bhagwan Singh Kushwaha,ARRAH,RJD,1,10th Pass,7973528,2039416,5934112
4693,4440,Sri Biju Phukan,GAUHATI,AITC,0,Graduate,685000,0,685000
4694,2502,Sri Bikash Debbarma,TRIPURA EAST,Jai Maha Bharath Party,0,10th Pass,350000,1900000,-1550000
4695,4432,Sri Dhiraj Medhi,GAUHATI,IND,0,10th Pass,23640000,120000,23520000
4696,2504,Sri Karna Bijoy Jamatia,TRIPURA EAST,AAP,0,10th Pass,8410000,0,8410000
4697,4433,Sri Padmeshwar Phukan,GAUHATI,IND,0,10th Pass,7324771,0,7324771
4698,2506,Sri. Hariharan K S,ATTINGAL,IND,0,Graduate Professional,2401400,0,2401400
4699,1972,Sri. Vakkom G Ajith,ATTINGAL,SHS,0,12th Pass,1120000,0,1120000
4700,342,Sri.Manoj Kumar,ATTINGAL,SDPI,2,Others,284000,199789,84211
4701,1971,Sri.Sambath Anilkumar,ATTINGAL,IND,0,8th Pass,3262,17000,-13738
4702,7447,Sridevi.S,TIRUCHIRAPPALLI,IND,0,12th Pass,735000,0,735000
4703,7379,"Sridhar, C. Thiru",SRIPERUMBUDUR,Ulzaipali Makkal Katchy,0,Post Graduate,1665000,248000,1417000
4704,6282,"Sridhar, R.S",ARAKKONAM,IND,0,Graduate,2006000,100000,1906000
4705,7391,"Sridhar,M.Thiru",SRIPERUMBUDUR,IND,0,10th Pass,90000,0,90000
4706,6986,"Sridharan, S.",COIMBATORE,IND,0,10th Pass,140000,0,140000
4707,833,Srihari Patanaik,BERHAMPUR,IND,0,12th Pass,976119,723600,252519
4708,1062,Srikant Arakeri,BIJAPUR,Karunaadu Party,0,Graduate,875500,390000,485500
4709,825,Srilokanath Ratha,ASKA,INC,0,Post Graduate,39978228,0,39978228
4710,2236,Srinivasa,UDUPI CHIKMAGALUR,IND,0,5th Pass,2452000,2060000,392000
4711,7011,Srinivasan C.,KANCHEEPURAM,IND,0,Post Graduate,2957000,0,2957000
4712,7362,Srinivasan. D,TIRUVALLUR,SP,0,Graduate Professional,425000,0,425000
4713,6885,Srinivasan. J,CHENNAI NORTH,IND,0,Graduate Professional,585030,375000,210030
4714,6877,Srinivason .S,CHENNAI NORTH,AAP,0,Graduate,30560936,1350000,29210936
4715,669,Ssomendar Dhaka,BAGHPAT,AAP,0,Graduate Professional,6488116,250000,6238116
4716,4717,Stephen Besra,DUMKA,Jharkhand Disom Party,0,10th Pass,1457179,250000,1207179
4717,163,Subal Bhowmik,TRIPURA WEST,IND,1,Graduate Professional,4620411,0,4620411
4718,3390,Subarnamala Deb Barma,TRIPURA EAST,Amra Bangalee,0,8th Pass,7485,0,7485
4719,3254,Subas Chandra Mallick,JAJPUR,SUCI(C),0,Graduate,6000,0,6000
4720,3031,Subash Biswas,JALPAIGURI,IND,0,5th Pass,2117232,0,2117232
4721,576,Subash Chander,JAMMU,All J & K Kisan Majdoor Party,0,8th Pass,606100,0,606100
4722,788,Subash Chouhan,BARGARH,BJP,0,Graduate,455867,0,455867
4723,6979,"Subash, K.R.",COIMBATORE,IND,0,10th Pass,5818000,1950000,3868000
4724,7171,Subbiah .M,RAMANATHAPURAM,IND,0,10th Pass,837800,0,837800
4725,512,Subhas Sen,DIBRUGARH,CPI(ML)L,0,12th Pass,7032268,0,7032268
4726,2131,Subhash Bhimsha Sindankera,BIDAR,IND,0,5th Pass,306000,0,306000
4727,1656,Subhash Chand Kashyap,BAGHPAT,IND,0,Post Graduate,2539312,200000,2339312
4728,2415,Subhash Chandra Baheria,BHILWARA,BJP,0,Graduate,142870042,8665902,134204140
4729,1776,Subhash Chikbaraik,ALIPURDUARS,SUCI(C),0,10th Pass,1344,0,1344
4730,3372,Subhash Gopalrao Bodhe,MAVAL,IND,0,8th Pass,5030000,500000,4530000
4731,5178,Subhash Kalyanrao Lomte,AURANGABAD,AAP,0,Post Graduate,11681447,258000,11423447
4732,4848,Subhash Krishna Goswami,MALDAHA UTTAR,BJP,0,12th Pass,2236912,0,2236912
4733,4425,Subhash Maharia,SIKAR,IND,0,Graduate,74415150,3285722,71129428
4734,3673,Subhash Nivrutti Shilewant,SATARA,IND,0,12th Pass,34500,15000,19500
4735,627,Subhash Paswan,JAMUI,IND,0,Not Given,163000,0,163000
4736,4200,Subhash Patel,KHARGONE,BJP,0,Post Graduate,36138699,2300000,33838699
4737,7201,Subodh G. Ranjan,MUMBAI NORTH,IND,0,12th Pass,2621363,0,2621363
4738,2877,Subodh Kant Sahai,RANCHI,INC,1,Graduate Professional,258895068,3355000,255540068
4739,5038,Subodh Kumar,KANNAUJ,Peace Party,1,12th Pass,1686914,0,1686914
4740,4683,Subodh Kumar Gupta,DURG,RPI(A),0,12th Pass,11733950,600,11733350
4741,4465,Subodh Narayan Jha,BANKA,AITC,0,Graduate,7726666,2250000,5476666
4742,4735,Subodh Prasad,GODDA,AJSUP,0,Post Graduate,9435161,183000,9252161
4743,2866,Subodh Purty,KHUNTI,BSP,0,8th Pass,1060018,125000,935018
4744,7123,"Subramani, D.",PERAMBALUR,IND,0,12th Pass,2880137,0,2880137
4745,5681,Subramani.S,NAMAKKAL,IND,0,10th Pass,475000,0,475000
4746,7596,Subramanian @ S.S.S.Mani.S,TIRUNELVELI,IND,1,12th Pass,1408761,0,1408761
4747,7595,Subramanian.K,TIRUNELVELI,IND,0,5th Pass,250000,0,250000
4748,7111,"Subramaniyam, P.",NILGIRIS,IND,0,Literate,1005000,0,1005000
4749,5439,Subramaniyan A,TIRUVANNAMALAI,INC,0,Graduate Professional,10376045,864317,9511728
4750,3941,Subramaniyan G.R,NAMAKKAL,INC,0,Post Graduate,60136119,26717382,33418737
4751,2608,Subramanya Gowda K.,DAKSHINA KANNADA,IND,0,10th Pass,3695467,940000,2755467
4752,5029,Subrat Pathak,KANNAUJ,BJP,0,Graduate,23011868,9497355,13514513
4753,4852,Subrata Adhikary,RAIGANJ,IND,0,10th Pass,11228268,345538,10882730
4754,953,Subu Kechi,ARUNACHAL WEST,IND,1,Graduate Professional,785000,0,785000
4755,3337,Sucharita Mohanty,PURI,INC,0,Post Graduate,36546329,59551,36486778
4756,481,Sudarshan Bhagat,LOHARDAGA,BJP,0,Graduate,9031009,178967,8852042
4757,1084,Sudatta,DAKSHINA KANNADA,IND,0,10th Pass,326800,50000,276800
4758,2690,Suday Yadav,JAHANABAD,IND,0,10th Pass,4495000,0,4495000
4759,4495,Sudeep Roy,PURNIA,AAP,0,Post Graduate,24764655,0,24764655
4760,2876,Sudesh Kumar Mahto,RANCHI,AJSUP,0,Post Graduate,72986000,28544000,44442000
4761,1836,Sudhakar Kanamadi,BIJAPUR,BSP,0,Graduate,13314500,527933,12786567
4762,2596,Sudhakar Namdeorao Ghayawan,YAVATMAL-WASHIM,Republican Party of India (Khobragade),0,12th Pass,4025000,400000,3625000
4763,5875,Sudhakar Narayan Shinde,KALYAN,Ambedkarite Party of India,1,Post Graduate,28647744,0,28647744
4764,6953,Sudhamanirathinem,CHIDAMBARAM,Pattali Makkal Katchi,0,Post Graduate,24370129,0,24370129
4765,673,Sudhan Kumar,GHAZIABAD,SP,0,Graduate,180682500,0,180682500
4766,1235,Sudhanshu Suman,CHATRA,IND,0,Post Graduate,41861206,2258169,39603037
4767,63,Sudhansu Shekhar Bhaskar,JAMUI,RJD,0,Doctorate,13950638,1206926,12743712
4768,6332,Sudharshnar.K,DINDIGUL,IND,0,Graduate,3051385,0,3051385
4769,2237,Sudheer Kanchan,UDUPI CHIKMAGALUR,IND,0,Post Graduate,6657000,0,6657000
4770,164,Sudhindra Chandra Dasgupta,TRIPURA WEST,BJP,0,Graduate,2385517,0,2385517
4771,541,Sudhir Baban Surve,BULDHANA,AAP,0,Graduate,62153,0,62153
4772,2076,Sudhir Chandwas,BHIWANI-MAHENDRAGARH,IND,0,Graduate Professional,460000,0,460000
4773,4800,Sudhir Gautam,MANDSOUR,IND,0,5th Pass,371500,0,371500
4774,4203,Sudhir Gupta,MANDSOUR,BJP,0,Post Graduate,57429237,3058993,54370244
4775,3266,Sudhir Kumar Samal,DHENKANAL,INC,3,8th Pass,85901162,17484885,68416277
4776,7183,Sudhish L K,SALEM,DMDK,6,Graduate,339159159,96626000,242533159
4777,4384,Sudiip Ranjan Sen,RAIGANJ,SP,0,Others,649554210,226517331,423036879
4778,1912,Sufeera K. P.,THRISSUR,SDPI,1,8th Pass,104500,36000,68500
4779,7410,"Sugumar, K.",VELLORE,IND,0,Graduate,221700,0,221700
4780,1978,Suhas Naik,NORTH GOA,CPI,1,Graduate Professional,4483000,15000,4468000
4781,3674,Suhas Vishwasrao Deshmukh,SATARA,IND,0,Graduate,214884,0,214884
4782,1792,Sujay Ghatak,DARJEELING,INC,0,Graduate,4787759,730303,4057456
4783,1338,Sujeet Jha,NEW DELHI,Bhartiya Janta Dal (Integrated),0,12th Pass,220000,40000,180000
4784,4757,Sujeet Sangte,DEWAS,AAP,0,12th Pass,622739,2225000,-1602261
4785,3991,Sujit Kumar Ghosh,MURSHIDABAD,BJP,0,Graduate,3292077,0,3292077
4786,3222,Sujit Kumar Lugun,KEONJHAR,IND,0,12th Pass,5389000,64000,5325000
4787,2247,Sujit Mallick,KARIMGANJ,IND,0,10th Pass,200042,0,200042
4788,2262,Sukamal Das,SILCHAR,IND,0,8th Pass,25000,0,25000
4789,97,Sukanta Kumar Panigrahi,KANDHAMAL,BJP,2,Post Graduate,580000,120000,460000
4790,3428,Sukh Dev,JALORE,Awami Aamjan Party,0,5th Pass,2579600,80000,2499600
4791,1588,Sukharam Astkar Lanji,BALAGHAT,IND,0,Post Graduate,2102000,0,2102000
4792,1783,Sukhbilas Barma,JALPAIGURI,INC,0,Doctorate,26547600,0,26547600
4793,2075,Sukhbir Singh,BHIWANI-MAHENDRAGARH,IND,0,10th Pass,234171,0,234171
4794,445,Sukhbir Singh,SONIPAT,IND,0,Post Graduate,35860077,2625000,33235077
4795,4246,Sukhbir Singh Jaunapuria,TONK-SAWAI MADHOPUR,BJP,0,12th Pass,714124612,0,714124612
4796,3904,Sukhnandan Deshkar,MAHASAMUND,IND,0,8th Pass,7750000,465000,7285000
4797,1273,Sukhveer,FARIDABAD,Rashtriya Bahujan Congress Party,0,5th Pass,1303736,0,1303736
4798,3285,Sukumar Mallick,KENDRAPARA,IND,0,12th Pass,297207,0,297207
4799,2395,Suleman,JHALAWAR-BARAN,IND,0,8th Pass,150000,0,150000
4800,1014,Sulochana Devi,NAWADA,IND,0,Literate,7275000,800000,6475000
4801,4700,Suman Banerjee,DHANBAD,IND,0,8th Pass,3117000,27000,3090000
4802,5250,Suman Kumar,BHAGALPUR,IND,0,Graduate,492000,0,492000
4803,450,Suman Singh,SONIPAT,BSP,0,10th Pass,21283460,450000,20833460
4804,1285,Sumant Kumar,SOUTH DELHI,IND,1,Graduate,26172006,250729,25921277
4805,2345,Sumedha Nand Saraswati,SIKAR,BJP,0,Others,34311,0,34311
4806,4765,Sumitra Mahajan,INDORE,BJP,0,Post Graduate,18732234,3539000,15193234
4807,3891,Sumitrabai Dashrath Pawar,BEED,IND,0,Illiterate,0,0,0
4808,5936,Sundar Balkrishnan,MUMBAI SOUTH CENTRAL,AAP,0,Post Graduate,30571000,0,30571000
4809,6886,Sundar. G,CHENNAI NORTH,IND,0,5th Pass,221000,0,221000
4810,3943,Sundaram P.R,NAMAKKAL,AIADMK,0,Graduate,126539914,92677412,33862502
4811,7065,Sundaram.S,KRISHNAGIRI,United Communist Party of India,0,10th Pass,184000,78000,106000
4812,7454,Sundarraj.S,TIRUCHIRAPPALLI,IND,0,Graduate,2661024,0,2661024
4813,2030,Sunder,HISAR,IND,0,Literate,10170500,300000,9870500
4814,735,Sunder Lal Tiwari,REWA,INC,0,Graduate Professional,45035366,349790,44685576
4815,5017,Sunhari Lal,HATHRAS,AAP,0,10th Pass,24391902,7734490,16657412
4816,3461,Sunil,NAGAUR,IND,0,8th Pass,254232,0,254232
4817,3150,Sunil,NAGINA,IND,0,10th Pass,942300,0,942300
4818,2417,Sunil Agiwal,BHILWARA,AAP,0,Graduate Professional,43218483,11297000,31921483
4819,3648,Sunil Alias Yashwant Vasant Pednekar,RATNAGIRI SINDHUDURG,IND,0,10th Pass,1697200,125000,1572200
4820,2290,Sunil Bhadrawal,GANGANAGAR,Lok Dal,0,Graduate,1193000,0,1193000
4821,4400,Sunil Bharti,HARDOI,Rashtriya Ambedkar Dal,0,10th Pass,286500,0,286500
4822,2906,Sunil Borse,BHOPAL,BSP,0,10th Pass,5058000,800000,4258000
4823,812,Sunil Chandra Naik,KALAHANDI,Odisha Jan Morcha,0,Graduate Professional,2900000,0,2900000
4824,1317,Sunil Chhikara,NORTH WEST DELHI,IND,3,Graduate Professional,32150000,0,32150000
4825,1448,Sunil Dattu Pendor,NAGPUR,Bahujan Mukti Party,0,Post Graduate,1218560,0,1218560
4826,1120,Sunil David Amravati,AMRAVATI,Bahujan Mukti Party,0,Graduate Professional,21139,0,21139
4827,1631,Sunil Dutt,MEERUT,IND,0,12th Pass,10218400,0,10218400
4828,1719,Sunil Gautam,GAUTAM BUDHHA NAGAR,IND,2,8th Pass,37800,0,37800
4829,2945,Sunil Gopal,GWALIOR,SUCI(C),0,Graduate Professional,119963,0,119963
4830,1295,Sunil Kumar,SOUTH DELHI,IND,0,10th Pass,3125000,0,3125000
4831,2758,Sunil Kumar,PATALIPUTRA,Samajwadi Janata Party (Rashtriya),0,12th Pass,800000,150000,650000
4832,3088,Sunil Kumar,BAREILLY,AAP,0,Graduate,1919000,0,1919000
4833,1269,Sunil Kumar,ROHTAK,AITC,0,Graduate,339277,0,339277
4834,4731,Sunil Kumar Gupta,GODDA,IND,0,10th Pass,1285001,0,1285001
4835,657,Sunil Kumar Kasana,KAIRANA,AAP,0,12th Pass,20795589,1250000,19545589
4836,1230,Sunil Kumar Singh,CHATRA,BJP,0,Post Graduate,174744806,950052,173794754
4837,2753,Sunil Kumar Singh,PATALIPUTRA,IND,0,Post Graduate,123369500,61000,123308500
4838,3030,Sunil Pandit,DARJEELING,Rashtriya Janasachetan Party,0,8th Pass,848600,0,848600
4839,1550,Sunil Soni,SIDHI,Bahujan Sangharshh Dal,0,12th Pass,281653,0,281653
4840,4729,Sunil Soren,DUMKA,BJP,1,12th Pass,2944200,0,2944200
4841,1307,Sunil Sourabh,WEST DELHI,IND,0,Post Graduate,4963000,0,4963000
4842,2628,Sunil.V.J,BANGALORE NORTH,IND,0,10th Pass,3845084,641000,3204084
4843,339,Sunilkrishnan,ATTINGAL,IND,2,Post Graduate,5310000,0,5310000
4844,656,Sunita,KAIRANA,JD(U),0,Graduate,120000,0,120000
4845,1342,Sunita Chaudhary,NEW DELHI,JKNPP,0,10th Pass,2129016,3180,2125836
4846,3056,Sunita Shakya,AONLA,BSP,0,12th Pass,46011233,0,46011233
4847,3215,Sunita Sujata Nagpal,SHAHJAHANPUR,Peace Party,0,Graduate,77086,0,77086
4848,3706,Sunita Vijaykumar Ughade,SOLAPUR,IND,0,Literate,133900,225000,-91100
4849,3348,Sunjoy Hans,BHUBANESWAR,Aama Odisha Party,0,10th Pass,659112136,143674099,515438037
4850,3272,Suparno Satpathy,DHENKANAL,Aama Odisha Party,0,Graduate,48872009,702378,48169631
4851,2606,Supreeth Kumar Poojary,DAKSHINA KANNADA,Hindustan Janta Party,0,10th Pass,1388000,142250,1245750
4852,3386,Supriya Sule,BARAMATI,NCP,0,Graduate,1139090851,0,1139090851
4853,4748,Surae Soren,RAJMAHAL,IND,0,Doctorate,566012,0,566012
4854,3723,Suraiya Zaithoon,BANGALORE CENTRAL,IND,1,Others,85000,0,85000
4855,4232,Suraj Bhan,DAUSA,SP,0,Post Graduate,5582551,0,5582551
4856,3530,Suraj Vishwanath Kondarwad,HINGOLI,IND,0,Graduate Professional,0,0,0
4857,4090,Surat Jaman Mondal,DHUBRI,SUCI(C),0,Others,328926,7471,321455
4858,3651,Surekha Alias Suraiyya Shahin Shaikh,SANGLI,Maharashtra Vikas Aghadi,0,Graduate,300000,0,300000
4859,4844,Suren Murmu,MALDAHA UTTAR,IND,0,8th Pass,533000,0,533000
4860,893,Surender Kumar,CHANDIGARH,Bahujan Mukti Party,0,Graduate,304607,151340,153267
4861,200,Surender Kumar,SIRSA,IND,0,12th Pass,131500,0,131500
4862,979,Surender Singh,CHANDNI CHOWK,IND,0,Graduate,7902603,0,7902603
4863,3762,Surendra B. P.,CHAMARAJANAGAR,Sarva Janata Party,0,Graduate,272500,0,272500
4864,3421,Surendra Kumar Jain,AJMER,IND,0,Graduate,1242221,0,1242221
4865,2342,Surendra Kumar Phulwariya,SIKAR,IND,4,Post Graduate,70250,0,70250
4866,2347,Surendra Kumar Punia,SIKAR,AAP,0,Graduate Professional,15949561,3984000,11965561
4867,4145,Surendra Lal Singh,SURGUJA,CPI(M),0,Post Graduate,97692,33620,64072
4868,4817,Surendra Mehar,UJJAIN,IND,2,10th Pass,282100,0,282100
4869,5027,Surendra Nath,KANNAUJ,Bahujan Mukti Party,0,Graduate,1998000,0,1998000
4870,2670,Surendra Prasad Yadav,JAHANABAD,RJD,3,Not Given,49462901,1022720,48440181
4871,152,Surendra Rajvanshi,NAWADA,SP,0,Graduate,3385189,0,3385189
4872,146,Surendra Ram,SASARAM,IND,0,5th Pass,9289000,200000,9089000
4873,3044,Surendra Singh,AMROHA,IND,0,Post Graduate,36813206,0,36813206
4874,1797,Surendrajeet Singh Ahluwalia,DARJEELING,BJP,0,Graduate Professional,23377223,443035,22934188
4875,1731,Suresh,BULANDSHAHR,Jai Maha Bharath Party,0,8th Pass,126500,0,126500
4876,1974,Suresh,ATTINGAL,IND,0,8th Pass,2360000,0,2360000
4877,1977,Suresh,ATTINGAL,IND,0,10th Pass,56000,0,56000
4878,3846,Suresh,KOPPAL,IND,0,5th Pass,1600000,70000,1530000
4879,4250,Suresh,TONK-SAWAI MADHOPUR,BSP,0,Graduate,2065000,0,2065000
4880,1181,Suresh Angadi,BELGAUM,BJP,1,Graduate Professional,417003065,366283849,50719216
4881,3494,Suresh Baburao Veer,BARAMATI,IND,0,10th Pass,3425000,15000,3410000
4882,4985,Suresh Chand Saaraswat,FARRUKHABAD,IND,0,Post Graduate,22245,0,22245
4883,7540,Suresh Gandhi,VIRUDHUNAGAR,IND,0,12th Pass,1231198,0,1231198
4884,7203,Suresh Giga Dabhi,MUMBAI NORTH CENTRAL,IND,0,Literate,2057768,2103322,-45554
4885,5182,Suresh Gopinath Mhatre,BHIWANDI,MNS,2,12th Pass,26619897,1283975,25335922
4886,5626,Suresh Hiraman Ingale,RAVER,IND,0,Post Graduate,390000,115000,275000
4887,5191,Suresh Kaluram Jadhav,BHIWANDI,IND,0,8th Pass,2264906,115000,2149906
4888,3385,Suresh Khopade,BARAMATI,AAP,0,Graduate Professional,31870466,0,31870466
4889,5274,Suresh Kumar Ajad,SUPAUL,Jai Hind Party,0,Post Graduate,1051233,30000,1021233
4890,7366,Suresh Kumar. S,TIRUVALLUR,IND,0,8th Pass,212000,0,212000
4891,7597,Suresh Kumar.S,TIRUNELVELI,IND,0,Graduate Professional,320000,250000,70000
4892,2172,Suresh Maharudrappa Mundargi,HAVERI,Rani Chennamma Party,0,10th Pass,1162000,0,1162000
4893,1672,Suresh Pal,GHAZIABAD,Bharatiya Sarvodaya Kranti Party,0,12th Pass,63170,0,63170
4894,3867,Suresh Parth Mane (Nana),SANGLI,IND,0,12th Pass,154500,0,154500
4895,1143,Suresh Pujari,SAMBALPUR,BJP,0,Post Graduate,8684372,0,8684372
4896,5260,Suresh Rai,KATIHAR,Rashtravadi Janata Party,0,8th Pass,672000,80000,592000
4897,1504,Suresh Rajaram Mukhmale,YAVATMAL-WASHIM,Maharashtra Vikas Aghadi,0,12th Pass,3280000,0,3280000
4898,3570,Suresh Shamrao Ghadge,MADHA,AITC,0,Literate,3000000,0,3000000
4899,4218,Suresh Sharma,ALWAR,Jago Party,0,10th Pass,275000,0,275000
4900,2882,Suresh Toppo,RANCHI,Jharkhand Disom Party,0,Graduate,427491,0,427491
4901,2541,Suresh Udhavrao Shinde,NAGPUR,IND,0,Graduate Professional,2545000,0,2545000
4902,3507,Sureshdada Patil,HATKANANGLE,IND,0,Graduate,47349446,12294173,35055273
4903,898,Surinder Bhardwaj,CHANDIGARH,JD(U),0,Graduate,419506,0,419506
4904,2089,Surinder Kumar Khullar,GURGAON,IND,0,Graduate,15164593,3641000,11523593
4905,409,Surinder Pal Singh,AMBALA,AAP,0,Post Graduate,15369639,2104283,13265356
4906,5623,Surwade Jairam Girdhar,RAVER,IND,0,Post Graduate,9555000,0,9555000
4907,2455,Surya Bhavani Singh Chawada,RAJSAMAND,IND,0,Graduate Professional,3121717,225545,2896172
4908,3529,Suryawanshi Ashok Bhagwanrao,HINGOLI,IND,0,Graduate Professional,10055500,175000,9880500
4909,3309,Suryawanshi Dattaram Balaji,NANDED,IND,0,8th Pass,7263132,841037,6422095
4910,3553,Suryawansi Sidharth Tukaram,LATUR,Bahujan Mukti Party,0,Doctorate,3537300,627000,2910300
4911,2707,Suryoday Paswan,MUNGER,Sankhyanupati Bhagidari Party,0,Graduate,627000,0,627000
4912,3252,Susanta Kumar Jena,BHADRAK,IND,0,10th Pass,15000,0,15000
4913,3639,Sushama Pandurang Gaikwad,PUNE,IND,0,10th Pass,30300,0,30300
4914,3508,Sushant Santosh Dige,HATKANANGLE,IND,0,12th Pass,2135600,610000,1525600
4915,427,Sushil Kaushik,HISAR,IND,0,Post Graduate,51500,0,51500
4916,371,Sushil Kumar Singh,AURANGABAD,BJP,5,Post Graduate,127845854,7321626,120524228
4917,430,Sushil Nidhi,HISAR,IND,0,12th Pass,2306220,800000,1506220
4918,3615,Sushilkumar Vinayak Padule,OSMANABAD,IND,0,10th Pass,25500,0,25500
4919,489,Sushma Mehta,PALAMAU,CPI(ML)L,6,12th Pass,2305547,651713,1653834
4920,4818,Sushma Swaraj,VIDISHA,BJP,0,Graduate Professional,175516422,6500000,169016422
4921,1124,Sushma Vitthal Nagpure,BHANDARA-GONDIYA,IND,0,12th Pass,1060000,0,1060000
4922,2255,Sushmita Dev,SILCHAR,INC,1,Post Graduate,87495844,12008613,75487231
4923,108,Sushree Saroj Pandey,DURG,BJP,0,Doctorate,3200925,508039,2692886
4924,61,Swadesh Ohri,NEW DELHI,Atulya Bharat Party,0,12th Pass,25102378,0,25102378
4925,4382,Swapan Kumar Das,RAIGANJ,BSP,0,10th Pass,4233000,0,4233000
4926,4377,Swapan Kumar Mandal,MURSHIDABAD,Amra Bangalee,0,10th Pass,734500,0,734500
4927,4099,Swarnalata Chaliha,MANGALDOI,SUCI(C),0,Post Graduate,96500,0,96500
4928,1992,Swati Kerkar,SOUTH GOA,AAP,0,12th Pass,693648,0,693648
4929,2509,Syamalakumari,THIRUVANANTHAPURAM,IND,0,5th Pass,0,0,0
4930,4690,Syed Abid Ahmad Shah,ANANTNAG,JKNPP,0,10th Pass,20974,0,20974
4931,4459,Syed Alamdar Hussain,ARARIA,IND,0,12th Pass,3610000,0,3610000
4932,3798,Syed Arif,KOPPAL,BSP,1,12th Pass,10000,5000,5000
4933,854,Syed Asif Bukhaari,BANGALORE CENTRAL,IND,0,12th Pass,325897,0,325897
4934,3041,Syed Kalbe Rushaid Rizvi,AMROHA,AAP,0,Others,5709549,25000,5684549
4935,3746,Syed Mehaboob,BANGALORE SOUTH,JD(U),0,12th Pass,5572310,0,5572310
4936,6314,Syed Mohideen.A.G.,CUDDALORE,AAP,0,Graduate,23090724,3340000,19750724
4937,4189,Syed Nizam Ahmed,INDORE,IND,0,12th Pass,2425000,0,2425000
4938,3753,Syed Rafiq Ahmed,BANGALORE SOUTH,IND,0,5th Pass,1981000,0,1981000
4939,3183,Syed Salman Ali,RAMPUR,AAP,0,Graduate,2118955,0,2118955
4940,5268,Syed Shah Iqbal Alam,PURNIA,Bhartiya Ekta Manch Party,0,12th Pass,18201000,0,18201000
4941,4075,Syed Shahnawaz Hussain,BHAGALPUR,BJP,0,10th Pass,47044000,14007000,33037000
4942,2140,Syed Waheed,BIDAR,Bahujan Mukti Party,1,10th Pass,1425000,0,1425000
4943,2318,Syopat Ram,CHURU,Bharatiya Sant Mat Party,0,10th Pass,202400,0,202400
4944,1922,T D Baburajan,CHALAKUDY,IND,0,12th Pass,5278500,180000,5098500
4945,1953,T S Balakrishnan,ALAPPUZHA,IND,0,12th Pass,50,0,50
4946,3771,T V Manjunatha Gowda,CHIKKBALLAPUR,IND,0,10th Pass,7718000,300000,7418000
4947,2583,T. Dayananda,CHITRADURGA,IND,0,5th Pass,3483000,30000,3453000
4948,6918,T. Dhanasekar,CHENNAI SOUTH,National Organisation Congress,0,Graduate Professional,3060000,0,3060000
4949,3751,T. E. Moses,BANGALORE SOUTH,IND,0,Not Given,7963850,0,7963850
4950,296,T. L. Santhosh,THRISSUR,IND,6,Not Given,7597000,530000,7067000
4951,6942,T. Ponnusamy,CHENNAI SOUTH,IND,0,8th Pass,247855,0,247855
4952,6861,T. Ravikumar,CHENNAI CENTRAL,IND,0,8th Pass,116000,0,116000
4953,278,T.Ayyappan,PONNANI,BSP,0,Post Graduate,3324000,0,3324000
4954,3292,T.Bhavana,CHITRADURGA,IND,0,10th Pass,100000,0,100000
4955,3779,T.D. Jagadeesha,HASSAN,IND,0,10th Pass,20000,0,20000
4956,6951,T.K. Ramajayam,CHENNAI SOUTH,IND,0,Graduate Professional,5312700,0,5312700
4957,6930,T.K.S.Elangovan,CHENNAI SOUTH,DMK,0,Post Graduate,20482886,675903,19806983
4958,1937,T.K.Tomy,IDUKKI,CPI(ML) Red star,0,Others,404000,0,404000
4959,3964,T.N.Bharath Nachiappan,MADURAI,INC,0,Post Graduate,5559753,0,5559753
4960,6364,T.Ramachandiran,KALLAKURICHI,IND,0,5th Pass,52095,0,52095
4961,7489,T.Ramasamy,MADURAI,IND,0,5th Pass,118530,0,118530
4962,2635,T.S.Chaitanya,BANGALORE NORTH,IND,0,Others,1203291,0,1203291
4963,7427,T.S.Senthilkumar,TIRUPPUR,IND,0,10th Pass,130600,0,130600
4964,954,T.Siddique,KASARAGOD,INC,7,Graduate Professional,6779637,1849149,4930488
4965,3834,T.Sivagnanasambandan,CUDDALORE,IND,0,Post Graduate,8496700,30000,8466700
4966,2580,T.Somesh,CHITRADURGA,IND,0,5th Pass,5488000,0,5488000
4967,952,Taba Taku,ARUNACHAL WEST,Lok Bharati,0,Graduate,6200000,0,6200000
4968,1415,Tadas Vilas Krushnaji,WARDHA,IND,0,Graduate,3118896,0,3118896
4969,405,Takam Sanjoy,ARUNACHAL WEST,INC,0,Graduate,105915042,0,105915042
4970,4746,Tala Hansda,RAJMAHAL,IND,0,8th Pass,1714000,0,1714000
4971,6963,"Tamilnadu Selvam, Era.",COIMBATORE,BSP,0,5th Pass,35000,0,35000
4972,6980,"Tamilselvan, K.",COIMBATORE,IND,0,Graduate Professional,425000,0,425000
4973,7458,Tamilselvi.S,THANJAVUR,CPI(M),0,Post Graduate,221758,0,221758
4974,3985,Tamradwaj Sahu,DURG,INC,0,12th Pass,21002226,1777720,19224506
4975,3653,Tanajirao Jagannath Jadhav(Chinchanikar),SANGLI,IND,0,Graduate,203614,76363,127251
4976,143,Tanish Orang,LAKHIMPUR,CPI(ML)L,0,8th Pass,295642,0,295642
4977,4685,Tanveer Hussain Khan,ANANTNAG,IND,0,Graduate Professional,23200000,0,23200000
4978,4147,Tanvir Maqbool Dar,ANANTNAG,AAP,0,Graduate Professional,16821474,3959860,12861614
4979,2661,Taphir Husain,BUXAR,Hindustan Vikas Dal,0,5th Pass,310000,0,310000
4980,247,Tapir Gao,ARUNACHAL EAST,BJP,0,Post Graduate,82370000,300000,82070000
4981,4639,Tara Singh,RAIGARH,AAP,0,Graduate,5623449,300000,5323449
4982,1144,Tarani Bhoi,SAMBALPUR,Paschimanchal Vikas Party,0,10th Pass,2587176,547876,2039300
4983,4694,Tarch Murmu,DHANBAD,IND,0,Graduate,1909310,0,1909310
4984,989,Tariq Mirza,CHANDNI CHOWK,RPI(A),0,8th Pass,110000,0,110000
4985,4966,Tariq Parvez,FARRUKHABAD,AAP,0,12th Pass,1141000,0,1141000
4986,3616,Tarkase Pushpa,OSMANABAD,Hindusthan Nirman Dal,0,10th Pass,75000,0,75000
4987,3429,Tarun Kumar,JALORE,IND,0,10th Pass,255000,0,255000
4988,2248,Tarun Kumar Das,KARIMGANJ,AAP,0,10th Pass,391000,0,391000
4989,4631,Tarzan Jangde,RAIPUR,IND,0,12th Pass,580000,0,580000
4990,4456,Taslim Uddin,ARARIA,RJD,4,Literate,42368468,1026919,41341549
4991,3853,Tate Ashok Santram,BEED,Ambedkarist Republican Party,0,12th Pass,25000,0,25000
4992,3263,Tathagata Satpathy,DHENKANAL,BJD,7,Others,35434099,0,35434099
4993,6001,Tatkare Sunil Dattatrey,RAIGAD,NCP,0,Others,100643136,2482602,98160534
4994,5993,Tatkare Sunil Sham,RAIGAD,IND,0,12th Pass,726710,0,726710
4995,3388,Tatyaso Sitaram Tele,BARAMATI,JD(S),1,Literate,1366907,500000,866907
4996,3133,Teaj Singh Saini,MORADABAD,Rashtriya Samanta Dal,0,Illiterate,480000,0,480000
4997,4630,Teekam Kumar Tondre,RAIPUR,IND,0,12th Pass,215500,0,215500
4998,1286,Tej Pal Singh,SOUTH DELHI,IND,0,10th Pass,2755320,0,2755320
4999,3144,Tej Singh,NAGINA,Ambedkar Samaj Party,0,Graduate,38907469,0,38907469
5000,3879,Tejas Ankush Ghumare,BEED,IND,1,Literate,20000,0,20000
5001,2404,Tejpal,KOTA,IND,0,Graduate,2112136,0,2112136
5002,232,Tejpal Singh,RAMPUR,IND,0,12th Pass,477625,0,477625
5003,2364,Tek Chand Sonwal,JAIPUR RURAL,Ambedkarite Party of India,0,12th Pass,3396640,0,3396640
5004,2491,Tek Nath Dhakal,SIKKIM,Sikkim Krantikari Morcha,0,Post Graduate,37669202,0,37669202
5005,364,Tetari Devi,SASARAM,CPI(ML)L,0,Literate,2138858,0,2138858
5006,2841,Tetri Urf Sheela Devi,HAZARIBAGH,BSP,0,10th Pass,5412000,3000,5409000
5007,7453,"Thaddaus Fernandez,",TIRUCHIRAPPALLI,IND,0,Post Graduate,5841080,0,5841080
5008,4020,Thaddeus Lakra,RANCHI,IND,0,Graduate,5210000,0,5210000
5009,52,Thakare Rameshwar (Rameshwar) Sundarlal,BHANDARA-GONDIYA,SP,0,10th Pass,3700102,74000,3626102
5010,6998,Thamaraiselvan.R,DHARMAPURI,DMK,0,Not Given,16722502,0,16722502
5011,3947,Thambidurai.M,KARUR,AIADMK,2,Doctorate,132457262,51481886,80975376
5012,7053,"Thamilalagan, A.",KARUR,IND,0,Post Graduate,290000,0,290000
5013,7471,Thamilarima S,SIVAGANGA,AAP,0,Graduate,41412999,0,41412999
5014,7504,"Thangadurai, V.",THENI,BSP,1,10th Pass,1030000,0,1030000
5015,6333,Thangapandian.R,DINDIGUL,IND,3,12th Pass,700000,0,700000
5016,6923,Thangaraj,CHENNAI SOUTH,IND,0,Graduate,25500,0,25500
5017,7001,Thangaraj V,ERODE,IND,0,5th Pass,500,0,500
5018,7096,Thangasamy. V,NAGAPATTINAM,BSP,0,8th Pass,10500,0,10500
5019,534,Thangso Baite,OUTER MANIPUR,INC,0,Post Graduate,5947000,880000,5067000
5020,7542,Thanuskodi,VIRUDHUNAGAR,IND,0,Others,2772100,562000,2210100
5021,7173,Thennarasu .P,RAMANATHAPURAM,IND,0,Others,460000,0,460000
5022,1887,Thennilapuram Radhakrishnan,PALAKKAD,Welfare Party Of India,0,10th Pass,2994408,270000,2724408
5023,7585,Thevendran.T.,TIRUNELVELI,BSP,0,Graduate,673797,0,673797
5024,7172,Thiagarajan .R,RAMANATHAPURAM,IND,0,Graduate Professional,850000,0,850000
5025,5703,Thiagarajan K,SALEM,IND,0,12th Pass,856000,100000,756000
5026,3807,Thimmappa Uppar,KOPPAL,Bharatiya Dr. B.R.Ambedkar Janta Party,0,10th Pass,1000423,0,1000423
5027,3813,Thimme Gowda,MYSORE,Sarva Janata Party,0,Literate,1272000,0,1272000
5028,6308,Thirumaavalavan,CHIDAMBARAM,Viduthalai Chiruthaigal Katchi,3,Post Graduate,9195241,1627119,7568122
5029,6317,Thirunavukkarasu,CUDDALORE,IND,0,Post Graduate,15000,0,15000
5030,7084,Thirunavukkarasu. R,MAYILADUTHURAI,IND,0,Post Graduate,43925000,0,43925000
5031,7156,Thirunnavukkarasar .Su,RAMANATHAPURAM,INC,1,Post Graduate,34748520,469666,34278854
5032,7412,"Thirupathy, T.",VELLORE,IND,0,Post Graduate,6934775,0,6934775
5033,6957,"Thirusangu, A",CHIDAMBARAM,IND,0,5th Pass,412000,0,412000
5034,2510,Thomas Joseph,THIRUVANANTHAPURAM,RPI(A),0,10th Pass,7850000,872906,6977094
5035,2518,Thopaiah C,BANGALORE RURAL,BSP,0,5th Pass,1315000,200000,1115000
5036,3504,Thorat Anandrao Tukaram,HATKANANGLE,IND,0,Graduate,1740000,0,1740000
5037,3854,Thorat Dhanraj Vitthal,BEED,Maharashtra Parivartan Sena (T),0,10th Pass,700000,0,700000
5038,7188,Thorat Sunil Uttamrao,MUMBAI NORTH,AIFB,0,Graduate,1618000,0,1618000
5039,7119,"Thozhar Tamilselvan, P.",PERAMBALUR,United Communist Party of India,0,Literate,2015076,136382,1878694
5040,3748,Thulasappa Dasar,BANGALORE SOUTH,IND,0,Post Graduate,1280000,0,1280000
5041,1954,Thulaseedharan Pallickal,ALAPPUZHA,SDPI,2,12th Pass,118200,0,118200
5042,478,Tilakdhari Prasad Singh,KODARMA,INC,0,Graduate,4666034,0,4666034
5043,7085,Timothy.T,MAYILADUTHURAI,IND,0,5th Pass,542922,0,542922
5044,2294,Titar Singh,GANGANAGAR,IND,0,Literate,41500,0,41500
5045,2317,Toruram Meghwal,CHURU,Bahujan Mukti Party,1,Literate,881700,70000,811700
5046,7610,Tribhuvan Madhukar Padmakar,AURANGABAD,IND,0,12th Pass,2193000,0,2193000
5047,270,Trichur Nazeer,KOZHIKODE,IND,0,10th Pass,362347,0,362347
5048,5661,Triloki Ghurahu Yadav,THANE,IND,0,8th Pass,890224,0,890224
5049,7224,Tukaram Baburao Mane,MUMBAI NORTH EAST,Bahujan Mukti Party,0,Others,27041300,60000,26981300
5050,3617,Tukaram Dasu Gangawane,OSMANABAD,IND,0,10th Pass,2580700,90000,2490700
5051,4513,Tuleshwar Singh,SURGUJA,AITC,0,Graduate,26048526,2483971,23564555
5052,1434,Tumane Gopal Ajabrao,RAMTEK,IND,0,12th Pass,17500,0,17500
5053,7233,Tupsoundarya Sunita Mohan,MUMBAI NORTH EAST,IND,0,12th Pass,1530000,0,1530000
5054,3618,Tupsundare Balaji Bapurao,OSMANABAD,IND,0,8th Pass,198000,0,198000
5055,760,U K Choudhary (Munna Bhaiya),BALAGHAT,AAP,0,Post Graduate,54742608,1000000,53742608
5056,1417,Ubale Shrikrushna Champatrao,WARDHA,Ambedkarwadi Republican Party,1,Graduate Professional,919000,110000,809000
5057,2701,Uchit Kumar,MUNGER,IND,1,12th Pass,176574,0,176574
5058,3471,Udaram,PALI,IND,0,8th Pass,6512500,0,6512500
5059,3554,Udare Minakshi Mahadev,LATUR,IND,0,Graduate,525000,20000,505000
5060,1070,Udasi Shivakumar Channabasappa,HAVERI,BJP,0,Graduate Professional,576693538,54423645,522269893
5061,1761,Uday Alies Udayveer,BIJNOR,Bharatiya Momin Front,1,Not Given,1610000,0,1610000
5062,1299,Uday Kumar Singh,WEST DELHI,Bahujan Mukti Party,0,12th Pass,5144079,900000,4244079
5063,62,Uday Narain Choudhary,JAMUI,JD(U),0,Graduate,9827813,0,9827813
5064,1602,Uday Pratap Singh,HOSHANGABAD,IND,0,Graduate,40000,0,40000
5065,134,Uday Pratap Singh,HOSHANGABAD,BJP,1,Graduate,133375092,3775714,129599378
5066,4493,Uday Singh Urf Pappu Singh,PURNIA,BJP,4,12th Pass,1466364725,123100000,1343264725
5067,7022,Udayakumar S.P.,KANNIYAKUMARI,AAP,382,Doctorate,52080000,297000,51783000
5068,1701,Udayveer,GAUTAM BUDHHA NAGAR,Rashtriya Janta Party,0,Illiterate,7271300,124123,7147177
5069,4087,Uddhab Barman,BARPETA,CPI(M),0,Graduate Professional,318400,0,318400
5070,3679,Uddhavrao Balwant Gaikwad,SHIRDI,IND,0,5th Pass,200900,0,200900
5071,3335,Udhav Rangrao Pawar (Patil),PARBHANI,IND,0,Graduate,2411162,675000,1736162
5072,6322,Udhaya Kumar .M,DINDIGUL,AIADMK,0,Post Graduate,27810000,2800000,25010000
5073,69,Udit Raj,NORTH WEST DELHI,BJP,1,Doctorate,44902363,0,44902363
5074,5055,Udyan Sharma,MATHURA,Peace Party,2,Graduate,125350000,1618244,123731756
5075,5858,Ugle Ram Haribhau,JALNA,Rashtriya Sant Sandesh Party,0,10th Pass,17863200,0,17863200
5076,4961,Ujiyare Lal Dohare,ETAWAH,AAP,0,Post Graduate,92802808,2000000,90802808
5077,7009,Ulaganathan .A,KANCHEEPURAM,IND,0,12th Pass,418000,0,418000
5078,1505,Ulhas Vasramji Jadhao,YAVATMAL-WASHIM,IND,0,Graduate Professional,5394200,850000,4544200
5079,7153,Uma Mageswari R.T.,RAMANATHAPURAM,CPI,0,12th Pass,688550,1165000,-476450
5080,4719,Uma Nath Kole,DUMKA,IND,0,10th Pass,350527,0,350527
5081,190,Umadevi. M,BANGALORE SOUTH,SUCI(C),1,Post Graduate,469430,0,469430
5082,154,Umakant Rahi,NAWADA,Shoshit Samaj Dal,0,Post Graduate,2610034,0,2610034
5083,3968,Umakant Yadav,BANKA,Bahujan Mukti Party,0,Graduate Professional,3015000,0,3015000
5084,4182,Umang Singhar,DHAR,INC,0,Graduate,27003369,710226,26293143
5085,5694,Umarani S W/O Sivakumar,SALEM,IND,0,8th Pass,730000,0,730000
5086,3937,Umarani. S W/O Selvaraj,SALEM,DMK,0,Post Graduate,13571624,963005,12608619
5087,2079,Umed Singh,GURGAON,RASHTRIYA MORCHA PARTY,0,Others,30500,0,30500
5088,3205,Umed Singh,SHAHJAHANPUR,BSP,0,12th Pass,101502333,1404515,100097818
5089,2009,Umed Singh,HISAR,IND,0,5th Pass,25250500,300000,24950500
5090,1760,Umesh Alies Pani,BIJNOR,IND,0,8th Pass,545918,0,545918
5091,3686,Umesh Arjun Kanchan,SHIRUR,IND,0,8th Pass,91000,0,91000
5092,3625,Umesh Bhujang Masankhamb,PUNE,IND,0,12th Pass,2850400,1250000,1600400
5093,2821,Umesh Chandra Mehta,GIRIDIH,AJSUP,1,Doctorate,9368674,764290,8604384
5094,233,Umesh Gautam,BAREILLY,BSP,1,Doctorate,103318000,39530000,63788000
5095,2772,Umesh Kumar,PATNA SAHIB,SP,0,Graduate,1415000,0,1415000
5096,4629,Umesh Kumar Verma,RAIPUR,IND,0,Post Graduate,464935,0,464935
5097,3675,Umesh Mukund Waghmare,SATARA,IND,0,8th Pass,30000,0,30000
5098,7216,Umesh Sonba Avhad,MUMBAI NORTH CENTRAL,Maharashtra Parivartan Sena (T),0,10th Pass,50000,0,50000
5099,5854,Unge Rambhau Kundlik,JALNA,IND,0,Post Graduate,9428900,105990,9322910
5100,2258,Upendra Chandra Das,SILCHAR,IND,0,8th Pass,695001,0,695001
5101,2848,Upendra Karmakar,JAMSHEDPUR,IND,0,5th Pass,330000,0,330000
5102,554,Upendra Kushwaha,KARAKAT,Rashtriya Lok Samta Party,4,Post Graduate,24829741,823834,24005907
5103,376,Upendra Nath,AURANGABAD,Bahujan Mukti Party,1,Post Graduate,9228000,0,9228000
5104,626,Upendra Ravidas,JAMUI,JMM,0,10th Pass,421280000,0,421280000
5105,4386,Upendra Singh,FIROZABAD,Bharatiya Kisan Parivartan Party,0,Graduate Professional,1396180,0,1396180
5106,4914,Upendra Singh,AGRA,INC,1,Post Graduate,18179036,330224,17848812
5107,7210,Upesh M. Baria,MUMBAI NORTH CENTRAL,IND,0,Post Graduate,29335000,0,29335000
5108,4095,Urkhao Gwra Brahma,KOKRAJHAR,IND,0,12th Pass,7766195,0,7766195
5109,2327,Urmila,JHUNJHUNU,Megh Desham Party,0,Graduate,353000,0,353000
5110,2082,Usha Rani Verma,GURGAON,IND,0,Post Graduate,5821000,917021,4903979
5111,375,Usha Sharan,AURANGABAD,Shoshit Samaj Dal,1,Literate,3900000,1000,3899000
5112,4401,Usha Verma,HARDOI,SP,0,Post Graduate,33409414,1100000,32309414
5113,3519,Uttam Rathod,HINGOLI,IND,0,12th Pass,2500000,1180000,1320000
5114,3513,Uttamrao Pandurang Rathod,HINGOLI,Bahujan Mukti Party,0,Graduate Professional,8148200,458000,7690200
5115,569,V Govind,KOPPAL,IND,0,5th Pass,162000,0,162000
5116,1865,V M Raghavan,KOZHIKODE,IND,0,10th Pass,13000,0,13000
5117,1101,V Muniswamy,KOLAR,SP,0,Illiterate,403964,0,403964
5118,4056,V Rakkamuthu,SIVAGANGA,BSP,0,Illiterate,10000,0,10000
5119,349,V S Jayakumar,THIRUVANANTHAPURAM,IND,0,Graduate,2040500,1675000,365500
5120,1886,V S Shanavas,PALAKKAD,IND,4,10th Pass,1401101,333500,1067601
5121,471,V V Khalid,ANDAMAN & NICOBAR ISLANDS,IND,0,8th Pass,235000,0,235000
5122,7500,V Velusamy,MADURAI,DMK,9,Graduate Professional,38731336,3600000,35131336
5123,1195,V. Bala Krishnan,BANGALORE CENTRAL,AAP,0,Graduate Professional,1894253519,320000,1893933519
5124,6921,V. Balaji,CHENNAI SOUTH,BSP,0,12th Pass,443000,0,443000
5125,6860,V. Chandramohan,CHENNAI CENTRAL,IND,0,12th Pass,52000,0,52000
5126,604,V. Dhananjaya Kumar,UDUPI CHIKMAGALUR,JD(S),0,Graduate Professional,99477175,0,99477175
5127,5580,V. Narayanasamy,PONDICHERRY,INC,0,Post Graduate,91869740,4206223,87663517
5128,4062,V. Rangarajan,PONDICHERRY,AAP,0,Graduate Professional,57938000,3400000,54538000
5129,5590,V. Vijaya,PONDICHERRY,IND,0,12th Pass,306000,230000,76000
5130,4327,V.Andichamy,MADURAI,IND,0,Graduate Professional,441200,0,441200
5131,6290,V.Anna Venkatesh,ARANI,Anaithindia Dravidar Samudaya Munnetra Kazhag,0,Graduate,835000,0,835000
5132,6283,V.Elumalai,ARANI,AIADMK,0,Graduate Professional,70492462,25000,70467462
5133,7488,V.G.Ramdoss,MADURAI,IND,0,Graduate Professional,77071122,6290631,70780491
5134,955,V.K. Sajeeva,VADAKARA,BJP,2,Graduate Professional,2534579,1125903,1408676
5135,7494,V.Karuppaiah,MADURAI,IND,0,5th Pass,67000,0,67000
5136,181,V.Manjunath Bhandary,SHIMOGA,INC,0,Doctorate,194691247,89667657,105023590
5137,6304,V.Moorthy,ARANI,IND,0,5th Pass,380500,0,380500
5138,4285,V.P.Eswaran,KALLAKURICHI,DMDK,0,Post Graduate,98021861,5000000,93021861
5139,4348,V.Ravichandran,KARUR,Ulzaipali Makkal Katchy,0,12th Pass,280000,0,280000
5140,4300,V.Sathyabama,TIRUPPUR,AIADMK,2,Post Graduate,28108573,2475755,25632818
5141,1106,V.Srinivasa,KOLAR,IND,0,12th Pass,112000,0,112000
5142,1879,V.T.Ikramul Haque,PONNANI,SDPI,0,10th Pass,15185342,0,15185342
5143,7099,Vadivel Ravanan,NAGAPATTINAM,Pattali Makkal Katchi,0,Illiterate,1283271,0,1283271
5144,6277,"Vadivel, A.",ARAKKONAM,IND,0,10th Pass,157800,0,157800
5145,4038,Vadivel.R,NAMAKKAL,Ulzaipali Makkal Katchy,0,12th Pass,136000,0,136000
5146,7131,"Vadivelu, P.",PERAMBALUR,IND,1,12th Pass,750000,0,750000
5147,3069,Vagish Pathak,BADAUN,BJP,0,Post Graduate,138995758,42644117,96351641
5148,3589,Vaidy Hansraj Dadarao,NANDED,BSP,0,Graduate Professional,24105918,1000000,23105918
5149,7528,Vaiko,VIRUDHUNAGAR,MDMK,6,Post Graduate,36116391,137545,35978846
5150,3370,"Vaishali Surendra Borde	",MAVAL,IND,0,Graduate Professional,78806,0,78806
5151,5953,Vaishali Surendra Borde,MUMBAI SOUTH CENTRAL,IND,0,Graduate Professional,78806,0,78806
5152,5451,Vaithiyanathan S,TIRUVANNAMALAI,IND,0,12th Pass,1120000,0,1120000
5153,7046,"Valaiyapathi, R.",KARUR,AAP,0,Graduate,12942916,0,12942916
5154,4051,Vallal Peruman,CHIDAMBARAM,INC,0,Graduate Professional,25721400,4625000,21096400
5155,5429,Vanaroja R,TIRUVANNAMALAI,AIADMK,0,Post Graduate,3700000,0,3700000
5156,1852,Vappan,WAYANAD,BSP,0,Graduate Professional,3725000,888817,2836183
5157,3936,Varadan. M,KALLAKURICHI,IND,0,Post Graduate,1531000,975000,556000
5158,5140,Varis Ali,TONK-SAWAI MADHOPUR,awami aamjan party,0,8th Pass,2796100,0,2796100
5159,1457,Varsha Govind Tidke,BHANDARA-GONDIYA,IND,0,10th Pass,294378,0,294378
5160,3720,Vasanagouda Bhandi,BAGALKOT,IND,0,12th Pass,875000,0,875000
5161,7018,Vasantha Kumar H.,KANNIYAKUMARI,INC,5,Post Graduate,2857786803,876085097,1981701706
5162,7036,Vasantha Kumar L.,KANNIYAKUMARI,IND,0,10th Pass,3423600,220000,3203600
5163,7037,Vasantheesvaran E.,KANNIYAKUMARI,IND,0,8th Pass,400000,0,400000
5164,7567,Vasanthi.M,TENKASI,AIADMK,0,Post Graduate,24014922,0,24014922
5165,1389,Vasantrao Sukhdev Dandage,BULDHANA,SP,0,Graduate,233640000,0,233640000
5166,7250,Vasave Amit Sheklal,NANDURBAR,BSP,0,12th Pass,51000,0,51000
5167,7378,"Vasigaran, S.A.N. Thiru",SRIPERUMBUDUR,AAP,0,12th Pass,259529,0,259529
5168,6868,Vasuki .U,CHENNAI NORTH,CPI(M),0,Graduate,20187812,3212000,16975812
5169,869,Ved Pal,BHIWANI-MAHENDRAGARH,BSP,6,8th Pass,70084365,4037541,66046824
5170,1347,Ved Prakash,NEW DELHI,IND,0,10th Pass,10478697,0,10478697
5171,2071,Vedparkash Bhartiya,BHIWANI-MAHENDRAGARH,IND,0,10th Pass,3378000,160000,3218000
5172,558,Veena Bharti,KARAKAT,JPS,0,8th Pass,729000,0,729000
5173,2695,Veena Devi,MUNGER,LJP,0,8th Pass,31162836,0,31162836
5174,3882,Veer Shesherao Chokhoba,BEED,IND,0,Graduate,0,0,0
5175,1074,Veerabhadrappa Kabbinad,HAVERI,IND,0,5th Pass,2500,0,2500
5176,7448,Veeramalai.A,TIRUCHIRAPPALLI,IND,0,12th Pass,3356000,0,3356000
5177,1899,Veerendrakumar,PALAKKAD,IND,0,5th Pass,835000,66000,769000
5178,7608,Veilumuthukumar.P,TIRUNELVELI,IND,0,10th Pass,30000,0,30000
5179,4299,Vel.S.K,NAMAKKAL,DMDK,0,Graduate Professional,93414188,20086406,73327782
5180,2453,Velaram,UDAIPUR,AAP,1,Doctorate,10272231,0,10272231
5181,1860,Velayudhan K. P.,KOZHIKODE,BSP,0,10th Pass,3539300,500000,3039300
5182,7133,"Velayutham, C.",PERAMBALUR,IND,0,5th Pass,81000,0,81000
5183,7182,Velchsamy .R,RAMANATHAPURAM,IND,0,8th Pass,2750000,0,2750000
5184,7473,Velladhurai A,SIVAGANGA,Ezhuchi Tamilargal Munnetra Kazhagam,0,8th Pass,2397000,0,2397000
5185,7581,Velladurai.P.,TENKASI,IND,0,Others,788500,80000,708500
5186,5438,Velmurugan A,TIRUVANNAMALAI,IND,0,Others,50000,0,50000
5187,2634,Velu V,BANGALORE NORTH,BSP,1,8th Pass,2100000,0,2100000
5188,6280,"Velu, D.",ARAKKONAM,IND,0,8th Pass,1000000,0,1000000
5189,6261,"Velu, R.",ARAKKONAM,Pattali Makkal Katchi,1,Doctorate,22414897,0,22414897
5190,6279,"Velu, R.",ARAKKONAM,IND,0,10th Pass,251116,0,251116
5191,6281,"Velu, V.",ARAKKONAM,IND,0,12th Pass,797612,0,797612
5192,5682,Velusamy.S,NAMAKKAL,Tamil Nadu Makkal Congress,1,10th Pass,6495000,1930000,4565000
5193,3833,Venkatesan G,DINDIGUL,IND,0,10th Pass,698182,0,698182
5194,7416,Venkatesan S,VILUPPURAM,IND,0,Graduate,210391,0,210391
5195,7415,"Venkatesan, R.",VELLORE,IND,0,10th Pass,330500,0,330500
5196,6869,Venkatesh Babu .T.G,CHENNAI NORTH,AIADMK,0,Post Graduate,37038275,804032,36234243
5197,3773,Venkatesh D T,CHIKKBALLAPUR,IND,0,Post Graduate,2500000,150000,2350000
5198,7607,Venkatesh.A,TIRUNELVELI,IND,0,Post Graduate,933000,280000,653000
5199,7417,Vennila. K,KALLAKURICHI,IND,0,10th Pass,2390900,200000,2190900
5200,7370,Venugopal P.,TIRUVALLUR,IND,0,10th Pass,262854,0,262854
5201,3323,Venugopal Shastri Tumuluri,NANDED,IND,0,Graduate Professional,5810377,180068,5630309
5202,7360,Venugopal. P. Dr.,TIRUVALLUR,AIADMK,0,Graduate Professional,28643502,1768538,26874964
5203,1987,Venus Habib,SOUTH GOA,IND,0,Graduate,4733543,0,4733543
5204,7369,Vetriselvam. K,TIRUVALLUR,IND,0,10th Pass,62000,0,62000
5205,7181,Vetrivel .S,RAMANATHAPURAM,IND,0,Graduate,30000,0,30000
5206,4462,Viajy Bharti,BANKA,Rajnaitik Vikalp Party,0,10th Pass,353558,0,353558
5207,5662,Vichare Rajan Baburao,THANE,SHS,13,10th Pass,102091612,13054217,89037395
5208,7059,"Vigneshwaran, M.",KARUR,IND,0,Graduate Professional,260000,0,260000
5209,3443,Vigyan Modi,JODHPUR,AAP,0,Others,13265789,409622,12856167
5210,5849,Vijay Bhimrao Nikam,JALGAON,IND,0,12th Pass,30500,0,30500
5211,7394,"Vijay Elanchezian, J.",VELLORE,INC,0,Graduate Professional,9800356,0,9800356
5212,4702,Vijay Kant Mishra,DHANBAD,IND,0,12th Pass,560000,0,560000
5213,120,Vijay Kumar,JAMMU,IND,0,8th Pass,520000,50000,470000
5214,1316,Vijay Kumar,NORTH WEST DELHI,RPI(A),0,Graduate,5880000,0,5880000
5215,1246,Vijay Kumar Chourasiya,KODARMA,AAP,1,Graduate,3704548,620968,3083580
5216,4170,Vijay Kumar Hansdak,RAJMAHAL,JMM,1,5th Pass,6863306,0,6863306
5217,4455,Vijay Kumar Mandal,ARARIA,JD(U),1,10th Pass,4326107,0,4326107
5218,3905,Vijay Kumar Patel,MAHASAMUND,IND,0,Post Graduate,3249000,0,3249000
5219,2767,Vijay Kumar Sahni,PATNA SAHIB,IND,0,Graduate,7528500,0,7528500
5220,2913,Vijay Kumar Sen,BHOPAL,CPI(ML) Red Star,1,Graduate,34000,0,34000
5221,2026,Vijay Kumar Sharma,HISAR,IND,0,Post Graduate,2730250,0,2730250
5222,4262,Vijay Kumar Sharma,AKBARPUR,IND,0,Graduate,7799428,1650000,6149428
5223,1667,Vijay Kumar Singh,GHAZIABAD,BJP,2,Doctorate,41137044,2026774,39110270
5224,3636,Vijay Laxman Sarode,PUNE,IND,0,12th Pass,71000,0,71000
5225,1723,Vijay Pal,BULANDSHAHR,Rashtriya Janpriya Party,0,8th Pass,159000,0,159000
5226,2100,Vijay Raj,FARIDABAD,IND,0,Post Graduate,2035329,0,2035329
5227,395,Vijay Ram,NAWADA,Moolniwasi Samaj Party,1,10th Pass,221500,0,221500
5228,981,Vijay Shankar Chaubey,CHANDNI CHOWK,IND,0,12th Pass,2105641,0,2105641
5229,2899,Vijay Singh Kori,BHIND,AIFB,0,10th Pass,403800,0,403800
5230,4994,Vijay Singh Kushwaha,FATEHPUR SIKRI,Sanyukt Samajwadi Dal,0,10th Pass,200000,0,200000
5231,7049,"Vijay, J.",KARUR,IND,0,Graduate Professional,454000,0,454000
5232,1192,Vijaya Kumar,UDUPI CHIKMAGALUR,CPI,0,Others,3085000,215000,2870000
5233,6876,Vijaya Kumar .K,CHENNAI NORTH,Tamil Nadu Makkal Congress,0,12th Pass,3000000,400000,2600000
5234,2439,Vijaya Ray,CHITTORGARH,Rajasthan Vikas Party,0,Graduate,318693,0,318693
5235,7000,Vijayakumar S,ERODE,IND,0,Graduate,1025551,0,1025551
5236,7449,Vijayakumar.P,TIRUCHIRAPPALLI,IND,0,12th Pass,1072802,158660,914142
5237,1908,Vijayan Ambalakkad,ALATHUR,IND,2,10th Pass,825077,0,825077
5238,7098,Vijayan. A.K.S,NAGAPATTINAM,DMK,0,Post Graduate,28140439,3925882,24214557
5239,7243,Vijayanand Shankarrao Shinde,MUMBAI NORTH WEST,Hindusthan Nirman Dal,0,Graduate Professional,3296000,0,3296000
5240,1871,Vijayaraghavan .K,KOZHIKODE,IND,0,8th Pass,2006500,0,2006500
5241,7438,Vijaykumar.Amg,TIRUCHIRAPPALLI,DMDK,0,12th Pass,119179136,17355409,101823727
5242,2446,Vijaypal,BANSWARA,BSP,0,Post Graduate,740000,0,740000
5243,383,Vijeet Kumar,AURANGABAD,IND,0,Graduate,400000,0,400000
5244,3187,Vijendra Singh,RAMPUR,Rashtriya Congress (Babu Jagjivanram),0,Literate,33048000,0,33048000
5245,432,Vikas,HISAR,IND,3,Graduate,473900,0,473900
5246,2192,Vikas Basavantappa Soppin,DHARWAD,IND,0,Graduate Professional,6039592,1379613,4659979
5247,4013,Vikas Chandra Sharma,RANCHI,CPI(ML) Red Star,0,Post Graduate,126000,0,126000
5248,2955,Vikas Sharma,GWALIOR,Bharatiya Navyuvak Party,0,10th Pass,5100000,0,5100000
5249,3397,Vikas Sudam Kusekar,SHIRUR,AIFB,0,Graduate Professional,4055000,125000,3930000
5250,3619,Vikram Ashok Sawale,OSMANABAD,AAP,0,Graduate,50891116,141639,50749477
5251,112,Vikram Usendi,KANKER,BJP,0,10th Pass,23376000,869000,22507000
5252,3703,Vikram Uttam Kasabe,SOLAPUR,IND,0,Post Graduate,99228,0,99228
5253,1570,Vikrant,JABALPUR,IND,0,10th Pass,323500,0,323500
5254,2353,Vimal,SIKAR,Jai Maha Bharath Party,0,Graduate Professional,88000,0,88000
5255,3125,Vimal Kumar,MORADABAD,AAP,0,Graduate,2456083,731000,1725083
5256,4982,Vimla Devi,FARRUKHABAD,IND,0,10th Pass,774907,0,774907
5257,887,Vimla Shoree,BASTAR,CPI,0,Graduate Professional,1520000,200000,1320000
5258,4229,Vimla Umar,BHARATPUR,AITC,0,8th Pass,6579500,730000,5849500
5259,4946,Vinay,ETAH,Bhartiya Shakti Chetna Party,0,Graduate,8558000,0,8558000
5260,1372,Vinay,NORTH EAST DELHI,Bharatiya Sarvodaya Kranti Party,0,12th Pass,4274100,0,4274100
5261,2183,Vinay Kulkarni,DHARWAD,INC,2,12th Pass,111890685,6539376,105351309
5262,3004,Vinay Kumar,SAGAR,Bhartiya Shakti Chetna Party,0,12th Pass,913873,44000,869873
5263,1571,Vinay Kumar Jain,JABALPUR,IND,0,10th Pass,32198461,1637760,30560701
5264,5700,Vinayagamoorthi T,SALEM,BSP,0,10th Pass,197000,0,197000
5265,3642,Vinayak Bhaurao Raut,RATNAGIRI SINDHUDURG,SHS,5,Post Graduate,44568629,2370842,42197787
5266,3789,Vinayaka Prasad.H.N,KOLAR,IND,0,12th Pass,110000,0,110000
5267,1926,Vincent,CHALAKUDY,IND,0,10th Pass,4618200,1200000,3418200
5268,538,Vincent H. Pala,SHILLONG,INC,0,Graduate Professional,497108058,0,497108058
5269,4955,Vineet Kumar,ETAWAH,Ambedkar Samaj Party,0,Post Graduate,1328000,0,1328000
5270,929,Vinod Ankush Nannaware,GADCHIROLI-CHIMUR,SP,0,10th Pass,1969000,520000,1449000
5271,5663,Vinod Deepchand Gangwal,THANE,IND,1,Graduate Professional,27667168,1922750,25744418
5272,1492,Vinod Dinanath Meshram,CHANDRAPUR,IND,0,Not Given,0,0,0
5273,3645,Vinod Hanumantrao Sawant,RATNAGIRI SINDHUDURG,Akhil Bharat Hindu Mahasabha,0,10th Pass,28610000,0,28610000
5274,1526,Vinod Kumar,SATNA,Bhartiya Shramik Dal Socialist,0,10th Pass,260000,0,260000
5275,2309,Vinod Kumar Baghel,ALIGARH,Rashtriya Samaj Paksha,0,12th Pass,30000,0,30000
5276,4781,Vinod Kumar Bhagwan Birade,KHANDWA,RPI(A),0,Graduate,25000,0,25000
5277,4913,Vinod Kumar Singh,AGRA,IND,0,Post Graduate,126000,0,126000
5278,3141,Vinod Kumar Tejyan,NAGINA,Bahujan Mukti Party,2,Post Graduate,21180272,3200000,17980272
5279,1693,Vinod Kumar Tyagi,GHAZIABAD,IND,1,Post Graduate,41416138,0,41416138
5280,1263,Vinod Ram,PALAMAU,IND,0,12th Pass,1526001,0,1526001
5281,7074,Vinothkumar.P,KRISHNAGIRI,IND,0,12th Pass,478000,0,478000
5282,7557,Vinston Anto. S,THOOTHUKKUDI,IND,0,10th Pass,668734,0,668734
5283,3104,Vipnesh,KHERI,CPI,0,Graduate Professional,207911,0,207911
5284,5244,Viren Das,BHAGALPUR,Sankhyanupati Bhagidari Party,0,Literate,3010500,0,3010500
5285,1302,Virender Mohan Vats,WEST DELHI,IND,0,Graduate,910714,300000,610714
5286,4134,Virendra Kumar Dahariya,RAIPUR,BSP,0,10th Pass,4612000,100000,4512000
5287,1572,Virendra Kumar Sharma,JABALPUR,IND,0,Graduate,380000,0,380000
5288,1361,Virendra Mayer,EAST DELHI,Samajwadi Janata Party (Rashtriya),0,Graduate,231000,0,231000
5289,3074,Virendra Pal Gupta,BADAUN,Rashtravadi Janata Party,0,8th Pass,785000,350000,435000
5290,7253,Virendra Ravaji Valvi,NANDURBAR,AAP,0,Graduate,470995,0,470995
5291,1618,Virendra Singh,MUZAFFARNAGAR,SP,2,Post Graduate,293622871,466848,293156023
5292,4221,Virendra Vidrohi,ALWAR,AAP,0,Doctorate,1178758,376527,802231
5293,7073,Virginiya Benatin Franciles,KRISHNAGIRI,IND,0,8th Pass,2545000,900000,1645000
5294,4220,Virja Nand,ALWAR,SP,0,Graduate,5255484,0,5255484
5295,1473,Vishal Arvind Bhoyar,BHANDARA-GONDIYA,IND,0,Post Graduate,124600,0,124600
5296,5665,Vishal Dinkar Salve,THANE,IND,0,Post Graduate,5272000,200000,5072000
5297,1322,Vishal Khosla,NEW DELHI,IND,0,12th Pass,489000,0,489000
5298,477,Visheshwar Prasad,KODARMA,BSP,0,8th Pass,4850000,1800000,3050000
5299,416,Vishnu Bhagwan,KURUKSHETRA,IND,1,Graduate Professional,1946070,379840,1566230
5300,488,Vishnu Dayal Ram,PALAMAU,BJP,0,Graduate,24753886,0,24753886
5301,455,Vishnu Dutt,ROHTAK,IND,0,10th Pass,1166047,80000,1086047
5302,428,Vishnu Kumar,HISAR,IND,0,Graduate Professional,31000,0,31000
5303,103,Vishnudev Sai,RAIGARH,BJP,0,10th Pass,21576220,1819686,19756534
5304,160,Vishun Chaudhary,JAMUI,SHS,0,8th Pass,190000,0,190000
5305,1539,Vishv Nath Dwivedi,REWA,IND,0,12th Pass,156000,0,156000
5306,5554,Vishwadeep Singh,FIROZABAD,BSP,0,Post Graduate,48629198,438000,48191198
5307,2714,Vishwajit Kumar,NALANDA,IND,0,12th Pass,3409263,0,3409263
5308,1115,Vishwanath Gotuji Jamnekar,AMRAVATI,IND,0,Graduate Professional,620000,0,620000
5309,4684,Vishwaratan Sinha,DURG,AAP,0,Post Graduate,13759160,994273,12764887
5310,2992,Visnu Sharma,MORENA,AITC,0,10th Pass,800000,0,800000
5311,7007,Viswanathan P,KANCHEEPURAM,INC,0,Graduate,15447693,1770204,13677489
5312,7132,"Viswanathan, A.",PERAMBALUR,IND,0,10th Pass,863000,0,863000
5313,6278,"Viswanathan, P.",ARAKKONAM,IND,0,8th Pass,347702,0,347702
5314,5865,Vitthal Sahebrao Shelke,JALNA,Ambedkarite Party of India,0,Post Graduate,0,0,0
5315,1584,Vivek Mishra (Lalu Bhaiya),BALAGHAT,Jai Maha Bharath Party,0,Graduate,245500,0,245500
5316,1973,Vivekanandan,ATTINGAL,IND,0,8th Pass,4652,0,4652
5317,753,Vivekkrishna Tankha,JABALPUR,INC,0,Graduate Professional,423720471,2277000,421443471
5318,7511,"Voltaire, M.J.",THENI,SUCI(C),0,Post Graduate,96887,0,96887
5319,4312,Vrahma Saran Jatav,FARRUKHABAD,IND,1,12th Pass,1359047,0,1359047
5320,4671,Vrinda Ganda,JANJGIR-CHAMPA,IND,0,Illiterate,2218300,0,2218300
5321,1470,Wadhave Damodhar Natthu,BHANDARA-GONDIYA,IND,0,10th Pass,5790000,40000,5750000
5322,3587,Wadje Panjab Shrihari,NANDED,IND,7,Graduate,65425728,17401655,48024073
5323,3682,Wagh Gangadhar Radhaji,SHIRDI,IND,0,10th Pass,1986175,0,1986175
5324,5825,Waghere Hemant Motiram,DINDORI,CPI(M),3,Graduate,830380,464940,365440
5325,3696,Waghmare Pundalik Onkari,SOLAPUR,Bahujan Mukti Party,0,10th Pass,1016000,0,1016000
5326,3394,Waghmare Sarjerao Bhika,SHIRUR,BSP,0,12th Pass,1671548,0,1671548
5327,3585,Walke Vikram Vasudeo,MADHA,IND,1,5th Pass,911000,0,911000
5328,3913,Wamanrao Bagde,RAJNANDGAON,IND,0,10th Pass,16495585,0,16495585
5329,5601,Wamanrao Madhav Sasane,RAVER,Bahujan Mukti Party,0,12th Pass,117571244,1400000,116171244
5330,5977,Wanaga Chintaman Navasha,PALGHAR,BJP,0,Graduate Professional,5809644,401000,5408644
5331,876,Wangman Lowangcha,ARUNACHAL EAST,PPA,0,Graduate,46162501,0,46162501
5332,5859,Wankhede Sharadchandra Ganapatrao,JALNA,BSP,1,Post Graduate,28995248,950000,28045248
5333,3526,Wankhede Subhash,HINGOLI,IND,0,5th Pass,1030500,0,1030500
5334,3512,Wankhede Subhash Bapurao,HINGOLI,SHS,1,10th Pass,11343000,3541000,7802000
5335,3516,Wankhede Subhash Nagorao,HINGOLI,JD(U),1,5th Pass,1776500,100000,1676500
5336,3378,Ware Subhash Shankarrao,PUNE,AAP,2,Graduate Professional,4586646,0,4586646
5337,4430,Wazed Ali Choudhury,DHUBRI,INC,0,Graduate,23983914,6220000,17763914
5338,2257,Wazid Reja Osmani,SILCHAR,AITC,0,Doctorate,7384788,0,7384788
5339,7038,Wilson I.,KANNIYAKUMARI,IND,0,12th Pass,26000,0,26000
5340,3948,Y.Larance,TIRUCHIRAPPALLI,IND,0,Graduate,3197000,250000,2947000
5341,4628,Yaasmin Beg,RAIPUR,IND,0,10th Pass,200500,0,200500
5342,3634,Yadav Gangadhar Nathu,PUNE,IND,0,Post Graduate,358000,0,358000
5343,5900,Yadav Kamlesh Shobhnath,MUMBAI NORTH,SP,4,10th Pass,13642568,0,13642568
5344,2623,Yakub Shariff,CHIKKBALLAPUR,Bahujan Mukti Party,0,Post Graduate,1173400,200000,973400
5345,1060,Yamanur Kamble,BAGALKOT,BSP,1,Post Graduate,5034259,0,5034259
5346,573,Yashpal Sharma,JAMMU,JKPDP,0,Graduate Professional,7743691,0,7743691
5347,2837,Yashpal Yadav,HAZARIBAGH,IND,0,5th Pass,7731500,0,7731500
5348,3541,Yashwant Balkrushna Joshi,KOLHAPUR,IND,0,10th Pass,2638600,229000,2409600
5349,5998,Yashwant Jayram Gaikwad,RAIGAD,BSP,0,10th Pass,5557874,0,5557874
5350,2428,Yashwant Puri,CHITTORGARH,IND,0,Graduate Professional,1906246,0,1906246
5351,3139,Yashwant Singh,NAGINA,BJP,0,Post Graduate,34806740,0,34806740
5352,2154,Yeshwanthrao,BIDAR,Bharatiya Peoples Party,0,Post Graduate,3236000,120000,3116000
5353,6899,Yogaraj. S,CHENNAI NORTH,IND,0,Graduate Professional,13105000,30000,13075000
5354,647,Yogender Ram,KODARMA,Akhil Bharatiya Jan Sangh,0,10th Pass,4765000,500000,4265000
5355,3055,Yogendra Kumar,AONLA,Akhil Bharat Hindu Mahasabha,1,10th Pass,234800,0,234800
5356,2717,Yogendra Prasad,NALANDA,Bharatiya Inqalab Party,0,12th Pass,5874500,25000,5849500
5357,459,Yogendra Singh Yadav,GURGAON,AAP,0,Post Graduate,29709151,1387505,28321646
5358,856,Yogesh,BANGALORE SOUTH,IND,0,10th Pass,25000,0,25000
5359,5058,Yogesh Kumar,MATHURA,BSP,2,Graduate,15890007,1873951,14016056
5360,224,Yogesh Kumar,SAHARANPUR,AAP,4,Graduate,55998531,183016,55815515
5361,1556,Yogesh Kumar Singh Ad.,SHAHDOL,SP,0,Graduate Professional,1251141,1820,1249321
5362,5181,Yogesh Motiram Kathore,BHIWANDI,Bharipa Bahujan Mahasangh,0,8th Pass,1440000,110000,1330000
5363,762,Yogesh Nanaji Samrite,BALAGHAT,BSP,1,Post Graduate,5250000,0,5250000
5364,4872,Yousub Ali Ahmed,DHUBRI,SP,0,12th Pass,6469882,80000,6389882
5365,2021,Yudhvir,HISAR,IND,0,10th Pass,675000,0,675000
5366,4010,Yugeshwar Marar Deen,RANCHI,Manav Mukti Morcha,1,Graduate Professional,7735000,0,7735000
5367,1655,Yunush,BAGHPAT,Navbharat Nirman Party,0,Literate,4810000,0,4810000
5368,7359,Yuvaraj.V,TIRUVALLUR,DMDK,1,10th Pass,79725701,30105940,49619761
5369,3498,Yuvraj Shivaji Kamble,HATKANANGLE,IND,0,8th Pass,975000,0,975000
5370,679,Zafar Alam,ALIGARH,SP,0,Graduate Professional,331958000,2362000,329596000
5371,3110,Zafar Ali Naqvi,KHERI,INC,0,Graduate Professional,4699334,0,4699334
5372,5616,Zagadya Purmya Pawara,RAVER,IND,1,Literate,287800,0,287800
5373,188,Zaheeda Shereen,BANGALORE CENTRAL,SUCI(C),0,Graduate Professional,587593,0,587593
5374,461,Zakir Hussain,GURGAON,INLD,0,Graduate Professional,81039887,789903,80249984
5375,2228,Zakir Hussain,UDUPI CHIKMAGALUR,BSP,0,5th Pass,1309472,45000,1264472
5376,4853,Zameerul Hasan,RAIGANJ,AIUDF,0,Graduate,8696996,14900000,-6203004
5377,2544,Zanzad Shalikram Shankarrao,BHANDARA-GONDIYA,IND,0,8th Pass,1140019,0,1140019
5378,4869,Zesmina Khatun,DHUBRI,AITC,0,12th Pass,390500,0,390500
5379,4786,Ziauddin Inamdar,KHANDWA,Bahujan Mukti Party,2,10th Pass,1698000,800000,898000
5380,720,Zulfikal Ali A A,ERNAKULAM,SDPI,4,Others,557800,0,557800
