Sno,Candidate,Constituency,Party,Criminal Case,Education,Total Assets,Liabilities,Net Assets
898,Naveen Jindal,KURUKSHETRA,INC,2,Post Graduate,3083154000,49114000,3034040000
745,Malook Nagar,BIJNOR,BSP,0,Graduate,2896200000,33733000,2862467000
605,Kamal Nath,CHHINDWARA,INC,0,Graduate,2069080434,51172087,2017908347
972,Patel Praful Manoharbhai,BHANDARA-GONDIYA,NCP,0,Graduate,1959685779,40000000,1919685779
720,M. Shahid,MEERUT,BSP,0,5th Pass,1989984945,103807610,1886177335
832,Moni Kumar Subba,TEZPUR,IND,2,8th Pass,3067535137,1400740132,1666795005
315,Denis Siangshai,SHILLONG,IND,0,Graduate,1287025457,0,1287025457
616,Kapil Sibal,CHANDNI CHOWK,INC,0,Graduate Professional,1144747216,0,1144747216
1334,Shruti Choudhry,BHIWANI-MAHENDRAGARH,INC,0,Graduate Professional,1083115000,106873000,976242000
665,Kuldeep Bishnoi,HISAR,Haryana Janhit Congress (BL),1,Graduate,786595116,104464405,682130711
43,Adv. Jawahar Leonardo Dias,SOUTH GOA,Goemcarancho Otrec Astro,1,Post Graduate,564223740,484000,563739740
168,Ashwini Kumar,KARNAL,BJP,6,Graduate,698638135,153937858,544700277
483,Hemendra Chandra Singh,KANDHAMAL,BJD,2,Graduate,503907437,4786551,499120886
1528,Vincent H. Pala,SHILLONG,INC,0,Graduate Professional,497108058,0,497108058
739,Mahesh Sharma,GAUTAM BUDHHA NAGAR,BJP,0,Graduate Professional,473797545,40905738,432891807
1551,Vivekkrishna Tankha,JABALPUR,INC,0,Graduate Professional,423720471,2277000,421443471
1491,Upendra Ravidas,JAMUI,JMM,0,10th Pass,421280000,0,421280000
1269,Satish Kumar,GAUTAM BUDHHA NAGAR,BSP,1,12th Pass,599501967,201428322,398073645
792,Meira Kumar,SASARAM,INC,0,Post Graduate,384751309,0,384751309
727,Mahabal Mishra,WEST DELHI,INC,1,12th Pass,388226286,8691614,379534672
1352,Smt. Meenakshi Lekhi,NEW DELHI,BJP,0,Graduate Professional,349916470,3275562,346640908
1192,Robert Romawia Royte,MIZORAM,IND,0,Post Graduate,346499910,0,346499910
1351,Smt. Kirron Kher,CHANDIGARH,BJP,0,Post Graduate,335343871,1886187,333457684
623,Kartar Singh Bhadana,KAIRANA,RLD,1,8th Pass,334053064,2555000,331498064
1563,Zafar Alam,ALIGARH,SP,0,Graduate Professional,331958000,2362000,329596000
314,Deepender Singh,ROHTAK,INC,0,Post Graduate,358749354,39310300,319439054
902,Neiphiu Rio,NAGALAND,NPF,0,Graduate,315834264,0,315834264
903,Nikhil Kumar,AURANGABAD,INC,0,Post Graduate,297302441,0,297302441
1538,Virendra Singh,MUZAFFARNAGAR,SP,2,Post Graduate,293622871,466848,293156023
396,Dushyant Chautala,HISAR,INLD,0,Graduate,361326990,68744460,292582530
654,Krishan Pal,FARIDABAD,BJP,0,Graduate Professional,296440144,19707475,276732669
1139,Rameshwar Oraon,LOHARDAGA,INC,0,Doctorate,262697987,0,262697987
1315,Shazia Ilmi Malik,GHAZIABAD,AAP,1,Post Graduate,303342609,41846167,261496442
1012,Prashant Chaudhary,BAGHPAT,BSP,0,Post Graduate,258289957,3950000,254339957
495,Inderjit Singh,GURGAON,BJP,0,Graduate Professional,250698763,0,250698763
1306,Shamsher Singh Kharkara,ROHTAK,INLD,0,Post Graduate,242943888,0,242943888
69,Ajay Arjun Singh,SATNA,INC,2,Post Graduate,254876883,13845072,241031811
149,Ashok Bhardwaj,GURGAON,National Janhit Congress (AB),0,Graduate Professional,239374641,3790167,235584474
525,Jai Singh,SONIPAT,AAP,0,Post Graduate,246912638,12140161,234772477
1502,Vasantrao Sukhdev Dandage,BULDHANA,SP,0,Graduate,233640000,0,233640000
609,Kamini Kaur,NORTH WEST DELHI,IND,0,8th Pass,233096000,0,233096000
383,Dr. Shashi Tharoor,THIRUVANANTHAPURAM,INC,0,Doctorate,230275186,0,230275186
546,Jaya Prada Nahata,BIJNOR,RLD,0,12th Pass,226399859,3931582,222468277
790,Meghe Sagar Dattatraya,WARDHA,INC,0,Graduate,340138817,118145553,221993264
1033,Purno Agitok Sangma,TURA,NPP,0,Post Graduate,215134618,0,215134618
954,Pankaj Agarwal,MUZAFFARNAGAR,INC,0,Graduate,242260053,27148000,215112053
112,Anitha Prathap,ERNAKULAM,AAP,0,Graduate Professional,203330000,0,203330000
113,Anjali Anish Damania,NAGPUR,AAP,0,Graduate Professional,193161591,1399670,191761921
454,Gunwant Sudamrao Devpare,AMRAVATI,BSP,0,Others,209390631,23488366,185902265
579,K P Sankaran Menon,NEW DELHI,IND,0,Doctorate,182208649,0,182208649
1390,Sudhan Kumar,GHAZIABAD,SP,0,Graduate,180682500,0,180682500
1056,Raj Babbar,GHAZIABAD,INC,1,12th Pass,197233950,22896345,174337605
186,Bahadur Singh,BHIWANI-MAHENDRAGARH,INLD,0,5th Pass,182580199,8699200,173880999
1420,Sunil Kumar Singh,CHATRA,BJP,0,Post Graduate,174744806,950052,173794754
1136,Ramesh Kumar,SOUTH DELHI,INC,0,10th Pass,172314296,0,172314296
77,Ajit Singh,BAGHPAT,RLD,0,Post Graduate,169254660,0,169254660
773,Manoj Tiwari,NORTH EAST DELHI,BJP,0,Post Graduate,199483924,34645630,164838294
577,K M Noordeen,CHALAKUDY,AAP,0,Graduate,158604311,0,158604311
1,Kaushal Yadav,NAWADA,JD(U),8,Post Graduate,154566136,2604969,151961167
1234,Sanjay Gandhi,CHANDNI CHOWK,Braj Vikas Party,0,12th Pass,151747504,0,151747504
843,Mukul Upadhyay,GHAZIABAD,BSP,0,10th Pass,167355710,18751971,148603739
1131,Ramesh Bidhuri,SOUTH DELHI,BJP,4,Graduate Professional,147493056,0,147493056
1135,Ramesh Kaushik,SONIPAT,BJP,0,Graduate Professional,142840716,0,142840716
412,Gadkari Nitin Jairam,NAGPUR,BJP,4,Graduate Professional,153704475,19004037,134700438
1040,R K Anand,FARIDABAD,INLD,0,Graduate Professional,149352852,15495731,133857121
1479,Uday Pratap Singh,HOSHANGABAD,BJP,1,Graduate,133375092,3775714,129599378
451,Gulkirat Kaur Panag,CHANDIGARH,AAP,0,Post Graduate,129508000,2164000,127344000
307,Dayanand G. Narvekar,NORTH GOA,IND,2,Graduate Professional,184306689,62952534,121354155
1441,Sushil Kumar Singh,AURANGABAD,BJP,5,Post Graduate,127845854,7321626,120524228
833,Morarji Nagma Arvind,MEERUT,INC,0,Graduate,117912089,2978643,114933446
880,Narendra Sharma,NORTH EAST DELHI,SUCI(C),0,Post Graduate,112772737,0,112772737
178,Avtar Singh Bhadana,FARIDABAD,INC,1,8th Pass,112529244,0,112529244
596,Kadir Rana,MUZAFFARNAGAR,BSP,5,Literate,135202262,24105110,111097152
1093,Rajkumar Saini,KURUKSHETRA,BJP,0,Graduate,132880476,23262108,109618368
1287,Seshraj,SAHARANPUR,IND,0,Others,106068354,0,106068354
1457,Takam Sanjoy,ARUNACHAL WEST,INC,0,Graduate,105915042,0,105915042
779,Maratha Virender Verma,KARNAL,BSP,0,Graduate Professional,96600000,0,96600000
474,Harihara Karana,KANDHAMAL,INC,0,Post Graduate,96350411,269368,96081043
1296,Shahnawaj Rana,BIJNOR,SP,11,Graduate Professional,145562257,54311908,91250349
908,Ninong Ering,ARUNACHAL EAST,INC,0,Graduate,88065000,0,88065000
1158,Ranee Narah,LAKHIMPUR,INC,0,Graduate,88519819,1118242,87401577
260,Chandrabhan Singh Choudhary,CHHINDWARA,BJP,0,Graduate Professional,88884662,2258313,86626349
859,Nagmani,CHATRA,AJSUP,1,12th Pass,85515758,0,85515758
521,Jai Prakash Agarwal,NORTH EAST DELHI,INC,0,Graduate,83974848,0,83974848
1459,Tapir Gao,ARUNACHAL EAST,BJP,0,Post Graduate,82370000,300000,82070000
1069,Rajballabh Prasad,NAWADA,RJD,3,10th Pass,83137973,1387290,81750683
969,Parvesh Sahib Singh,WEST DELHI,BJP,1,Post Graduate,107235461,26650000,80585461
1564,Zakir Hussain,GURGAON,INLD,0,Graduate Professional,81039887,789903,80249984
476,Hariprasad Dihingia,LAKHIMPUR,AGP,2,10th Pass,80659606,1997168,78662438
1177,Ravi Naik,NORTH GOA,INC,0,Post Graduate,81066000,3126000,77940000
976,Pawan Kumar Bansal,CHANDIGARH,INC,0,Graduate Professional,77478000,0,77478000
285,Churchill Alemao,SOUTH GOA,AITC,3,Others,149868252,72589679,77278573
339,Dharampal Yadav,GURGAON,INC,0,Graduate,76792493,0,76792493
1445,Sushmita Dev,SILCHAR,INC,1,Post Graduate,87495844,12008613,75487231
635,Khem Lal Bansal,CHANDIGARH,Inqalab Vikas Dal,0,10th Pass,76108195,900000,75208195
1314,Shashi Saini,KARNAL,IND,0,Post Graduate,73585000,0,73585000
164,Ashutosh,CHANDNI CHOWK,AAP,3,Post Graduate,81121758,11140787,69980971
267,Chattar Singh,KURUKSHETRA,BSP,0,Graduate Professional,72970569,3500000,69470569
356,Dillip Kumar Tirkey,SUNDARGARH,BJD,0,Graduate,70158593,831924,69326669
129,Arka Keshari Deo,KALAHANDI,BJD,0,Graduate,69822063,831688,68990375
1319,Shibun Lyngdoh,SHILLONG,BJP,0,Graduate,75894099,7061466,68832633
518,Jagdish Singh Rana,SAHARANPUR,BSP,0,Graduate,72148732,4290563,67858169
512,Jagbir Singh Malik,SONIPAT,INC,0,Graduate Professional,69917201,2154569,67762632
352,Digvijay Singh,JABALPUR,Bhartiya Shakti Chetna Party,0,Post Graduate,67620000,0,67620000
382,Dr. Satyapal Singh,BAGHPAT,BJP,0,Doctorate,67402076,352000,67050076
1503,Ved Pal,BHIWANI-MAHENDRAGARH,BSP,6,8th Pass,70084365,4037541,66046824
1227,Sandeep Dikshit,EAST DELHI,INC,0,Post Graduate,73671067,8872174,64798893
722,M.Lalmanzuala,MIZORAM,AAP,0,Graduate,63800000,0,63800000
599,Kalikesh Narayan Singh Deo,BOLANGIR,BJD,3,Graduate,87955818,24410449,63545369
378,Dr. Rahul Dipankar,BULANDSHAHR,AAP,0,Post Graduate,74254557,10800000,63454557
181,Baadshah,ALIGARH,PECP,0,8th Pass,62260000,500000,61760000
1133,Ramesh Chand Tomar,GAUTAM BUDHHA NAGAR,INC,4,Doctorate,61617189,0,61617189
162,Ashok Tanwar,SIRSA,INC,1,Doctorate,72777188,11222039,61555149
72,Ajay Makan,NEW DELHI,INC,1,Post Graduate,61098675,500000,60598675
497,Indrajeet Kumar,SIDHI,INC,0,Graduate,62690091,2494561,60195530
613,Kanti Singh,KARAKAT,RJD,4,Graduate,60390021,337826,60052195
279,Chittoor Rajamannar,IDUKKI,IND,0,Post Graduate,60222146,1365374,58856772
1231,Sangeeta Kumari Singh Deo,BOLANGIR,BJP,3,Graduate,62357000,3817340,58539660
517,Jagdish Singh,SATNA,AAP,2,Graduate,58152000,630000,57522000
658,Krishna Tirath,NORTH WEST DELHI,INC,0,Graduate,56882796,0,56882796
1240,Sanjay Meshack,ANDAMAN & NICOBAR ISLANDS,AAP,0,10th Pass,57497526,633088,56864438
90,Amarnath Pradhan,SAMBALPUR,INC,0,Post Graduate,56069048,0,56069048
508,Jag Mohan Singh Bakshi,CHANDNI CHOWK,Atulya Bharat Party,0,12th Pass,60404560,4500000,55904560
1558,Yogesh Kumar,SAHARANPUR,AAP,4,Graduate,55998531,183016,55815515
343,Dharmender,GAUTAM BUDHHA NAGAR,Dharam Nirpeksh Dal,0,8th Pass,55813000,0,55813000
619,Karan Singh,GURGAON,IND,0,Graduate,58279661,2735214,55544447
917,Noble Mathew,KOTTAYAM,IND,0,Post Graduate,55079708,50000,55029708
450,Gulab Singh,SONIPAT,POORVANCHAL RASHTRIYA CONGRESS,0,Graduate,53952000,0,53952000
1474,U K Choudhary (Munna Bhaiya),BALAGHAT,AAP,0,Post Graduate,54742608,1000000,53742608
673,Kuldeep Singh,KURUKSHETRA,RPI,0,10th Pass,53708428,0,53708428
875,Narendra Bhati,GAUTAM BUDHHA NAGAR,SP,0,12th Pass,53617561,0,53617561
425,Gawali Bhavana Pundlikrao,YAVATMAL-WASHIM,SHS,4,Graduate,60886040,7368967,53517073
499,Innocent,CHALAKUDY,IND,0,8th Pass,54474761,1303000,53171761
190,Balabhadra Majhi,NABARANGPUR,BJD,0,Graduate,52977088,705404,52271684
317,Deoraj Singh Patel,REWA,BSP,0,Post Graduate,70149663,17924260,52225403
513,Jagbir Singh Rana,KARNAL,IND,0,Post Graduate,54297291,2759783,51537508
1268,Satish Kumar,ALIGARH,BJP,1,10th Pass,52180006,754800,51425206
437,Giriraj Singh,NAWADA,BJP,1,Graduate,50054771,0,50054771
1223,Sampat Singh,HISAR,INC,0,Post Graduate,62661560,14371778,48289782
1094,Rajmohan Gandhi,EAST DELHI,AAP,0,Post Graduate,48208736,0,48208736
105,Anil Kumar,BAGHPAT,PECP,4,12th Pass,55427000,7522794,47904206
295,Daitary Pradhan,KALAHANDI,Aama Odisha Party,2,Post Graduate,47792839,367818,47425021
946,Paban Singh Ghatowar,DIBRUGARH,INC,0,Graduate,49229437,2547986,46681451
127,Arjun Singh Thakur,BASTAR,Ambedkarite Party of India,0,Post Graduate,46885000,250000,46635000
662,Krupal Balaji Tumane,RAMTEK,SHS,1,Graduate,46564362,216000,46348362
1553,Wangman Lowangcha,ARUNACHAL EAST,PPA,0,Graduate,46162501,0,46162501
1166,Ratan Singh,SAHARANPUR,Bahujan Mukti Party,0,Others,46134617,0,46134617
878,Narendra Kr Pandey,CHANDNI CHOWK,BSP,0,12th Pass,48980150,3166282,45813868
334,Dharambir,BHIWANI-MAHENDRAGARH,BJP,0,Graduate,50057200,4530000,45527200
492,Imran Masood,SAHARANPUR,INC,5,12th Pass,47166093,2012262,45153831
1482,Udit Raj,NORTH WEST DELHI,BJP,1,Doctorate,44902363,0,44902363
1410,Sunder Lal Tiwari,REWA,INC,0,Graduate Professional,45035366,349790,44685576
944,P.Kumarankutty,VADAKARA,IND,0,Graduate Professional,44347759,0,44347759
778,Manzoor Thengana,PATHANAMTHITTA,SDPI,1,Others,43900000,0,43900000
544,Jaswinder Singh,KARNAL,INLD,0,10th Pass,46436884,2562000,43874884
232,Bijoy Krishna Handique,JORHAT,INC,0,Post Graduate,43378685,0,43378685
1253,Sarat Pattnayak,BOLANGIR,INC,0,Graduate Professional,43999656,818572,43181084
1004,Pradipta Kumar Naik,KALAHANDI,BJP,0,Graduate Professional,42970197,0,42970197
409,Fauji Jai Kawar Tyagi Dixit,GURGAON,IND,0,8th Pass,42915552,0,42915552
319,Deotale Sanjay Wamanrao,CHANDRAPUR,INC,0,Graduate Professional,45464118,3496308,41967810
1130,Ramesh,SONIPAT,IND,0,Graduate Professional,42376491,425241,41951250
351,Dhotre Sanjay Shyamrao,AKOLA,BJP,3,Graduate Professional,48501735,6928458,41573277
1533,Vinod Kumar Tyagi,GHAZIABAD,IND,1,Post Graduate,41416138,0,41416138
872,Nar Bahadur Khatiwara,SIKKIM,BJP,0,Graduate Professional,41384503,0,41384503
1173,Rattan Lal Kataria,AMBALA,BJP,0,Post Graduate,42150634,843229,41307405
740,Mahesh Singh Yadav,CHATRA,JD(U),0,Graduate,44079939,3281756,40798183
1014,Prashant Shyamsundar Mishra,BHANDARA-GONDIYA,AAP,0,Post Graduate,41306880,559171,40747709
1081,Rajes Nandini Singh - Dalvir,SHAHDOL,INC,0,Graduate,41389440,645000,40744440
752,Mandheer Singh Maan,FARIDABAD,IND,0,10th Pass,40072745,0,40072745
1335,Shushila,FARIDABAD,IND,0,10th Pass,40072745,0,40072745
1378,Srilokanath Ratha,ASKA,INC,0,Post Graduate,39978228,0,39978228
836,Muhammed Hamdullah Sayeed,LAKSHADWEEP,INC,0,Graduate Professional,40192946,358156,39834790
1391,Sudhanshu Suman,CHATRA,IND,0,Post Graduate,41861206,2258169,39603037
1021,Prechard B. M. Basaiawmoit,SHILLONG,IND,0,12th Pass,39194012,0,39194012
1220,Salil Saha,TRIPURA WEST,AAP,0,Post Graduate,41153192,1973987,39179205
1515,Vijay Kumar Singh,GHAZIABAD,BJP,2,Doctorate,41137044,2026774,39110270
882,Naresh Batra,HISAR,IND,0,10th Pass,38729000,0,38729000
506,J Sudhakaran,THIRUVANANTHAPURAM,BSP,0,Post Graduate,40695000,2000000,38695000
390,Dr.Rajendra Ramkrishna Gawai,AMRAVATI,RPI,0,Graduate Professional,38261507,0,38261507
816,Mohd Shahid Siddiqui,EAST DELHI,AITC,0,12th Pass,40044000,2010000,38034000
193,Balbir Singh Saini,KURUKSHETRA,INLD,0,Graduate,42261869,4284205,37977664
498,Ingle Krushanarao Ganpatrao,BULDHANA,NCP,0,Graduate,63065868,25092634,37973234
419,Ganesh Singh,SATNA,BJP,2,Post Graduate,37800000,0,37800000
1464,Tek Nath Dhakal,SIKKIM,Sikkim Krantikari Morcha,0,Post Graduate,37669202,0,37669202
614,Kanwar Hasan,KAIRANA,BSP,0,Post Graduate,37686620,245671,37440949
622,Kartar Singh,HISAR,IND,0,Graduate,36950500,0,36950500
1333,Shripad Yesso Naik,NORTH GOA,BJP,0,Graduate,37019154,837843,36181311
602,Kamal Chand Arya,FARIDABAD,Bahujan Mukti Party,0,Graduate Professional,36090683,0,36090683
367,Dr. Arvind Kumar Singh,ALIGARH,BSP,0,Doctorate,41664986,6100000,35564986
1082,Rajesh,GURGAON,IND,0,10th Pass,36429409,880000,35549409
275,Chhedi Paswan,SASARAM,BJP,0,Post Graduate,35776803,275000,35501803
1046,Raghav Lakhanpal,SAHARANPUR,BJP,0,Post Graduate,35406431,0,35406431
241,Biren Singh Engti,AUTONOMOUS DISTRICT,INC,0,Post Graduate,35367390,0,35367390
507,Jadhav Prataprao Ganpatrao,BULDHANA,SHS,2,12th Pass,36033147,684092,35349055
746,Mam Chand,KARNAL,CPI,0,Illiterate,37120000,2100000,35020000
1293,Shahid Manzoor,MEERUT,SP,0,Post Graduate,34814614,231000,34583614
93,Ambedkar Prakash Yashwant,AKOLA,Bharipa Bahujan Mahasangh,3,Graduate Professional,35716840,1400000,34316840
212,Bennet Abraham,THIRUVANANTHAPURAM,CPI,1,Post Graduate,34112353,0,34112353
920,O V Sreedath,THIRUVANANTHAPURAM,Socialist Republican Party,4,Graduate,33965814,0,33965814
120,Anubha Munjare,BALAGHAT,SP,5,Post Graduate,36108915,2167687,33941228
137,Arunoday Saha,TRIPURA WEST,INC,0,Doctorate,33892463,0,33892463
76,Ajit Joy,THIRUVANANTHAPURAM,AAP,0,Post Graduate,37145768,3500000,33645768
728,Mahabali Singh,KARAKAT,JD(U),5,8th Pass,33437255,0,33437255
1191,Riti Pathak,SIDHI,BJP,0,Graduate Professional,33416561,0,33416561
245,Biswajit Ranjit Chatterjee,NEW DELHI,AITC,0,12th Pass,33350000,0,33350000
1403,Sukhbir Singh,SONIPAT,IND,0,Post Graduate,35860077,2625000,33235077
845,Mul Chand,GURGAON,IND,0,10th Pass,33392000,750000,32642000
1320,Shilvin Kottackakathu,PATHANAMTHITTA,IND,0,Others,33956316,1491421,32464895
1022,Prem Das Rai,SIKKIM,SDF,0,Post Graduate,32389223,0,32389223
1171,Rathod Mohan Mallu,YAVATMAL-WASHIM,Bharip Bahujan Mahasangh,0,Post Graduate,34013105,1750000,32263105
1078,Rajendra Kumar Mund,KALAHANDI,IND,0,Post Graduate,32280000,48000,32232000
1412,Sunil Chhikara,NORTH WEST DELHI,IND,3,Graduate Professional,32150000,0,32150000
1128,Ramdas Chandrabhanji Tadas,WARDHA,BJP,5,10th Pass,33628998,1749314,31879684
763,Manju Chhibber,EAST DELHI,RPI(A),0,Graduate,31380000,0,31380000
62,Adv.Shivajirao Shivaramji Moghe,YAVATMAL-WASHIM,INC,2,Graduate Professional,42689718,11315807,31373911
184,Bagi Kumar Verma,AURANGABAD,JD(U),0,Graduate,32766379,1600000,31166379
386,Dr. Sushil Indora,SIRSA,Haryana Janhit Congress (BL),0,Graduate Professional,31066422,28522,31037900
38,Adsul Anandrao Vithoba,AMRAVATI,SHS,1,Graduate,32596257,1587104,31009153
1526,Vinay Kumar Jain,JABALPUR,IND,0,10th Pass,32198461,1637760,30560701
83,Aleixo Reginaldo Lourenco,SOUTH GOA,INC,0,12th Pass,31453008,905729,30547279
1303,Shalom Mathew Francisco Sardinha,SOUTH GOA,IND,0,Graduate Professional,32828000,2340017,30487983
1063,Raj Pal Singh,WEST DELHI,BSP,0,Graduate,30390435,0,30390435
1059,Raj Kumar,AMBALA,INC,0,10th Pass,36214599,5883900,30330699
1248,Sant Dharamvir Chotiwala,SONIPAT,IND,0,Graduate Professional,30110000,50000,30060000
910,Nirmal Singh,JAMMU,IND,0,Graduate,30496000,904000,29592000
948,Padam Singh,SONIPAT,INLD,0,Graduate Professional,30051128,466311,29584817
873,Narender,HISAR,IND,1,10th Pass,30260500,700000,29560500
803,Mohammad Shakeel Saifi,EAST DELHI,BSP,1,Literate,29743591,458360,29285231
96,Anand Kumar,NORTH EAST DELHI,AAP,0,Doctorate,29255377,72369,29183008
618,Karam Chand Lathwal,WEST DELHI,Bhartiya Pragatisheel Congress,0,Post Graduate,28936843,0,28936843
617,Kapoor Singh,AMBALA,BSP,0,Doctorate,32373100,3483000,28890100
477,Harkrishan Das Nijhawan,NEW DELHI,IND,1,12th Pass,29194281,572550,28621731
1208,Sachintra Debbarma,TRIPURA EAST,INC,0,Graduate Professional,28560336,0,28560336
1557,Yogendra Singh Yadav,GURGAON,AAP,0,Post Graduate,29709151,1387505,28321646
860,Nahid Hasan,KAIRANA,SP,2,Graduate,30399449,2105000,28294449
265,Chatap Wamanrao Sadashiv,CHANDRAPUR,AAP,3,Graduate Professional,29375000,1300000,28075000
1108,Rakesh Singh Urf Ghanshyam Singh,JABALPUR,BJP,1,Graduate,27823610,0,27823610
899,Navneet Ravi Rana,AMRAVATI,NCP,3,10th Pass,29496562,1858727,27637835
1188,Rinku Kumar Tyagi,GHAZIABAD,IND,0,Others,31501000,4000000,27501000
347,Dheeraj Puri,NEW DELHI,SHS,0,10th Pass,27148834,0,27148834
666,Kuldeep Rai Sharma,ANDAMAN & NICOBAR ISLANDS,INC,0,Graduate Professional,31594826,5034619,26560207
566,Jugal Kishore,JAMMU,BJP,0,10th Pass,26824308,300000,26524308
371,Dr. Harsh Vardhan,CHANDNI CHOWK,BJP,2,Post Graduate,28229308,1780492,26448816
800,Mohamad Adeeb,BIJNOR,Rashtrawadi Samaj Party,0,Post Graduate,26241383,0,26241383
561,Jose K Mani,KOTTAYAM,Kerala Congress (M),0,Post Graduate,26236371,0,26236371
1034,Purshotam,FARIDABAD,AAP,0,10th Pass,27376208,1193221,26182987
489,Hukum Singh,KAIRANA,BJP,2,Graduate Professional,29078847,2941671,26137176
225,Bhura Ram,AMBALA,IND,0,Not Given,26119165,0,26119165
930,P C Chacko,CHALAKUDY,INC,0,Post Graduate,28000209,2063744,25936465
1408,Sumant Kumar,SOUTH DELHI,IND,1,Graduate,26172006,250729,25921277
254,C. L. Ruala,MIZORAM,INC,0,Graduate,25733421,0,25733421
406,Faggan Singh Kulaste,MANDLA,BJP,2,Post Graduate,25738420,98311,25640109
998,Pradeep Kumar Jatav,BULANDSHAHR,BSP,1,12th Pass,25731324,557571,25173753
1446,Swadesh Ohri,NEW DELHI,Atulya Bharat Party,0,12th Pass,25102378,0,25102378
1485,Umed Singh,HISAR,IND,0,5th Pass,25250500,300000,24950500
679,Kunwar Bhartendra,BIJNOR,BJP,2,Post Graduate,24840646,0,24840646
1543,Vishnu Dayal Ram,PALAMAU,BJP,0,Graduate,24753886,0,24753886
282,Christy Fernandez,ERNAKULAM,IND,0,Doctorate,27176949,2620749,24556200
1098,Raju Or Bharatraje Uddhaorao Patil,YAVATMAL-WASHIM,MNS,6,Graduate,25700000,1400000,24300000
565,Jual Oram,SUNDARGARH,BJP,1,Others,24202170,0,24202170
1169,Rathod Baliram Parashram,YAVATMAL-WASHIM,BSP,0,Graduate Professional,26249301,2106000,24143301
39,Adv. A. Jayaram,THRISSUR,BSP,0,Graduate Professional,24702613,628000,24074613
1489,Upendra Kushwaha,KARAKAT,Rashtriya Lok Samta Party,4,Post Graduate,24829741,823834,24005907
246,Bodhsingh Bhagat,BALAGHAT,BJP,0,Graduate,24959436,1393732,23565704
505,Ivoryna Shylla,SHILLONG,IND,0,10th Pass,23050000,0,23050000
1102,Rakesh Chandra Rawat,ALIGARH,Rashtriya Sawarn Dal,0,Post Graduate,23000000,0,23000000
621,Karra Parasu Ramaiah,SASARAM,JD(U),1,Doctorate,24500404,1672000,22828404
849,Muttemwar Vilasrao Baburao,NAGPUR,INC,0,Graduate,26382690,3569251,22813439
1233,Sanjay Bhoi,BARGARH,INC,0,Graduate,25786368,3000000,22786368
222,Bhupen Kumar Borah,TEZPUR,INC,0,Post Graduate,26084515,3350225,22734290
327,Devinder Kumar Sehrawat,SOUTH DELHI,AAP,0,Post Graduate,23237892,540000,22697892
1013,Prashant Pandharinath Surve,YAVATMAL-WASHIM,IND,0,Post Graduate,26770200,4600000,22170200
863,Nakul Das Rai,SIKKIM,AITC,0,Graduate,22091161,115000,21976161
1016,Pratap Goswami,RAMTEK,AAP,0,Graduate,23772549,2075378,21697171
61,Adv.S.Prahladan,KOLLAM,BSP,0,Graduate Professional,21645000,0,21645000
258,Chandra Sekhar Sahu,BERHAMPUR,INC,0,Graduate Professional,22114000,642430,21471570
428,Ghanshyam Dass,NEW DELHI,IND,0,10th Pass,21043000,0,21043000
276,Chinchole Gangaram Kaluji,BULDHANA,IND,0,12th Pass,21065000,117000,20948000
1407,Suman Singh,SONIPAT,BSP,0,10th Pass,21283460,450000,20833460
955,Pankaj Prafulkumar Bhansali,NAGPUR,IND,0,12th Pass,20684589,0,20684589
682,Kusum Sherwal,AMBALA,INLD,0,Doctorate,21378240,696974,20681266
1282,Savitri,GAUTAM BUDHHA NAGAR,IND,0,10th Pass,20577047,0,20577047
810,Mohanan D,ALAPPUZHA,AAP,0,Post Graduate,21114000,600000,20514000
717,M Raghavan,KOZHIKODE,IND,0,10th Pass,20493829,0,20493829
427,George Mankidiyil,THIRUVANANTHAPURAM,IND,0,Graduate Professional,20103771,0,20103771
1101,Rakesh,GAUTAM BUDHHA NAGAR,IND,0,12th Pass,19913600,0,19913600
141,Arvind Kumar Sharma,KARNAL,INC,0,Post Graduate,35428444,15584114,19844330
253,C N Jayadevan,THRISSUR,CPI,3,Post Graduate,20041642,294000,19747642
1206,Sabukutty Joy (Sabu Puthuchera),PATHANAMTHITTA,Social Action Party,1,Post Graduate,21739967,2025000,19714967
581,K Sudhakaran,KANNUR,INC,2,Post Graduate,21659467,1969997,19689470
475,Hariom Sharma,CHANDNI CHOWK,AITC,0,10th Pass,23010474,3391550,19618924
1419,Sunil Kumar Kasana,KAIRANA,AAP,0,12th Pass,20795589,1250000,19545589
714,M I Shanavas,WAYANAD,INC,0,Post Graduate,27122055,7711000,19411055
481,Hemanand Biswal,SUNDARGARH,INC,0,12th Pass,20107728,1300000,18807728
426,Geeta Arya,SASARAM,AAP,0,8th Pass,18756436,0,18756436
84,Aleyamma Varghese,PATHANAMTHITTA,AITC,0,10th Pass,22800000,4200000,18600000
725,Madan Lal Sharma,JAMMU,INC,0,10th Pass,18843802,384929,18458873
511,Jagbir Singh,MUZAFFARNAGAR,IND,0,Graduate Professional,19380034,1100000,18280034
642,Kiran Pal,KURUKSHETRA,Bharatiya Inqalab Party,0,12th Pass,18260000,0,18260000
99,Anil,KURUKSHETRA,IND,0,5th Pass,18036000,0,18036000
524,Jai Singh,ROHTAK,IND,0,10th Pass,18187000,200000,17987000
1086,Rajesh Kumar,KARNAL,IND,0,Graduate,18210000,225000,17985000
709,Lt Col Sp Singh,GAUTAM BUDHHA NAGAR,Nav Bharat Democratic Party,0,Graduate,17777227,0,17777227
983,Phool Singh Pal,MUZAFFARNAGAR,IND,0,12th Pass,17502382,0,17502382
962,Pardeep Singh Tanwar,BHIWANI-MAHENDRAGARH,IND,0,Graduate,17720045,225000,17495045
975,Paul Lyngdoh,SHILLONG,UDP,0,Post Graduate,17371929,0,17371929
1112,Ram Briksh Mall,EAST DELHI,Hindusthan Nirman Dal,0,Post Graduate,18234000,956912,17277088
440,Gopi Chand Shahabadi,TEZPUR,AITC,0,Graduate,20624119,3437403,17186716
1279,Satya Narayan Singh,KARAKAT,IND,0,Graduate,19450824,2396194,17054630
1176,Ravi Kumar Gupta,NEW DELHI,IND,0,12th Pass,17057930,15000,17042930
1210,Safruddin,GAUTAM BUDHHA NAGAR,IND,0,10th Pass,17029000,0,17029000
337,Dharampal,GURGAON,BSP,0,12th Pass,16990111,0,16990111
934,P K Sreemathi,KANNUR,CPI(M),8,Others,16939970,0,16939970
563,Joy Ram Engleng,AUTONOMOUS DISTRICT,BJP,0,10th Pass,22032158,5096806,16935352
1073,Rajender,FARIDABAD,BSP,0,Graduate,17146020,250000,16896020
214,Bhairaw Dayal Singh,KARAKAT,IND,0,Post Graduate,16847000,0,16847000
201,Balwinder Kaur,KURUKSHETRA,AAP,0,10th Pass,17852106,1196325,16655781
1312,Shankarlal Agrawala,SAMBALPUR,"Proutist Bloc, India",0,12th Pass,16466020,0,16466020
432,Ghulam Mohammed,BAGHPAT,SP,0,Post Graduate,22108104,5678445,16429659
296,Dalbir Singh Chahal,SONIPAT,Rashtravadi Janata Party,0,5th Pass,16475000,90000,16385000
5,A Sampath,ATTINGAL,CPI(M),1,Doctorate,17791149,1421392,16369757
560,Jorawar Ram,PALAMAU,JD(U),2,12th Pass,16525000,205000,16320000
457,Gursagar Singh,JAMMU,Socialistic Democratic Party,0,12th Pass,19540000,3350000,16190000
844,Mukul Wasnik,RAMTEK,INC,2,Post Graduate,16119417,0,16119417
586,K. Shyambabu Subudhi,BERHAMPUR,IND,0,12th Pass,16000000,0,16000000
1232,Sanjay,SONIPAT,IND,0,10th Pass,15800000,0,15800000
37,Aditya Narayan,NAWADA,IND,0,Graduate,15770000,0,15770000
463,Haji Jainul Abedin,CHATRA,BSP,0,Graduate,15758303,0,15758303
520,Jai Karan,ROHTAK,SUCI(C),0,Post Graduate,15703701,0,15703701
388,Dr. Yudhbir Singh Khyalia,HISAR,AAP,0,Doctorate,23346340,7678981,15667359
1043,Rabindra Nath Choudhury,KARIMGANJ,AGP,0,Graduate Professional,15546810,0,15546810
587,K. V. Pusa,NAGALAND,INC,0,Graduate,15500000,0,15500000
64,Ahir Hansraj Gangaram,CHANDRAPUR,BJP,11,10th Pass,15548000,99500,15448500
1344,Sidhant Mohapatra,BERHAMPUR,BJD,0,Post Graduate,16462430,1183828,15278602
828,Mohd. Sabir Rahi,ALIGARH,AAP,0,10th Pass,15227199,0,15227199
1499,V.T.Ikramul Haque,PONNANI,SDPI,0,10th Pass,15185342,0,15185342
834,Moreshwar Ramaji Meshram,BHANDARA-GONDIYA,IND,0,Graduate,15858255,695510,15162745
989,Pjech Debbarma,TRIPURA WEST,IND,0,10th Pass,15085500,10373,15075127
59,Adv.P.K.Jayakrishnan,MAVELIKKARA,BSP,0,Post Graduate,15410000,400000,15010000
753,Mange Ram,HISAR,BSP,0,12th Pass,14755486,0,14755486
1342,Sibasankar Ulaka,KORAPUT,BJP,1,Others,16500000,1750000,14750000
634,Khatab Singh Mor,KARNAL,Bhartiya Shakti Chetna Party,0,12th Pass,14880000,200000,14680000
366,Dr. Arun Kr. Sarmah,KALIABOR,AGP,0,Doctorate,19515691,4850186,14665505
461,Habung Payeng,ARUNACHAL WEST,AAP,0,Post Graduate,14587055,0,14587055
1255,Sarbananda Sonowal,LAKHIMPUR,BJP,0,Graduate Professional,14497515,0,14497515
173,Ateeque Ahmad Mohd. Badiujjama,NAGPUR,IND,2,10th Pass,14360527,7606,14352921
1052,Ragini Lata Singh,AURANGABAD,AAP,0,Post Graduate,14532000,183755,14348245
1157,Ranbir Singh Sharma,KURUKSHETRA,IND,0,Graduate Professional,14604045,300000,14304045
482,Hemant Kumar Saini,GURGAON,Bahujan Mukti Party,0,10th Pass,15206538,1008079,14198459
1277,Satya Narayan,SONIPAT,IND,0,10th Pass,14173000,0,14173000
148,Ashish Khetan,NEW DELHI,AAP,0,Post Graduate,17172618,3005294,14167324
723,M.P. Sayed Mohammaed Koya,LAKSHADWEEP,BJP,0,Graduate,14073985,0,14073985
10,A.K. Aggarwal,NORTH EAST DELHI,Agar Jan Party,1,10th Pass,14058166,0,14058166
937,P P Mohanan,KANNUR,IND,0,12th Pass,13953502,0,13953502
357,Dinesh Kashyap,BASTAR,BJP,1,Post Graduate,16108199,2191216,13916983
647,Kishan Pal Singh,GAUTAM BUDHHA NAGAR,AAP,0,10th Pass,14376352,592054,13784298
172,Atam Parkash,HISAR,IND,0,Post Graduate,13665554,0,13665554
769,Manoj Kumar,ROHTAK,BSP,0,12th Pass,13590000,0,13590000
1099,Raju S. Mankar,AMRAVATI,IND,0,Literate,13736000,150000,13586000
415,Gaikwad Mohan Ramrao,NAGPUR,BSP,0,Doctorate,47473922,33921023,13552899
433,Ghuran Ram,PALAMAU,JVM,3,Graduate,14586699,1046647,13540052
985,Phul Singh,HISAR,CPI(M),0,Graduate,14551828,1022496,13529332
1023,Prem Singh,EAST DELHI,Socialist Party (India),0,Doctorate,13650000,200000,13450000
1366,Soso Lorho,OUTER MANIPUR,NPF,0,Graduate,13445800,0,13445800
788,Meena Singla,NEW DELHI,Poorvanchal Rashtriya Congress,0,Graduate,13840344,517041,13323303
1439,Surinder Pal Singh,AMBALA,AAP,0,Post Graduate,15369639,2104283,13265356
273,Chetan Bhimraj Pendam,WARDHA,BSP,1,Post Graduate,13251784,0,13251784
806,Mohammed Yamin,MUZAFFARNAGAR,AAP,0,10th Pass,13243000,0,13243000
401,E. T. Mohammed Basheer,PONNANI,IUML,0,12th Pass,13216259,0,13216259
856,N.K.Premachandran,KOLLAM,Revolutionary Socialist Party,1,Graduate Professional,16228989,3114638,13114351
28,Abdurahiman Varikottil,PONNANI,IND,0,Literate,13110077,0,13110077
123,Anup Sing Dahiya,SONIPAT,Rashtriya Jatigat Aarakshan Virodhi Party,0,10th Pass,13153500,152500,13001000
132,Arun Kumar,HISAR,IND,0,12th Pass,13095700,320000,12775700
929,Onkar Singh,KURUKSHETRA,National Janhit Congress (AB),0,Literate,13440157,673667,12766490
1392,Sudhansu Shekhar Bhaskar,JAMUI,RJD,0,Doctorate,13950638,1206926,12743712
867,Nanabhau Falgunrao Patole,BHANDARA-GONDIYA,BJP,5,12th Pass,12738190,0,12738190
368,Dr. Bhola Singh,BULANDSHAHR,BJP,0,Graduate,12577537,0,12577537
266,Chater Singh Kashyap,MUZAFFARNAGAR,Vanchit Jamat Party,0,10th Pass,12559000,0,12559000
270,Chaware Maya Namdeo,RAMTEK,SP,7,Post Graduate,13746000,1220000,12526000
780,Master Sher Singh,BHIWANI-MAHENDRAGARH,CPI(M),0,Graduate Professional,12962284,500926,12461358
1311,Shankar Ram Thakur,BASTAR,SP,0,Graduate,12430000,8000,12422000
575,K C Venugopal,ALAPPUZHA,INC,0,Post Graduate,12856075,456010,12400065
971,Patel Hidayat Ulla Barkat Ulla,AKOLA,INC,1,12th Pass,12476287,202500,12273787
1156,Rana Nag,BOLANGIR,BSP,0,Graduate,13940000,1700000,12240000
1355,Smt. Seema,GAUTAM BUDHHA NAGAR,Rashtriya Naujawan Dal,0,12th Pass,12201000,0,12201000
931,P C Mohanan Master,KANNUR,BJP,2,12th Pass,12859808,739740,12120068
646,Kiren Rijiju,ARUNACHAL WEST,BJP,0,Graduate,12539868,475000,12064868
620,Karan Singh,ROHTAK,IND,0,10th Pass,12226000,162000,12064000
516,Jagdish Bhagwan Kadu,WARDHA,IND,0,Graduate Professional,15288413,3305000,11983413
1107,Rakesh Sharma,AURANGABAD,IND,0,Doctorate,12693861,828288,11865573
400,E. Ahamed,MALAPPURAM,IUML,1,Graduate Professional,11818952,0,11818952
648,Kishor Rambhau Kinkar,WARDHA,Bahujan Mukti Party,1,Graduate,12132347,345000,11787347
554,Jiten Gogoi,KALIABOR,IND,1,8th Pass,14407099,2700000,11707099
949,Padam Singh,SONIPAT,IND,0,12th Pass,11672304,0,11672304
897,Naveen Jain,JABALPUR,IND,0,Graduate,11687096,50000,11637096
1353,Smt. Prabhatai Madhukar Parlewar,BULDHANA,Narayani Sena,0,Post Graduate,11619000,0,11619000
1270,Satish Kumar,NAWADA,IND,0,10th Pass,11610000,0,11610000
1066,Rajan Lal,NORTH EAST DELHI,Bharatiya Republican Paksha,0,Graduate Professional,11571000,0,11571000
1438,Surinder Kumar Khullar,GURGAON,IND,0,Graduate,15164593,3641000,11523593
941,P.C.Jolly,IDUKKI,IND,0,12th Pass,16991308,5500000,11491308
689,Lal Chand,BHIWANI-MAHENDRAGARH,Republican Backward Congress,0,Graduate,11484000,0,11484000
218,Bhavna Bhavesh Wasnik,AMRAVATI,AAP,0,Post Graduate,12289332,880320,11409012
876,Narendra Chandra Deb Barma,TRIPURA EAST,Indigenous Peoples Front of Tripura,0,Graduate,11365500,0,11365500
858,Nagendra Kumar Pradhan,SAMBALPUR,BJD,0,Post Graduate,12796623,1461565,11335058
697,Lalit Mohon Suklabaidya,KARIMGANJ,INC,2,Post Graduate,11328972,0,11328972
592,K.V. Thomas,ERNAKULAM,INC,0,Post Graduate,11848550,522352,11326198
537,Jarnail Singh,WEST DELHI,AAP,0,Post Graduate,11542391,222000,11320391
1295,Shahjan Masood Urf Shahdan,SAHARANPUR,SP,2,Graduate,11192498,0,11192498
1142,Ramji Manjhi,GAYA,RJD,0,Graduate,11115000,0,11115000
233,Bijoy Krishna Nath,SILCHAR,AGP,0,Graduate,11038641,0,11038641
1054,Rahul Sheshraoji Meshram,RAMTEK,IND,0,12th Pass,10938968,0,10938968
103,Anil Kumar,SONIPAT,Rashtriya Bahujan Hitay Party,0,10th Pass,10875000,0,10875000
655,Krishanpal,KAIRANA,IND,0,Literate,10804500,0,10804500
1197,Ruby Yadav,SOUTH DELHI,IND,0,Post Graduate,10797222,0,10797222
268,Chaudhary Daya Chand,FARIDABAD,Bhartiya Shakti Chetna Party,0,Graduate,10745000,0,10745000
420,Gangmumei Kamei,OUTER MANIPUR,BJP,0,Post Graduate,10656364,0,10656364
13,A.V.Thamarakshan,ALAPPUZHA,Revolutionary Socialist Party of Kerala (B),1,Post Graduate,10641399,0,10641399
536,Jannat Jahan-Ul-Haq (Naina),CHANDIGARH,BSP,0,Graduate,11100000,500000,10600000
1116,Ram Karan Sauran,NORTH WEST DELHI,IND,0,Graduate,11854000,1257000,10597000
923,Om Prakash Dhankhad,ROHTAK,BJP,1,Post Graduate,10587916,0,10587916
533,James Joseph P,KOTTAYAM,IND,0,12th Pass,10508400,0,10508400
1504,Ved Prakash,NEW DELHI,IND,0,10th Pass,10478697,0,10478697
1037,Pyare Lal,BULANDSHAHR,Bahujan Mukti Party,0,Graduate Professional,11325000,900000,10425000
1310,Shankar Kumar Patra,BOLANGIR,Aama Odisha Party,0,Post Graduate,10380000,0,10380000
1183,Ravindra Kumar Ray,KODARMA,BJP,0,Doctorate,10564046,200000,10364046
130,Armerington Kharshiing,SHILLONG,AAP,0,Not Given,10547837,211214,10336623
757,Mani Charenamei,OUTER MANIPUR,IND,0,Graduate,11422552,1108000,10314552
1415,Sunil Dutt,MEERUT,IND,0,12th Pass,10218400,0,10218400
332,Dhanapalan,THRISSUR,INC,1,Graduate,12435866,2269212,10166654
641,Kim Gangte,OUTER MANIPUR,AITC,0,Post Graduate,10150000,0,10150000
453,Gunin Basumatari,JORHAT,SP,0,Graduate Professional,10322068,217200,10104868
1213,Sahaba Ahmed,KALIABOR,IND,0,Graduate Professional,10104000,0,10104000
230,Bijendra Singh,ALIGARH,INC,2,Graduate,12292000,2201014,10090986
534,Janardan Mishra,REWA,BJP,0,Graduate Professional,10156568,106977,10049591
163,Ashok Vithoba Khandale,CHANDRAPUR,RPI,0,Graduate,10956000,1000000,9956000
74,Ajay Singla,CHANDIGARH,IND,2,10th Pass,9877806,0,9877806
1409,Sunder,HISAR,IND,0,Literate,10170500,300000,9870500
1478,Uday Narain Choudhary,JAMUI,JD(U),0,Graduate,9827813,0,9827813
651,Kodikunnil Suresh,MAVELIKKARA,INC,1,Graduate Professional,13251330,3439654,9811676
732,Mahender Jat,GURGAON,IND,0,Graduate Professional,10206000,400000,9806000
892,Natthi Lal Sharma,ALIGARH,IND,0,Graduate,9794000,0,9794000
808,Mohan Lal,KAIRANA,IND,0,12th Pass,9741331,0,9741331
783,Mathew T Thomas,KOTTAYAM,JD(S),4,Graduate Professional,10379737,649181,9730556
841,Mukesh Kumar Arora,NORTH EAST DELHI,IND,0,Graduate,13688864,3970000,9718864
1049,Raghunath Shankarrao Shelke,YAVATMAL-WASHIM,Ambedkarist Republican Party,0,Graduate,9692000,0,9692000
927,Omkar Singh Markam,MANDLA,INC,0,Post Graduate,9618675,0,9618675
503,Ismail P.,MALAPPURAM,Welfare Party Of India,0,Post Graduate,9524919,0,9524919
199,Balwant Kumar,CHATRA,Jharkhand Party,1,Graduate,9514000,0,9514000
303,Dattaram Desai,NORTH GOA,AAP,0,Post Graduate,9795686,335819,9459867
372,Dr. Himanshu Singh,MEERUT,AAP,3,Graduate Professional,9408585,0,9408585
1204,Sabu Varghese,IDUKKI,BJP,0,Graduate Professional,9755000,386540,9368460
248,Brahmadav Anand Paswan,JAMUI,BSP,0,12th Pass,9493973,175000,9318973
958,Pankajkumar Sharma,CHANDRAPUR,AITC,0,Graduate,9757822,450000,9307822
556,Jitendra Choudhury,TRIPURA EAST,CPI(M),0,12th Pass,11322979,2030773,9292206
370,Dr. Gajbe Rameshkumar Baburaoji,GADCHIROLI-CHIMUR,AAP,0,Post Graduate,9315000,69000,9246000
1490,Upendra Nath,AURANGABAD,Bahujan Mukti Party,1,Post Graduate,9228000,0,9228000
1429,Surendra Ram,SASARAM,IND,0,5th Pass,9289000,200000,9089000
951,Padmanabhan .C.K.,KOZHIKODE,BJP,0,10th Pass,9306000,400000,8906000
1388,Sudarshan Bhagat,LOHARDAGA,BJP,0,Not Given,9031009,178967,8852042
1092,Rajkumar Pahan,CHATRA,Rashtriya Deshaj Party,0,Graduate,8851813,0,8851813
18,Abdul Jaleel,WAYANAD,SDPI,0,Graduate,8813205,0,8813205
452,Gumjum Haider,ARUNACHAL WEST,AITC,0,Graduate,8808016,0,8808016
550,Jhina Hikaka,KORAPUT,BJD,0,Graduate,8800000,0,8800000
965,Parmeshwar Hiraman Gawai,BULDHANA,Ambedkarist Republican Party,0,12th Pass,8810000,60000,8750000
802,Mohammad Moosa,BIJNOR,PECP,0,Graduate,8740204,0,8740204
905,Nilam Devi,CHATRA,JVM,0,5th Pass,9780527,1048964,8731563
589,K.Narayanan Master,PONNANI,BJP,1,12th Pass,10368303,1657088,8711215
1434,Suresh Pujari,SAMBALPUR,BJP,0,Post Graduate,8684372,0,8684372
1126,Ramashankar Shahwal,SIDHI,BSP,0,Post Graduate,9743656,1092000,8651656
1209,Safdar Ismail,NAWADA,IND,0,Graduate Professional,8605000,25000,8580000
33,Abraham Benhur,WAYANAD,IND,0,Post Graduate,9999242,1421961,8577281
109,Anish Mariyil,IDUKKI,IND,0,12th Pass,8569000,0,8569000
928,Ompal Singh,EAST DELHI,Kalyankari Jantantrik Party,0,Graduate,9063978,550000,8513978
977,Pawan Kumar Sharma,CHANDIGARH,IND,0,12th Pass,9196223,720000,8476223
1036,Puspendra Singh,SIDHI,GGP,1,Graduate Professional,10453934,2020000,8433934
1372,Sri Karna Bijoy Jamatia,TRIPURA EAST,AAP,0,10th Pass,8410000,0,8410000
770,Manoj Kumar,KODARMA,IND,0,Post Graduate,8410000,10000,8400000
888,Narinder Kumar,HISAR,IND,0,Others,8931000,600000,8331000
1068,Rajani Dubey,KARAKAT,Akhil Bharatiya Jan Sangh,0,Graduate,8324677,0,8324677
967,Parsuram Majhi,NABARANGPUR,BJP,0,Graduate,8274821,61600,8213221
687,Lakshmi Narayan,NEW DELHI,Bharatiya Bahujan Party,0,8th Pass,8202800,0,8202800
472,Hari Manjhi,GAYA,BJP,1,8th Pass,10184120,2000000,8184120
1272,Satish Kumar Singal,KURUKSHETRA,IND,0,Post Graduate,8105000,0,8105000
1370,Sreerupa Mitra Chaudhury,SOUTH DELHI,AITC,0,Post Graduate,11823944,3788624,8035320
404,Eng. Sanjay Raghunath Nasare,BHANDARA-GONDIYA,BSP,0,Graduate Professional,8504878,511145,7993733
57,Adv.Joice George,IDUKKI,IND,4,Graduate Professional,17396207,9417720,7978487
690,Lal Das,JABALPUR,GGP,0,10th Pass,8070000,130000,7940000
1427,Surender Singh,CHANDNI CHOWK,IND,0,Graduate,7902603,0,7902603
346,Dhebor Gohain Boruah,LAKHIMPUR,AITC,0,Graduate Professional,7878597,0,7878597
459,Gyan Chand,BARGARH,BSP,0,5th Pass,7854072,0,7854072
807,Mohan Kanuga,SOUTH DELHI,JKNPP,0,Post Graduate,7839000,0,7839000
612,Kanta,KURUKSHETRA,Indian Bahujan Sandesh Party (Kanshiram),1,10th Pass,34224262,26405000,7819262
3,A N Radhakrishnan,ERNAKULAM,BJP,0,Graduate,7813475,0,7813475
208,Bashir Khan Ramzan Khan,NAGPUR,Minorities Democratic Party,0,Graduate,7839000,52000,7787000
1555,Yashpal Sharma,JAMMU,JKPDP,0,Graduate Professional,7743691,0,7743691
381,Dr. Sanjeev Kumar Balyan,MUZAFFARNAGAR,BJP,1,Doctorate,10794222,3090803,7703419
1104,Rakesh Kumar,BHIWANI-MAHENDRAGARH,IND,0,Graduate Professional,8693411,1050000,7643411
215,Bhakta Charan Das,KALAHANDI,INC,1,Graduate Professional,11516583,3875982,7640601
126,Appanchira Ponnappan,IDUKKI,BSP,0,10th Pass,7611000,0,7611000
610,Kamlesh,BULANDSHAHR,SP,1,5th Pass,7593541,0,7593541
87,Ali Kishor Patnaik,BERHAMPUR,CPI(M),1,Graduate,7450333,0,7450333
116,Ankur,MUZAFFARNAGAR,IND,0,12th Pass,7425346,0,7425346
942,P.D. Chandrabhanu,ERNAKULAM,Socialist Republican Party,0,10th Pass,8306000,884000,7422000
1138,Rameshwar Kumar,KURUKSHETRA,Bhartiya Shakti Chetna Party,0,10th Pass,7416637,0,7416637
1554,Wazid Reja Osmani,SILCHAR,AITC,0,Doctorate,7384788,0,7384788
1084,Rajesh Devi Urf Radhika,MUZAFFARNAGAR,AITC,0,Graduate Professional,7370060,0,7370060
71,Ajay Kumar Panjabrao Hingankar,AKOLA,AAP,0,Graduate,8035000,700000,7335000
716,M M Paulose,ALAPPUZHA,IND,0,10th Pass,7322508,0,7322508
693,Laldev Ram,PALAMAU,Bahujan Mukti Party,0,12th Pass,7293888,0,7293888
289,Commander (Rtd) Ashok Raut,BULDHANA,IND,0,Graduate Professional,7250500,0,7250500
557,Jodhraj Paharia,NORTH WEST DELHI,IND,0,Illiterate,7221810,0,7221810
385,Dr. Suraj Mandal,KODARMA,Jharkhand Vikas Dal,2,Doctorate,7871582,700000,7171582
1481,Udayveer,GAUTAM BUDHHA NAGAR,Rashtriya Janta Party,0,Illiterate,7271300,124123,7147177
359,Dinesh Kumar,WEST DELHI,Akhand Bharat Samaj Party,0,10th Pass,7386000,252000,7134000
294,Daharwal Ganeshdeo Raghuji,BHANDARA-GONDIYA,GGP,0,5th Pass,7113000,0,7113000
67,Ajad Geeta Prasad Sharma,NAWADA,IND,0,12th Pass,7080000,0,7080000
292,D K Chopra,SOUTH DELHI,IND,1,Graduate,7080000,0,7080000
1045,Radheshyam Biswas,KARIMGANJ,AIUDF,0,12th Pass,7068281,0,7068281
1451,T. L. Santhosh,THRISSUR,IND,6,Not Given,7597000,530000,7067000
846,Mullappally Ramachandran,VADAKARA,INC,0,Post Graduate,9225000,2160000,7065000
1384,Subhas Sen,DIBRUGARH,CPI(ML)L,0,12th Pass,7032268,0,7032268
1328,Shri Chand Tanwar,SOUTH DELHI,CPI,0,8th Pass,7002415,0,7002415
1469,Thomas Joseph,THIRUVANANTHAPURAM,RPI(A),0,10th Pass,7850000,872906,6977094
1000,Pradeep Kumar Majhi,NABARANGPUR,INC,0,Graduate,6978000,36000,6942000
360,Dinesh Pal Singh,NORTH EAST DELHI,IND,0,8th Pass,6931000,0,6931000
286,Cleatus,WAYANAD,IND,2,8th Pass,6905000,0,6905000
313,Deepaksingh Trymbakrao Deshmukh,WARDHA,IND,0,10th Pass,6900000,0,6900000
1065,Raja Ram Singh,KARAKAT,CPI(ML)L,4,Graduate Professional,6796970,0,6796970
395,Dushmanta Kumar Giri,SOUTH DELHI,IND,1,Doctorate,9500000,2720000,6780000
35,Abullais.T.P,PONNANI,IND,0,12th Pass,6692346,0,6692346
283,Chungkhokai Doungel,OUTER MANIPUR,NCP,0,Graduate,6685000,0,6685000
1120,Ram Prasad Sharma,TEZPUR,BJP,0,Graduate Professional,6655300,0,6655300
1308,Shandar Gufran,MUZAFFARNAGAR,IND,0,Post Graduate,7268197,661855,6606342
11,A.K.Salahudeen,KOLLAM,SDPI,1,12th Pass,6562365,0,6562365
1109,Rakhal Raj Datta,TRIPURA WEST,Amra Bangalee,0,Post Graduate,6549960,0,6549960
350,Dhote Jambuwantrao Bapurao,YAVATMAL-WASHIM,AIFB,0,10th Pass,6545000,0,6545000
891,Nathu Ram,SAMBALPUR,BSP,0,Graduate,6538687,0,6538687
89,Amarjit Kaur,CHANDIGARH,IND,0,8th Pass,7020000,500000,6520000
754,Mange Ram,SIRSA,BSP,0,Graduate,6507759,0,6507759
330,Dhananjay Kishore,GAYA,AAP,0,Graduate Professional,6509560,6102,6503458
341,Dharamveer Singh,NORTH EAST DELHI,Rashtriya Ekta Party,1,10th Pass,6497000,0,6497000
1406,Sulochana Devi,NAWADA,IND,0,Literate,7275000,800000,6475000
1111,Ram Bilash,GAUTAM BUDHHA NAGAR,Bahujan Mukti Party,0,5th Pass,6470000,0,6470000
45,Adv. N.Sreeprakash,MALAPPURAM,BJP,0,Graduate Professional,6781097,317500,6463597
399,E S Khaja Hussain,PALAKKAD,SDPI,2,10th Pass,6490438,35000,6455438
1162,Ranvir Khobra,SIRSA,IND,0,Graduate,7896000,1450000,6446000
1193,Robin Singh,CHATRA,IND,0,10th Pass,6430000,0,6430000
672,Kuldeep S/O Sajjan,HISAR,IND,0,12th Pass,6548165,137000,6411165
1028,Prodip Hazarika,JORHAT,AGP,0,Post Graduate,6989852,650000,6339852
821,Mohd. Firoz Aftab,SAHARANPUR,IND,1,Graduate Professional,6305818,0,6305818
159,Ashok Mahadeorao Nete,GADCHIROLI-CHIMUR,BJP,0,12th Pass,12125676,5830550,6295126
915,Nitin Vasant Pohane,CHANDRAPUR,Lok Bharati,0,Graduate,8529000,2255000,6274000
46,Adv. Narendra Keshav Sawaikar,SOUTH GOA,BJP,0,Graduate Professional,6260382,0,6260382
1379,Ssomendar Dhaka,BAGHPAT,AAP,0,Graduate Professional,6488116,250000,6238116
584,K. Bhaskaran,KOLLAM,IND,1,Graduate,6313287,108453,6204834
1455,Taba Taku,ARUNACHAL WEST,Lok Bharati,0,Graduate,6200000,0,6200000
469,Har Gobind Arora,WEST DELHI,SHS,1,12th Pass,6189246,0,6189246
593,Kabindra Purkayastha,SILCHAR,BJP,0,Post Graduate,6236945,130502,6106443
644,Kiran Prem Kumar Rodge (Patankar),RAMTEK,BSP,0,Literate,6074383,0,6074383
502,Ishwar Singh,AMBALA,IND,0,5th Pass,6084400,37741,6046659
768,Manoj Kumar,PALAMAU,RJD,1,Graduate,8357000,2350000,6007000
1181,Ravinder Sharma,GAUTAM BUDHHA NAGAR,Rashtriya Kranti Party,0,8th Pass,5992835,0,5992835
277,Chirag Kumar Paswan,JAMUI,LJP,0,12th Pass,10414470,4458954,5955516
538,Jarnail Singh S/O Gurbax Singh,WEST DELHI,IND,0,8th Pass,5955021,0,5955021
157,Ashok Kumar Sharma,JAMMU,IND,0,Graduate,6156613,215602,5941011
1174,Raut Jaganath Nilkanth,WARDHA,IND,0,Graduate Professional,5940000,0,5940000
935,P Karunakaran,KASARAGOD,CPI(M),6,Post Graduate,5900345,0,5900345
611,Kanchan Kumari,KODARMA,IND,0,12th Pass,5980857,85000,5895857
1512,Vijay Kumar,NORTH WEST DELHI,RPI(A),0,Graduate,5880000,0,5880000
394,Durgesh Chandra Gautam,ALIGARH,AITC,0,Graduate Professional,5878725,0,5878725
1237,Sanjay Kumar Rai,SOUTH DELHI,BSP,1,12th Pass,5839937,0,5839937
1055,Rahulkant Alias Ramesh Sinha,RAMTEK,IND,0,Graduate Professional,6520000,700000,5820000
809,Mohan Marotrao Karemore,NAGPUR,IND,0,10th Pass,6008449,200000,5808449
721,M.A. Baby,KOLLAM,CPI(M),2,Graduate,6430619,625000,5805619
75,Ajaypal,BAGHPAT,IND,0,8th Pass,5790000,0,5790000
63,Aherwan Dharmender Rawat,FARIDABAD,IND,0,12th Pass,6109500,335000,5774500
1256,Saroj Kumar Naik,KALAHANDI,BSP,0,Graduate,5880000,120000,5760000
1336,Shuvadip Datta,SILCHAR,IND,0,12th Pass,6123000,365707,5757293
1552,Wadhave Damodhar Natthu,BHANDARA-GONDIYA,IND,0,10th Pass,5790000,40000,5750000
799,Mittu Mujavar,NORTH GOA,IND,0,12th Pass,6871000,1121500,5749500
1170,Rathod Induwar Kashiram,YAVATMAL-WASHIM,Bahujan Mukti Party,0,12th Pass,5950000,210000,5740000
1077,Rajendra Agarwal,MEERUT,BJP,2,Post Graduate,8803517,3074600,5728917
794,Mewa Singh,SIRSA,IND,0,5th Pass,5696200,0,5696200
1243,Sanjeev Kumar,GHAZIABAD,IND,0,Post Graduate,5671309,0,5671309
6,A Vijayaraghavan,KOZHIKODE,CPI(M),0,Graduate Professional,5757792,152305,5605487
34,Abrar Ahmad Mahmud Khan,YAVATMAL-WASHIM,Welfare Party of India,0,Others,6299991,700000,5599991
473,Hari Parkash,SONIPAT,SUCI(C),0,10th Pass,5588154,0,5588154
984,Phool Singh Paraste,SHAHDOL,BSP,2,Post Graduate,5694356,120000,5574356
1242,Sanjaybhau Narayanrao Chidam,WARDHA,IND,0,12th Pass,5610091,50000,5560091
1122,Rama Chandra Panda,BERHAMPUR,BJP,0,Post Graduate,5552220,0,5552220
968,Partha Karmakar,TRIPURA WEST,CPI(ML)L,0,Graduate,5540194,0,5540194
298,Dalpat Singh Paraste,SHAHDOL,BJP,0,Graduate Professional,5524870,0,5524870
79,Akar Dhoj Limbu,SIKKIM,INC,0,Graduate Professional,5504900,0,5504900
926,Ombir Sharma,GURGAON,IND,0,10th Pass,5496500,0,5496500
918,O M Jyotheendra Nath,THIRUVANANTHAPURAM,IND,0,Graduate,5620000,130000,5490000
27,Abdurahiman Vadakkathinakath,PONNANI,IND,0,8th Pass,5488050,0,5488050
244,Bishnu Pada Ray,ANDAMAN & NICOBAR ISLANDS,BJP,1,Graduate,5658980,175115,5483865
1155,Ramteke Ramesh Devidasrao,AMRAVATI,Republican Party of India (Khobragade),0,12th Pass,5770500,300000,5470500
110,Anita Mondal,ANDAMAN & NICOBAR ISLANDS,AITC,1,Graduate,5471073,6000,5465073
256,Chamra Linda,LOHARDAGA,AITC,2,Graduate,7010805,1550000,5460805
55,Adv.Dadasaheb Alias Dhanu Bhikaji Walthare,BHANDARA-GONDIYA,IND,0,Graduate Professional,5395083,0,5395083
1422,Sunilkrishnan,ATTINGAL,IND,2,Post Graduate,5310000,0,5310000
1330,Shri Ram,SATNA,IND,0,Post Graduate,5309000,0,5309000
1292,Shahid,SOUTH DELHI,IND,0,10th Pass,5305000,0,5305000
1029,Prof. Dr. Natthu Madhao Lokhande,RAMTEK,IND,0,Doctorate,5276500,0,5276500
1560,Yogesh Nanaji Samrite,BALAGHAT,BSP,1,Post Graduate,5250000,0,5250000
852,N K P Nair,ANDAMAN & NICOBAR ISLANDS,CPI(ML)L,0,10th Pass,5287805,43642,5244163
231,Bijoy Kr. Tiru,KALIABOR,AIUDF,0,Graduate,5238298,0,5238298
1288,Seyyed Mohammed Khasim.K,LAKSHADWEEP,SP,2,12th Pass,5236685,0,5236685
771,Manoj Kumar,SONIPAT,IND,0,Graduate Professional,5915698,685000,5230698
205,Banwari Saw,CHATRA,CPI,0,Literate,5765202,553000,5212202
418,Ganesh Bapurao Patil,RAMTEK,GGP,0,5th Pass,5220000,20000,5200000
701,Lamminlien Gangte,OUTER MANIPUR,JD(U),0,Illiterate,5177000,0,5177000
945,P.M. Velayudhan,KOLLAM,BJP,0,10th Pass,5927000,750000,5177000
465,Hamid Khan,FARIDABAD,Hindustan Kranti Dal,0,Graduate,5219608,49608,5170000
329,Dhanada Kanta Mishra,BERHAMPUR,AAP,0,Doctorate,10787163,5662400,5124763
991,Prabhas Kumar Singh,BARGARH,BJD,0,Doctorate,5786971,670000,5116971
1449,T D Baburajan,CHALAKUDY,IND,0,12th Pass,5278500,180000,5098500
156,Ashok Kumar Panda,SAMBALPUR,IND,0,Graduate,5947626,853925,5093701
1212,Sagar Singh Manaki,SUNDARGARH,Kosal Kranti Dal,0,Graduate,5069000,0,5069000
1467,Thangso Baite,OUTER MANIPUR,INC,0,Post Graduate,5947000,880000,5067000
540,Jasmer Singh,CHANDIGARH,IND,0,10th Pass,5355500,290000,5065500
1095,Raju Baiga,SHAHDOL,IND,1,10th Pass,5177500,120000,5057500
1323,Shiv Kumar Kant,GAYA,BSP,0,Graduate,5232500,200000,5032500
775,Manorom Gogoi,JORHAT,AAP,0,Post Graduate,6659665,1647593,5012072
678,Kunnukuzhi S Mani,THIRUVANANTHAPURAM,IND,0,10th Pass,5000040,0,5000040
940,P.Abdul Hameed Master,VADAKARA,SDPI,1,Graduate,4988654,0,4988654
1421,Sunil Sourabh,WEST DELHI,IND,0,Post Graduate,4963000,0,4963000
1262,Satbir,HISAR,IND,0,5th Pass,4959708,0,4959708
1454,T.Siddique,KASARAGOD,INC,7,Graduate Professional,6779637,1849149,4930488
51,Adv. Raju Mangeshkar,SOUTH GOA,CPI,1,Graduate Professional,4904426,0,4904426
1492,Usha Rani Verma,GURGAON,IND,0,Post Graduate,5821000,917021,4903979
376,Dr. Namdeo Dalluji Usendi,GADCHIROLI-CHIMUR,INC,1,Post Graduate,14281020,9382799,4898221
264,Charanjeet Singh,SIRSA,INLD,0,10th Pass,8146887,3260000,4886887
893,Naushad Alam,CHATRA,AITC,0,Graduate,4839400,0,4839400
576,K K Ashokan,KASARAGOD,IND,0,10th Pass,5351775,517000,4834775
447,Govind Gaude,SOUTH GOA,IND,4,Others,5478000,650000,4828000
738,Mahesh Giri,EAST DELHI,BJP,1,10th Pass,5216375,400000,4816375
523,Jai Ram Lal,EAST DELHI,JKNPP,0,10th Pass,4827000,15000,4812000
1562,Yunush,BAGHPAT,Navbharat Nirman Party,0,Literate,4810000,0,4810000
124,Anwar Shakeel Omar,MALAPPURAM,IND,0,Post Graduate,4809396,0,4809396
484,Hina Likhiram Kawre,BALAGHAT,INC,0,Post Graduate,4804487,0,4804487
88,Altaf Husain,CHANDNI CHOWK,Bhartiya Janta Dal (Integrated),0,12th Pass,4790000,0,4790000
291,Cp Verma,SAHARANPUR,IND,3,Literate,4750000,0,4750000
1510,Venus Habib,SOUTH GOA,IND,0,Graduate,4733543,0,4733543
48,Adv. Peelipose Thomas,PATHANAMTHITTA,IND,1,Graduate Professional,5648161,928336,4719825
514,Jagdish,KARNAL,IND,0,Illiterate,4778000,60000,4718000
531,Jalley Sonam,ARUNACHAL WEST,PPA,0,10th Pass,4680000,0,4680000
1471,Tilakdhari Prasad Singh,KODARMA,INC,0,Graduate,4666034,0,4666034
590,K.P. Sreesan,THRISSUR,BJP,1,12th Pass,4653270,0,4653270
1380,Subal Bhowmik,TRIPURA WEST,IND,1,Graduate Professional,4620411,0,4620411
1161,Ranjit Singh Gorh,LAKHIMPUR,IND,0,Graduate,4611700,0,4611700
786,Md. Ali Hussain,SAMBALPUR,IND,0,12th Pass,9030000,4420000,4610000
606,Kamble Bhanudas Chokoba,AKOLA,BSP,0,12th Pass,4607000,0,4607000
711,M .K Raghavan,KOZHIKODE,INC,0,Graduate,6164901,1558128,4606773
526,Jaideo Choudhary,KODARMA,SP,2,10th Pass,4620269,28831,4591438
730,Mahaveer Parshad Manjhi,SHAHDOL,IND,0,8th Pass,4568000,0,4568000
895,Naveen Chandra,NEW DELHI,Naya Daur Party,0,Graduate,4565000,0,4565000
1483,Ulhas Vasramji Jadhao,YAVATMAL-WASHIM,IND,0,Graduate Professional,5394200,850000,4544200
392,Duli Chand,KARNAL,Lok Parivartan Party(DC),0,Graduate Professional,4828000,290000,4538000
1151,Ramphal Sharma,KARNAL,IND,0,10th Pass,4537000,0,4537000
1354,Smt. Priya K S,ATTINGAL,Welfare Party Of India,0,Post Graduate,4530512,0,4530512
625,Karunakaran Kalippurayil,KASARAGOD,IND,0,10th Pass,4514183,0,4514183
47,Adv. P. P. A. Sageer,WAYANAD,AAP,0,Graduate Professional,4539401,57788,4481613
574,K C Karthikeyan,ERNAKULAM,BSP,0,10th Pass,5180540,700000,4480540
1397,Suhas Naik,NORTH GOA,CPI,1,Graduate Professional,4483000,15000,4468000
1148,Rampati Ranjan,PALAMAU,BSP,0,Graduate,4445000,0,4445000
444,Gourav Gogoi,KALIABOR,INC,0,Post Graduate,5473199,1042133,4431066
1309,Shankar Kansre,BALAGHAT,IND,0,Graduate Professional,5925841,1500000,4425841
653,Krishan Pal,BAGHPAT,Naitik Party,1,12th Pass,4414465,0,4414465
986,Phusey Ghanshyam Ramaji,NAGPUR,RPI,0,Graduate,4987645,577000,4410645
815,Mohd Naseer,EAST DELHI,PECP,0,8th Pass,4398632,0,4398632
784,Md Afaq,CHANDNI CHOWK,Jai Maha Bharath Party,0,5th Pass,4374000,0,4374000
180,B. Gopalakrishnan,CHALAKUDY,BJP,2,Graduate Professional,5014237,644405,4369832
118,Annamma Joy,CHALAKUDY,AITC,0,Graduate,6397000,2040000,4357000
707,Lingaraj Sabara@Gomango,KORAPUT,IND,0,Post Graduate,5462041,1123000,4339041
1190,Rita Devi,AURANGABAD,SP,0,10th Pass,5136715,800000,4336715
1048,Raghunandan Prasad Vishwakarma,KODARMA,AIFB,0,10th Pass,4822232,487351,4334881
854,N Sadanandan,MAVELIKKARA,AAP,0,Graduate Professional,4309529,0,4309529
1096,Raju Dsouza,NORTH GOA,Samajwadi Janata Party (Rashtriya),0,10th Pass,9352368,5050000,4302368
695,Lalit Kumar,BHIWANI-MAHENDRAGARH,AAP,0,Graduate Professional,8922356,4625841,4296515
696,Lalit Mittal,FARIDABAD,IND,0,Post Graduate,4295126,0,4295126
217,Bhaskaran K V,ERNAKULAM,IND,1,Graduate,4640900,350000,4290900
321,Dev Kumar Choudhary,GAYA,IND,0,Graduate Professional,5087170,800000,4287170
1525,Vinay,NORTH EAST DELHI,Bharatiya Sarvodaya Kranti Party,0,12th Pass,4274100,0,4274100
1556,Yogender Ram,KODARMA,Akhil Bharatiya Jan Sangh,0,10th Pass,4765000,500000,4265000
1017,Prathap Kumar. N. P,KOZHIKODE,IND,0,Graduate Professional,4356708,100000,4256708
422,Gaurav,BIJNOR,AAP,0,Graduate Professional,28246000,24000000,4246000
1477,Uday Kumar Singh,WEST DELHI,Bahujan Mukti Party,0,12th Pass,5144079,900000,4244079
588,K.G.Das,ANDAMAN & NICOBAR ISLANDS,CPI(M),0,12th Pass,4221392,0,4221392
747,Mamta Kumari,GAYA,SP,0,12th Pass,4195976,5454,4190522
25,Abdul Sami Salmani,NORTH EAST DELHI,BSP,0,Others,4331561,160000,4171561
759,Manish Vinayakrao Telrandhe,WARDHA,IND,1,Graduate,4316000,162000,4154000
1076,Rajender Kumar,AMBALA,Bhartiya Shakti Chetna Party,0,10th Pass,4150500,0,4150500
102,Anil Kumar,MUZAFFARNAGAR,Bahujan Mukti Party,0,Graduate Professional,4662600,518000,4144600
719,M. N. Kutty,THRISSUR,IND,0,10th Pass,4251600,120000,4131600
15,Abdul Amir Amiro,CHANDNI CHOWK,IND,0,5th Pass,4122551,0,4122551
1251,Sarah Joseph,THRISSUR,AAP,0,Post Graduate,4122398,0,4122398
281,Chomang Kro,AUTONOMOUS DISTRICT,IND,0,Graduate,4122196,0,4122196
877,Narendra Chinduji Meshram,WARDHA,GGP,0,5th Pass,4121000,20000,4101000
70,Ajay Kumar Khemka,CHANDNI CHOWK,Kalyankari Jantantrik Party,0,Graduate,4724526,625000,4099526
152,Ashok Kumar,JAMMU,BSP,0,10th Pass,4435000,350000,4085000
140,Arvind Dongre,CHHINDWARA,Bahujan Mukti Party,0,10th Pass,4084000,0,4084000
1274,Satpal,ROHTAK,IND,0,10th Pass,3998000,0,3998000
712,M B Rajesh,PALAKKAD,CPI(M),11,Graduate Professional,4676316,700680,3975636
1071,Rajeev Yadav,GURGAON,IND,0,Post Graduate,3963909,0,3963909
65,Ahmad Parvez Iqbal Ahmad Nur Mohammad,YAVATMAL-WASHIM,SP,1,Graduate,3957500,0,3957500
826,Mohd. Mukim,FARIDABAD,National Loktantrik Party,0,10th Pass,3999000,80000,3919000
1493,Usha Sharan,AURANGABAD,Shoshit Samaj Dal,1,Literate,3900000,1000,3899000
1030,Puran Mal,BHIWANI-MAHENDRAGARH,IND,0,10th Pass,4158000,290000,3868000
95,Amita Singh Jaat,ALIGARH,Sarva Samaj Kalyan Party,0,Post Graduate,3865000,0,3865000
640,Khush Dil Sehgal (Kapoor),FARIDABAD,Akhil Bharatiya Hind Kranti Party,0,Post Graduate,3903000,45000,3858000
362,Diwakar Pendam,GADCHIROLI-CHIMUR,Bahujan Mukti Party,0,8th Pass,3850000,0,3850000
348,Dhimati Vidya Kishor Bhimte,RAMTEK,Ambedkarite Party of India,0,Post Graduate,3902394,69000,3833394
990,Poonam Chand,SIRSA,AAP,0,12th Pass,3825442,0,3825442
710,Lukman Khan,NEW DELHI,IND,2,5th Pass,3786699,0,3786699
748,Mamta Rani,HISAR,"Rashtrawadi Parivartan Party (L.B,)",0,8th Pass,3922079,138000,3784079
981,Phool Chand,AMBALA,IND,0,8th Pass,3750000,0,3750000
813,Mohd Hasnan Khan,NORTH EAST DELHI,JKNPP,0,5th Pass,3700000,0,3700000
1001,Pradeep Varma,NEW DELHI,Bharat Vishal Party,0,Graduate Professional,4200000,500000,3700000
883,Naresh Gautam,GHAZIABAD,Bahujan Mukti Party,0,Graduate,3660000,0,3660000
591,K.Sivaraman,THRISSUR,CPI(ML) Red star,1,10th Pass,3658000,0,3658000
1466,Thakare Rameshwar (Rameshwar) Sundarlal,BHANDARA-GONDIYA,SP,0,10th Pass,3700102,74000,3626102
1389,Sudhakar Namdeorao Ghayawan,YAVATMAL-WASHIM,Republican Party of India (Khobragade),0,12th Pass,4025000,400000,3625000
183,Baburao Damaduji Meshram,NAGPUR,IND,0,12th Pass,3810000,200000,3610000
309,Deepak Karma,BASTAR,INC,0,Graduate,3601587,0,3601587
238,Binod Gogoi,KALIABOR,IND,0,Graduate,3600000,0,3600000
851,N J Pious,ERNAKULAM,IND,0,Graduate,3722750,150000,3572750
486,Hirasan Uikey,BALAGHAT,GGP,0,Graduate Professional,3765446,200000,3565446
1338,Shyamkumar Bapurao Lokhande,YAVATMAL-WASHIM,IND,0,Graduate,3564000,0,3564000
58,Adv.M.A.Bindu,ALAPPUZHA,SUCI(C),0,Graduate Professional,3543000,0,3543000
318,Deorao Monba Nannaware,GADCHIROLI-CHIMUR,Ambedkarite Party of India,0,Graduate Professional,4463077,922967,3540110
886,Naresh Mahadeo Patil,RAMTEK,Bahujan Mukti Party,0,Doctorate,3845000,312000,3533000
147,Ashish Bhushan Pathak,CHATRA,IND,0,Post Graduate,3530500,0,3530500
471,Hari Chand Jalmeria,JAMMU,JKNPP,0,Graduate Professional,4004437,500000,3504437
211,Benet Babu Benjamin,THIRUVANANTHAPURAM,IND,0,10th Pass,3503683,0,3503683
1281,Savitri,KARNAL,IND,0,Illiterate,3700000,200000,3500000
1044,Radhakrishnan P T,ERNAKULAM,IND,0,Graduate Professional,3488000,0,3488000
340,Dharamraj,NORTH WEST DELHI,Bhartiya Pragatisheel Congress,0,8th Pass,3486700,0,3486700
107,Anil Kumar Oraon,CHATRA,IND,0,10th Pass,3490000,25000,3465000
685,Ladu Kishore Swain,ASKA,BJD,0,Graduate,3488390,25000,3463390
1304,Shambaba Alias Shamsundar Panjabrao Nichit,WARDHA,IND,0,Post Graduate,4155000,700000,3455000
1527,Vincent,CHALAKUDY,IND,0,10th Pass,4618200,1200000,3418200
377,Dr. Pradeep Rambhau Nagrale,NAGPUR,Ambedkarite Party of India,0,Graduate Professional,8052965,4637487,3415478
17,Abdul Jabbar K K,KANNUR,SDPI,4,10th Pass,3403545,0,3403545
435,Giridhar Gamang,KORAPUT,INC,0,Graduate,5895460,2500000,3395460
1428,Surendra Rajvanshi,NAWADA,SP,0,Graduate,3385189,0,3385189
468,Hansraj Saini,SAHARANPUR,IND,0,Graduate Professional,3411840,42000,3369840
973,Patil Upendra Babarao,YAVATMAL-WASHIM,IND,0,Graduate Professional,3675000,315000,3360000
1194,Roshan Ali,NORTH EAST DELHI,National Loktantrik Party,0,Not Given,3351382,0,3351382
213,Bhagawati Charan Pandey(Neelu),SIDHI,IND,0,Graduate,3425500,100000,3325500
1031,Puran Singh Panwar,KARNAL,Rashtravadi Janata Party,0,Graduate Professional,3621304,296000,3325304
1452,T.Ayyappan,PONNANI,BSP,0,Post Graduate,3324000,0,3324000
128,Arjuna Bhatara,NABARANGPUR,Odisha Jan Morcha,0,Graduate,4137000,815000,3322000
1165,Ratan Chakraborti,TRIPURA WEST,AITC,0,Graduate,3314729,0,3314729
835,Mrinal Kumar Saikia,KALIABOR,BJP,0,Post Graduate,3360000,50000,3310000
765,Manohar Baliram Sonone,AMRAVATI,IND,1,12th Pass,5006000,1705000,3301000
373,Dr. Kshetra Pal Singh,FARIDABAD,IND,0,Graduate Professional,3280000,0,3280000
1435,Suresh Rajaram Mukhmale,YAVATMAL-WASHIM,Maharashtra Vikas Aaghadi,0,12th Pass,3280000,0,3280000
1361,Somaru Paswan,AURANGABAD,IND,0,Literate,3269500,0,3269500
562,Joseph Toppo,TEZPUR,AGP,0,10th Pass,3289490,22904,3266586
198,Balwan Singh,HISAR,IND,0,12th Pass,3560500,300000,3260500
487,Horen Borgohain,JORHAT,AIFB,0,Post Graduate,3260000,800,3259200
1113,Ram Dayal Singh,KARAKAT,IND,0,Graduate,3256600,0,3256600
1317,Shekh Hamid Imam,AKOLA,Bahujan Mukti Party,0,Graduate,3736459,483872,3252587
939,P V Natesan,ALAPPUZHA,BSP,0,Graduate,3219698,0,3219698
1505,Vedparkash Bhartiya,BHIWANI-MAHENDRAGARH,IND,0,10th Pass,3378000,160000,3218000
1150,Ramphal Shakya,GHAZIABAD,IND,0,Not Given,3200000,1077,3198923
1264,Sathyan Mokeri,WAYANAD,CPI,2,Graduate,3697322,502699,3194623
387,Dr. Tarun Kumar,CHANDNI CHOWK,Vishva Shakti Party,0,Graduate Professional,5518804,2334044,3184760
850,N Abdulla Davud,KANNUR,BSP,0,10th Pass,3226369,50000,3176369
1365,Sonia Sharma,GAUTAM BUDHHA NAGAR,Akhil Bharatiya Samajwadi Congress,0,Graduate,3327000,160000,3167000
632,Keshwar Yadav,CHATRA,SP,16,5th Pass,3450487,300000,3150487
436,Girija Kumary,ATTINGAL,BJP,0,12th Pass,3279941,146000,3133941
1417,Sunil Kumar,SOUTH DELHI,IND,0,10th Pass,3125000,0,3125000
1164,Rashmi Kashyap,CHANDNI CHOWK,Bhartiya Pragatisheel Congress,0,10th Pass,3123000,0,3123000
81,Akhei Achumi,NAGALAND,Socialist Party (India),0,Graduate,3122000,0,3122000
847,Musarrat Jahan,CHANDNI CHOWK,Rashtriya Janmorcha,0,Graduate,3119753,0,3119753
1456,Tadas Vilas Krushnaji,WARDHA,IND,0,Graduate,3118896,0,3118896
154,Ashok Kumar,NAWADA,Rajnaitik Vikalp Party,1,Literate,3116000,0,3116000
735,Mahesh,GAUTAM BUDHHA NAGAR,IND,0,Graduate Professional,3101000,0,3101000
161,Ashok Ram,PALAMAU,IND,0,10th Pass,3099116,0,3099116
627,Kavita Vinod Kumar Tibdiwal (Agrawal),NAGPUR,IND,0,Post Graduate,3694650,600000,3094650
1513,Vijay Kumar Chourasiya,KODARMA,AAP,1,Graduate,3704548,620968,3083580
331,Dhananjay Shamlalji Rajabhoj,BHANDARA-GONDIYA,IND,0,Post Graduate,3070000,0,3070000
223,Bhupeshwar Dayal,SONIPAT,IND,0,Graduate Professional,3058174,0,3058174
455,Gurmeet Singh,KURUKSHETRA,Lok Dal,0,Graduate,3125677,69000,3056677
1541,Visheshwar Prasad,KODARMA,BSP,0,8th Pass,4850000,1800000,3050000
1509,Velayudhan K. P.,KOZHIKODE,BSP,0,10th Pass,3539300,500000,3039300
1345,Silvi Sunil,IDUKKI,AAP,0,Others,3080470,45000,3035470
741,Mahgoo,SATNA,Dalit Vikas Party(Bharat),0,Graduate,3027000,0,3027000
1258,Saseendran,VADAKARA,BSP,0,5th Pass,3271000,250000,3021000
545,Jay Prakash Patel,HOSHANGABAD,GGP,0,10th Pass,3411000,400000,3011000
1271,Satish Kumar Minz,SUNDARGARH,IND,0,Post Graduate,3008000,0,3008000
885,Naresh Kumar,BHIWANI-MAHENDRAGARH,SP,0,Not Given,2992100,0,2992100
197,Balram Bari,CHANDNI CHOWK,IND,0,8th Pass,2980000,0,2980000
379,Dr. Rajesh Mahendia,HISAR,IND,0,Doctorate,3298180,350000,2948180
293,Dadhibal,SATNA,Apna Dal,0,Post Graduate,2933600,0,2933600
1343,Siddharth Raut,CHANDRAPUR,Prabuddha Republican Party,0,Post Graduate,3927422,1000000,2927422
458,Gurudas Uddhav Bawane,RAMTEK,IND,0,12th Pass,3742000,820000,2922000
864,Namdeo Anandrao Kannake,GADCHIROLI-CHIMUR,CPI,0,Graduate,3322000,400000,2922000
911,Nirmala,FARIDABAD,JD(U),0,Illiterate,2914700,0,2914700
242,Birendra Bhagat,LOHARDAGA,JVM,0,10th Pass,2911000,0,2911000
54,Adv.Bindhu Krishna,ATTINGAL,INC,2,Post Graduate,3764729,853967,2910762
1411,Sunil Chandra Naik,KALAHANDI,Odisha Jan Morcha,0,Graduate Professional,2900000,0,2900000
943,P.K.Biju,ALATHUR,CPI(M),0,Post Graduate,3231047,341749,2889298
820,Mohd. Alim Patel Mohd. Wahid,WARDHA,AAP,0,Post Graduate,2882200,0,2882200
1500,Vappan,WAYANAD,BSP,0,Graduate Professional,3725000,888817,2836183
982,Phool Singh Dhurwey,MANDLA,CSM,3,Graduate,2820609,20000,2800609
656,Krishna Das,KARIMGANJ,BJP,0,12th Pass,2794334,0,2794334
1146,Rammurti Keshvrao Chimote,NAGPUR,GGP,0,12th Pass,2792000,0,2792000
269,Chavan Vinod Narayan,YAVATMAL-WASHIM,IND,0,10th Pass,3361500,570000,2791500
384,Dr. Sunilbhau Vishwanathji Narnavre,RAMTEK,Republican Party of India (Khobragade),0,Not Given,2760000,0,2760000
1463,Tej Pal Singh,SOUTH DELHI,IND,0,10th Pass,2755320,0,2755320
19,Abdul Kareem,CHALAKUDY,IND,0,10th Pass,2746000,0,2746000
1514,Vijay Kumar Sharma,HISAR,IND,0,Post Graduate,2730250,0,2730250
1468,Thennilapuram Radhakrishnan,PALAKKAD,Welfare Party Of India,0,10th Pass,2994408,270000,2724408
335,Dharambir S/O Banwari,BHIWANI-MAHENDRAGARH,IND,0,Illiterate,2715000,0,2715000
1339,Shyamlal Kushwaha,SATNA,GGP,0,Post Graduate,2689000,0,2689000
297,Dalchand,NEW DELHI,IND,0,8th Pass,2970854,300000,2670854
947,Padam Chand,EAST DELHI,IND,0,10th Pass,2670000,0,2670000
755,Mange Ram Kashyap,MUZAFFARNAGAR,Majdoor Kisan Union Party,0,Graduate Professional,2663000,0,2663000
29,Abdurahiman Vayarakath,PONNANI,IND,0,Literate,3037410,375000,2662410
176,Atul Ashok Munginwar,CHANDRAPUR,IND,1,12th Pass,3400000,740000,2660000
1144,Ramkaran,KAIRANA,Bhartiya Vanchitsamaj Party,0,Post Graduate,2659619,0,2659619
1484,Umakant Rahi,NAWADA,Shoshit Samaj Dal,0,Post Graduate,2610034,0,2610034
1025,Premachandran,KOLLAM,IND,1,10th Pass,2605267,0,2605267
226,Bidhan Chandra Panda,BERHAMPUR,Samata Kranti Dal,0,10th Pass,3551085,950000,2601085
21,Abdul Majid Chouhan,JAMMU,IND,0,10th Pass,2600000,0,2600000
764,Manju Kumari,KODARMA,AITC,0,Post Graduate,2598000,0,2598000
1051,Raghuveer Singh Bodh,SAHARANPUR,IND,0,8th Pass,2590110,0,2590110
271,Chengara Surendran,MAVELIKKARA,CPI,1,Graduate,3363470,794051,2569419
1436,Suresh Udhavrao Shinde,NAGPUR,IND,0,Graduate Professional,2545000,0,2545000
30,Abhimod,PALAKKAD,IND,0,Post Graduate,2908779,370000,2538779
871,Nandkishor Gangaram Rangari,CHANDRAPUR,Aambedkar-right Party of India,0,Post Graduate,4111000,1580000,2531000
1273,Satish Poonchi,JAMMU,IND,0,10th Pass,2513000,0,2513000
49,Adv. Perurkada Harikumar,THIRUVANANTHAPURAM,SHS,4,Graduate Professional,2511500,0,2511500
1218,Sajjan Singh,ROHTAK,IND,0,Illiterate,2761000,250000,2511000
421,Gaur Chandra Majumder,ANDAMAN & NICOBAR ISLANDS,BSP,0,Graduate,3192819,688689,2504130
1137,Ramesh Singh Siral,NORTH EAST DELHI,Naya Daur Party,0,8th Pass,2490000,0,2490000
1060,Raj Kumar Nagar,SIRSA,SP,0,Graduate,5675000,3200000,2475000
706,Lingaraj Pradhan,BARGARH,AAP,0,Post Graduate,2470000,0,2470000
316,Densil Mendez,ERNAKULAM,JD(U),0,10th Pass,2634109,169614,2464495
539,Jarnail Singh S/O Rajinder Singh,WEST DELHI,IND,0,10th Pass,2457012,0,2457012
24,Abdul Salam N U,KASARAGOD,SDPI,1,Post Graduate,3620329,1182188,2438141
493,Inder Singh,NORTH WEST DELHI,Asankhya Samaj Party,0,10th Pass,2437000,0,2437000
1373,Sri. Hariharan K S,ATTINGAL,IND,0,Graduate Professional,2401400,0,2401400
1145,Ramla Mampad,WAYANAD,Welfare Party of India,0,12th Pass,2401057,0,2401057
1393,Sudhindra Chandra Dasgupta,TRIPURA WEST,BJP,0,Graduate,2385517,0,2385517
1327,Shravan Kumar Asija,HISAR,IND,0,12th Pass,2380000,0,2380000
1259,Sasidharan K V,KANNUR,AAP,0,Post Graduate,2730285,360000,2370285
1432,Suresh,ATTINGAL,IND,0,8th Pass,2360000,0,2360000
243,Birendra Singh,SATNA,IND,0,12th Pass,2451500,100000,2351500
553,Jitan Ram Manjhi,GAYA,JD(U),0,Graduate,2360142,13109,2347033
1385,Subhash Chand Kashyap,BAGHPAT,IND,0,Post Graduate,2539312,200000,2339312
528,Jaipal Bhatti,SIRSA,IND,0,5th Pass,2300000,0,2300000
133,Arun Kumar Bhowmik,TRIPURA WEST,SUCI(C),0,Graduate,2443828,145939,2297889
442,Gopinathan.N,MALAPPURAM,IND,0,Post Graduate,2486000,201347,2284653
250,Brmhadatta Mishra Urf Chote,REWA,IND,0,12th Pass,2283500,0,2283500
1057,Raj Kumar,JAMMU,IND,0,12th Pass,2268500,0,2268500
121,Anuj Ganga Singh Patta,MANDLA,GGP,0,Graduate,4480097,2220000,2260097
805,Mohammed Naeem,EAST DELHI,IND,1,10th Pass,2314000,59000,2255000
402,Edappally Basheer,CHALAKUDY,IND,0,Graduate,4228516,2000000,2228516
320,Deshmukh Jaideep Rajendra,WARDHA,IND,1,Post Graduate,2227258,0,2227258
950,Padmaja Kandukuri,NEW DELHI,IND,0,Not Given,2367592,180000,2187592
1257,Saroj Ram,SASARAM,Bahujan Mukti Party,0,Graduate Professional,2255786,80350,2175436
959,Parameswar Kand,KALAHANDI,Samata Kranti Dal,1,12th Pass,2270000,100000,2170000
1241,Sanjay Nilkanth Gawande,CHANDRAPUR,IND,0,12th Pass,2170000,0,2170000
733,Mahendra Oraon,LOHARDAGA,IND,0,12th Pass,2180000,20000,2160000
604,Kamal Kanti Debnath,TRIPURA WEST,IND,0,10th Pass,2569416,414150,2155266
1465,Tetari Devi,SASARAM,CPI(ML)L,0,Literate,2138858,0,2138858
206,Basant Panwar,NORTH WEST DELHI,BSP,0,8th Pass,2162778,27500,2135278
1424,Sunita Chaudhary,NEW DELHI,JKNPP,0,10th Pass,2129016,3180,2125836
1519,Vijay Shankar Chaubey,CHANDNI CHOWK,IND,0,12th Pass,2105641,0,2105641
1402,Sukharam Astkar Lanji,BALAGHAT,IND,0,Post Graduate,2102000,0,2102000
464,Haji Moideen Shah,THRISSUR,JD(U),0,Others,2100000,0,2100000
66,Ahshan Ali,GURGAON,IND,0,Graduate,2090000,0,2090000
145,Ashatai Abhyankar Amravati,AMRAVATI,IND,0,Graduate,3450000,1360000,2090000
572,K Ambujakshan,CHALAKUDY,Welfare Party Of India,1,Post Graduate,2134142,82000,2052142
1460,Tarani Bhoi,SAMBALPUR,Paschimanchal Vikas Party,0,10th Pass,2587176,547876,2039300
1517,Vijay Raj,FARIDABAD,IND,0,Post Graduate,2035329,0,2035329
1172,Rathod Naresh Fulsing,YAVATMAL-WASHIM,AAP,0,Graduate Professional,2030000,0,2030000
262,Chandradhwaja Majhi,NABARANGPUR,IND,0,Graduate,2028926,0,2028926
1356,Smt. Shobha Surendran,PALAKKAD,BJP,4,12th Pass,2027210,0,2027210
305,Davinder Kumar,KURUKSHETRA,IND,2,12th Pass,2275000,250000,2025000
1160,Ranjit Oraon,LOHARDAGA,IND,0,12th Pass,2024021,0,2024021
922,Om Parkash,HISAR,Bharatiya Sant Mat Party,0,10th Pass,2024000,0,2024000
1521,Vijayaraghavan .K,KOZHIKODE,IND,0,8th Pass,2006500,0,2006500
192,Balasaheb Shankar Darade,BULDHANA,IND,0,Post Graduate,2334214,331493,2002721
1235,Sanjay Kewat,KARAKAT,BSP,0,Graduate,1997000,0,1997000
365,Dr Bansidhar Tripathy,ASKA,AITC,0,Doctorate,1991383,0,1991383
549,Jayram Indwar,LOHARDAGA,BSP,0,12th Pass,1965000,0,1965000
1221,Sam P Mathew,WAYANAD,CPI(ML) Red star,4,12th Pass,1934280,0,1934280
449,Gufran Ahamad,MUZAFFARNAGAR,IND,0,12th Pass,2054600,125000,1929600
842,Mukesh Kumar Singh,FARIDABAD,IND,0,12th Pass,1928506,0,1928506
430,Ghaywan Roshan Jambuwantrao,CHANDRAPUR,Republican Party (Khoripa),0,Post Graduate,1921000,0,1921000
210,Basu Mog,TRIPURA EAST,IND,0,10th Pass,1911085,0,1911085
1280,Savio Oliver Rodrigues,SOUTH GOA,Goa Su-Raj Party,0,Graduate Professional,1892000,0,1892000
1200,S Radhakrishnan,PATHANAMTHITTA,IND,0,12th Pass,1875000,0,1875000
718,M. Baby,KOLLAM,IND,0,10th Pass,1871596,0,1871596
234,Biju Joseph,IDUKKI,IND,0,10th Pass,1867208,0,1867208
182,Babu Singh Dukhiya,WEST DELHI,IND,1,Graduate,1851000,0,1851000
774,Manoj Yadav,GURGAON,IND,0,12th Pass,3298000,1450000,1848000
151,Ashok Kumar,GAYA,JMM,0,Post Graduate,1843000,0,1843000
1080,Rajendrakumar Punjabrao Kanphade,NAGPUR,IND,0,Graduate,1841093,0,1841093
185,Bagi Lakra,SUNDARGARH,BSP,1,Graduate Professional,1925530,88983,1836547
890,Nasir Ahmed,JORHAT,AIUDF,0,Graduate,1830000,0,1830000
220,Bhuneswar Das,GAYA,Rashtriya Ahinsa Manch,0,Literate,1829000,0,1829000
1203,Sabir,GHAZIABAD,IND,0,Others,1836155,16555,1819600
1217,Saji Thuruthikunnel,CHALAKUDY,SHS,3,12th Pass,3017995,1206000,1811995
608,Kameshwar Baitha,PALAMAU,AITC,48,10th Pass,1808000,0,1808000
862,Najrul Hassan Hashmi,KODARMA,AJSUP,0,Literate,1800614,0,1800614
1100,Rakesh,MUZAFFARNAGAR,IND,0,12th Pass,1818316,28990,1789326
1117,Ram Kishan,KURUKSHETRA,Lok Parivartan Party(DC),0,10th Pass,1785984,0,1785984
1238,Sanjay Mahadev Wankhade,BULDHANA,IND,0,Graduate,2037000,260000,1777000
85,Ali Akbar,VADAKARA,AAP,0,12th Pass,4448946,2674831,1774115
1300,Shajumon Vattekad,ALATHUR,BJP,0,10th Pass,1772801,32653,1740148
744,Malkhan Patel,JABALPUR,IND,0,Not Given,1738000,0,1738000
900,Nawal Kishor Singh,LOHARDAGA,IND,0,10th Pass,1733000,0,1733000
542,Jasvinder,KURUKSHETRA,IND,0,5th Pass,1730088,0,1730088
94,Amit Kumar Sharma,NORTH EAST DELHI,IND,0,Graduate,1710000,0,1710000
704,Laxminarayan Dehariya,BALAGHAT,Bahujan Mukti Party,1,12th Pass,1710000,0,1710000
600,Kamakhya Prasad Tasa,JORHAT,BJP,0,Post Graduate,1694785,0,1694785
261,Chandradev Thakur,CHATRA,Socialist Party (India),0,8th Pass,1683317,0,1683317
736,Mahesh Chandra Mohanty,ASKA,BJP,0,Graduate,2702481,1021000,1681481
1175,Ravi Alias Shailesh Ganeshrao Yelne,WARDHA,IND,0,Graduate,1671754,0,1671754
585,K. Shyambabu Subudhi,ASKA,IND,0,10th Pass,1660000,0,1660000
801,Mohammad Jahid Husain,NAWADA,AITC,0,Graduate,1657448,0,1657448
1443,Sushma Mehta,PALAMAU,CPI(ML)L,6,12th Pass,2305547,651713,1653834
229,Bijender Kumar,SONIPAT,IND,0,10th Pass,1650000,0,1650000
1127,Rambadan Ram,PALAMAU,SP,0,Post Graduate,2450000,800000,1650000
1152,Ramrao Govinda Nannaware,GADCHIROLI-CHIMUR,BSP,0,Graduate,2671687,1030335,1641352
798,Mithual Kumar,KALIABOR,AIFB,0,8th Pass,1630000,0,1630000
1159,Ranjeet Amardas Sukhdeve,BHANDARA-GONDIYA,Ambedkar samaj Party,0,12th Pass,1854500,225000,1629500
1226,Sanat Kumar Tripathi,SIDHI,Bhartiya Shakti Chetna Party,1,12th Pass,1615000,0,1615000
1476,Uday Alies Udayveer,BIJNOR,Bharatiya Momin Front,1,Not Given,1610000,0,1610000
601,Kamal,BIJNOR,IND,0,5th Pass,1606593,0,1606593
615,Kapil Choudhary,GAYA,AITC,0,12th Pass,1606000,0,1606000
284,Chuni Manoj Kumar,KURUKSHETRA,IND,0,5th Pass,1593000,0,1593000
1316,Sheeba K A,ALATHUR,INC,0,Post Graduate,2903410,1310606,1592804
80,Akbar Kasmi,GURGAON,Rashtriya Ulama Council,0,Others,1592000,0,1592000
1041,R.D. Vishwkarma,REWA,Apna Dal,0,10th Pass,1575000,0,1575000
179,B Padmanabhan,PALAKKAD,AAP,0,Graduate,1573288,0,1573288
1542,Vishnu Bhagwan,KURUKSHETRA,IND,1,Graduate Professional,1946070,379840,1566230
344,Dharmender Singh,CHANDIGARH,Hindustan Ekta Party,0,Graduate,1623000,70000,1553000
278,Chitter Singh Bali,BHIWANI-MAHENDRAGARH,IND,0,10th Pass,2196500,650000,1546500
312,Deepak Shukla,CHANDIGARH,IND,0,Graduate,1874000,338837,1535163
1032,Purnanand Tiwari,REWA,AAP,0,Post Graduate,1533286,0,1533286
355,Dilip Paswan,JAMUI,IND,0,10th Pass,1531232,0,1531232
1534,Vinod Ram,PALAMAU,IND,0,12th Pass,1526001,0,1526001
667,Kuldeep S/O Ishwar Singh,HISAR,IND,0,Graduate,1522160,0,1522160
98,Anil,ROHTAK,Rashtriya Bahujan Hitay Party,0,10th Pass,1520000,0,1520000
795,Mirza Vahed Beg Ahmadbeg,BHANDARA-GONDIYA,IND,0,12th Pass,1513581,0,1513581
1442,Sushil Nidhi,HISAR,IND,0,12th Pass,2306220,800000,1506220
1359,Solomon George,NEW DELHI,BSP,0,Post Graduate,1501750,0,1501750
158,Ashok Kumar Vashishth,SONIPAT,RPI(A),0,10th Pass,1501000,0,1501000
100,Anil,MEERUT,IND,0,12th Pass,1594367,104944,1489423
848,Musthafa Kommeri,KOZHIKODE,SDPI,1,Graduate,1489200,0,1489200
960,Paramjit Singh,KARNAL,AAP,0,Graduate,2863613,1382819,1480794
391,Drupad Borgohain,JORHAT,CPI,0,Graduate,1479690,0,1479690
117,Ankush Vijayrao Nawale,WARDHA,SP,0,Graduate Professional,1551000,72000,1479000
1114,Ram Gopal Singh,SHAHDOL,Bhartiya Shakti Chetna Party,0,8th Pass,1475529,0,1475529
595,Kadir Khan Jaiswal,GAUTAM BUDHHA NAGAR,IND,0,8th Pass,1461000,0,1461000
1294,Shahid Sharif,NAGPUR,JD(U),0,Graduate,1450325,0,1450325
1529,Vinod Ankush Nannaware,GADCHIROLI-CHIMUR,SP,0,10th Pass,1969000,520000,1449000
1140,Rameshwar Prasad Yadav,KODARMA,IND,0,Post Graduate,1488300,45000,1443300
1215,Sahdev Singh Paraste,SHAHDOL,National Peoples Party,0,Post Graduate,1586000,150000,1436000
509,Jagannath Tiwari,EAST DELHI,IND,0,12th Pass,1476456,43236,1433220
336,Dharambir Singh,BHIWANI-MAHENDRAGARH,IND,0,Post Graduate,1424342,0,1424342
1346,Sima Chandravansi,CHATRA,AAP,0,Graduate Professional,1535000,120000,1415000
1498,V.K. Sajeeva,VADAKARA,BJP,2,Graduate Professional,2534579,1125903,1408676
751,Manbodh Baghel,BASTAR,BSP,0,Graduate Professional,1405000,0,1405000
23,Abdul Muneer,LAKSHADWEEP,CPI(M),0,Post Graduate,1395365,0,1395365
1010,Pranav Kumar Verma,KODARMA,JVM,0,Post Graduate,1386131,0,1386131
1186,Ribulaya Gogoi,JORHAT,AITC,0,10th Pass,1383171,0,1383171
936,P P Aboobacker,KANNUR,CPI(ML) Red star,0,10th Pass,1375736,0,1375736
1341,Siba Hati,KALAHANDI,SP,0,8th Pass,1474000,100000,1374000
758,Manish Kumar,NAWADA,IND,2,Graduate,1798755,428000,1370755
1329,Shri Parikshit Debbarma,TRIPURA EAST,BJP,0,10th Pass,1382000,30900,1351100
429,Ghanshyam Kudape,MANDLA,IND,0,10th Pass,1351051,0,1351051
299,Dan Bahadur Yadav,NORTH EAST DELHI,IND,0,Graduate,1345000,0,1345000
938,P R Rasmilnath,WAYANAD,BJP,0,Graduate,1445000,100000,1345000
114,Anju Urf Muskan,BULANDSHAHR,RLD,0,12th Pass,2995000,1656134,1338866
53,Adv.A.N.Shamseer,VADAKARA,CPI(M),0,Graduate Professional,1330825,0,1330825
1187,Richard D. Shabong,SHILLONG,CPI,0,12th Pass,1328273,0,1328273
108,Anilkumar R,KOTTAYAM,AAP,0,Post Graduate,1686239,360000,1326239
1246,Sankar Prasad Datta,TRIPURA WEST,CPI(M),1,Post Graduate,1320900,0,1320900
1524,Vimla Shoree,BASTAR,CPI,0,Graduate Professional,1520000,200000,1320000
691,Lal Say Kumar Bhagat,LOHARDAGA,CPI(ML)L,0,12th Pass,1319000,0,1319000
1072,Rajen Saikia,TEZPUR,AIFB,0,10th Pass,1318447,0,1318447
1405,Sukhveer,FARIDABAD,Rashtriya Bahujan Congress Party,0,5th Pass,1303736,0,1303736
1247,Sankar Sahu,ASKA,CPI(ML) Red star,0,Post Graduate,1294992,0,1294992
134,Arun Nagorao Gajbhiye,BHANDARA-GONDIYA,IND,0,Graduate,1295000,8382,1286618
166,Ashwani Malhotra,KURUKSHETRA,AITC,0,10th Pass,1284743,0,1284743
1228,Sandesh Ashok Ambedkar,BULDHANA,Bahujan Mukati Party,0,Post Graduate,1280500,0,1280500
398,Dwarka Prasad Pahade,CHHINDWARA,IND,0,12th Pass,1276700,0,1276700
1307,Shanbhulal,MANDLA,BSP,0,10th Pass,1275000,0,1275000
637,Kheme Thakur,FARIDABAD,SP,1,Graduate,1267000,0,1267000
699,Lambodar Kanhar,KANDHAMAL,IND,2,Graduate Professional,1303200,38000,1265200
1290,Shafeer Muhammed,CHALAKUDY,SDPI,3,10th Pass,1435046,170695,1264351
839,Mukesh Babu Ahirwar,HOSHANGABAD,IND,0,10th Pass,1260000,0,1260000
1143,Ramji Singh,AURANGABAD,IND,0,Post Graduate,1310000,50000,1260000
1147,Ramnaresh Singh,CHATRA,CPI(ML)L,4,10th Pass,1255000,0,1255000
1559,Yogesh Kumar Singh Ad.,SHAHDOL,SP,0,Graduate Professional,1251141,1820,1249321
1180,Ravinder Kumar,ROHTAK,Indian Bahujan Sandesh Party (Kanshiram),0,12th Pass,1245000,0,1245000
1413,Sunil Dattu Pendor,NAGPUR,Bahujan Mukti Party,0,Post Graduate,1218560,0,1218560
580,K S Velayudhan,ALATHUR,IND,0,10th Pass,1211050,0,1211050
919,O Rajagopal,THIRUVANANTHAPURAM,BJP,0,Graduate Professional,1211046,0,1211046
119,Anto Antony,PATHANAMTHITTA,INC,0,Graduate,5410884,4211050,1199834
1214,Sahadev Jal,KALAHANDI,Bahujan Mukti Party,0,Graduate,1199800,0,1199800
122,Anup Phukon,DIBRUGARH,AGP,0,Post Graduate,4737100,3549764,1187336
639,Khuman Singh Armo,MANDLA,AAP,0,12th Pass,1178622,0,1178622
1185,Rejamond Ali Barbhuiya,SILCHAR,CPI(M),0,Graduate Professional,1164212,0,1164212
913,Nishant Tyagi,BAGHPAT,IND,0,12th Pass,1147000,0,1147000
582,K Sudhakaran (Kollon House),KANNUR,IND,0,Post Graduate,1898622,756505,1142117
1085,Rajesh Kumar,NORTH WEST DELHI,Rashtriya Bahujan Hitay Party,0,10th Pass,1141000,0,1141000
1565,Zanzad Shalikram Shankarrao,BHANDARA-GONDIYA,IND,0,8th Pass,1140019,0,1140019
187,Bahadur Singh Chowdhary,JAMMU,SP,0,Graduate,1431120,298000,1133120
1042,R.S.Uma Bharatthy,ANDAMAN & NICOBAR ISLANDS,NCP,0,Post Graduate,1380999,253000,1127999
1374,Sri. Vakkom G Ajith,ATTINGAL,SHS,0,12th Pass,1120000,0,1120000
1313,Sharafudheen,VADAKARA,IND,0,12th Pass,1119368,0,1119368
1132,Ramesh Chand,AMBALA,IND,0,10th Pass,1110000,0,1110000
1047,Raghubir Singh,ANDAMAN & NICOBAR ISLANDS,SP,1,8th Pass,1128697,20000,1108697
652,Kripashankar Yadav,CHHINDWARA,IND,0,12th Pass,1106345,0,1106345
251,C B Chandrababu,ALAPPUZHA,CPI(M),10,Graduate Professional,1466177,360075,1106102
901,Nazarudheen,MALAPPURAM,SDPI,5,10th Pass,1855691,750000,1105691
219,Bhriguram Reang,TRIPURA EAST,AITC,0,12th Pass,1132884,31473,1101411
1284,Sayyad Afjalali Alias Chhanubhai,BHANDARA-GONDIYA,Minorities democratic party,0,5th Pass,1093000,0,1093000
1544,Vishnu Dutt,ROHTAK,IND,0,10th Pass,1166047,80000,1086047
135,Arun Thakur,EAST DELHI,Samyak Parivartan Party,0,12th Pass,1081500,0,1081500
1249,Santhosh Kumar,PATHANAMTHITTA,IND,3,Graduate Professional,1081000,0,1081000
1324,Shiv Shankar Kumar,GAYA,Bharat Bhrashtachar Mitao Party,0,Graduate,1067800,0,1067800
1496,V S Shanavas,PALAKKAD,IND,4,10th Pass,1401101,333500,1067601
1276,Satpal S/O Sube,BHIWANI-MAHENDRAGARH,IND,0,12th Pass,2766000,1700000,1066000
1119,Ram Nayak,KANDHAMAL,BSP,0,5th Pass,1774911,713000,1061911
1444,Sushma Vitthal Nagpure,BHANDARA-GONDIYA,IND,0,12th Pass,1060000,0,1060000
683,Kutub Ahmed Mazumder,SILCHAR,AIUDF,0,Graduate,1249603,190679,1058924
200,Balwant Singh,SIRSA,Bharatiya Sant Mat Party,0,10th Pass,1053000,0,1053000
86,Ali Husan,NORTH EAST DELHI,IND,0,5th Pass,1047500,0,1047500
301,Daryl William Ch Momin,TURA,INC,0,Post Graduate,1250390,204472,1045918
924,Ombir,BHIWANI-MAHENDRAGARH,Lok Parivartan Party(DC),0,10th Pass,1040000,0,1040000
724,M.T. Ramesh,PATHANAMTHITTA,BJP,0,Graduate,1039808,0,1039808
564,Joyce George,IDUKKI,IND,0,10th Pass,1034810,0,1034810
964,Parmendra Kumar Yadav,NAWADA,Bharatiya Ekta Dal,0,12th Pass,1030800,0,1030800
240,Bir Singh Soni,CHANDNI CHOWK,IND,0,12th Pass,1030100,0,1030100
715,M Khamchinpau Zou,OUTER MANIPUR,AAP,0,Post Graduate,1010616,0,1010616
831,Mohd.Usman Ghazi,MEERUT,Rashtriya Apna Dal,0,12th Pass,1005000,0,1005000
1229,Sandesh Bhivram Bhalekar,RAMTEK,AIFB,0,Graduate Professional,1003000,0,1003000
992,Prabhat Kumar Mahanty,ASKA,AAP,1,Graduate,989407,0,989407
547,Jayachandran Sarasamma,ALAPPUZHA,IND,1,Post Graduate,1587262,600000,987262
743,Mahmood Hassan,KARNAL,IND,0,8th Pass,1622345,640000,982345
363,Dongre Ashok Namaji,RAMTEK,IND,0,5th Pass,980000,0,980000
980,Phaljit Mahto,KODARMA,IND,0,Illiterate,995000,15000,980000
1141,Rameshwar Teli,DIBRUGARH,BJP,0,10th Pass,977943,0,977943
146,Ashish,KARNAL,AIFB,0,Graduate,2077000,1100000,977000
389,Dr.Kohapare Harshawardhan Muneshwar,BHANDARA-GONDIYA,Bahujan Mukti Party,0,Graduate Professional,980000,14000,966000
669,Kuldeep S/O Madan Lal,HISAR,IND,0,5th Pass,1012562,48000,964562
167,Ashweng J. Rengma,AUTONOMOUS DISTRICT,JMM,0,10th Pass,960000,0,960000
840,Mukesh Kumar,MEERUT,IND,0,Graduate Professional,2150500,1200000,950500
353,Dildar Hussain Beg,CHANDNI CHOWK,IND,0,12th Pass,946408,0,946408
490,Illyas,MALAPPURAM,BSP,0,10th Pass,988156,44000,944156
1074,Rajender,FARIDABAD,IND,0,10th Pass,940500,0,940500
567,Juno John Baby,ERNAKULAM,IND,0,Others,934581,0,934581
879,Narendra Mohanty,KANDHAMAL,AAP,9,Post Graduate,1217466,287074,930392
1291,Shahanavaj,SAHARANPUR,Rashtriya Janmorcha,0,12th Pass,919230,0,919230
797,Mister Alam Asrafee,CHATRA,Rashtriya Jankranti Morcha,0,Graduate,911000,0,911000
603,Kamal Das,SILCHAR,IND,0,5th Pass,900802,0,900802
73,Ajay Pratap Singh,SATNA,IND,0,12th Pass,900000,0,900000
659,Krishnan Eranhikkal,ALATHUR,SDPI,0,12th Pass,903301,20000,883301
1301,Shakeel Ahmed,EAST DELHI,Jai Maha Bharath Party,0,12th Pass,882000,0,882000
290,Comrade Ram Kumar,SIRSA,CPI(M),0,12th Pass,877705,0,877705
963,Pardip,KAIRANA,Bahujan Mukti Party,0,12th Pass,871000,0,871000
961,Pardaeshi Lal Uikey,CHHINDWARA,GGP,0,12th Pass,864500,0,864500
308,Deepak Gaur,FARIDABAD,Aarakshan Virodhi Party,0,12th Pass,1183000,325000,858000
629,Keshab Gogoi,LAKHIMPUR,IND,0,Graduate,858000,0,858000
91,Amarson Sankhil,OUTER MANIPUR,IND,0,Post Graduate,857093,0,857093
174,Athawaley Sanjay Hiramanji,AMRAVATI,IND,1,Graduate,1120000,268900,851100
660,Krishnankutty M.K.,ERNAKULAM,CPI(ML) Red star,0,10th Pass,879121,40000,839121
988,Piravathoor Sreedharan,MAVELIKKARA,IND,0,Post Graduate,829000,0,829000
1050,Raghuraj Pratap Singh,BULANDSHAHR,Rashtriya Kranti Party,0,12th Pass,849500,21000,828500
448,Grisa Kumar,GAUTAM BUDHHA NAGAR,IND,0,8th Pass,828000,0,828000
1520,Vijayan Ambalakkad,ALATHUR,IND,2,10th Pass,825077,0,825077
272,Cheni Ram Moran,DIBRUGARH,AIFB,0,10th Pass,824337,0,824337
42,Adv. Chirayinkeezhu Gopinathan,ATTINGAL,RPI(A),0,Graduate Professional,920662,100000,820662
650,Kismat Sharma,KARNAL,IND,0,10th Pass,1350000,540000,810000
1475,Ubale Shrikrushna Champatrao,WARDHA,Ambedkarwadi Republican Party,1,Graduate Professional,919000,110000,809000
1289,Shabnam,MUZAFFARNAGAR,IND,0,Literate,805000,0,805000
1348,Sita Ram,HISAR,IND,0,Graduate,1200500,400000,800500
700,Lamlalmoi@ Momoi Gangte,OUTER MANIPUR,CPI(ML)L,0,Graduate,800000,0,800000
1118,Ram Kishan Nirat (Saket),REWA,RPI(A),1,Post Graduate,897056,100000,797056
1325,Shivnath Sav,KODARMA,IND,0,8th Pass,911000,121000,790000
41,Adv. Basheer Alady,KASARAGOD,BSP,0,Post Graduate,785138,0,785138
1163,Rashid Ahmed Laskar,SILCHAR,SP,0,12th Pass,785000,0,785000
1387,Subu Kechi,ARUNACHAL WEST,IND,1,Graduate Professional,785000,0,785000
1508,Veerendrakumar,PALAKKAD,IND,0,5th Pass,835000,66000,769000
338,Dharampal Dhiman,KURUKSHETRA,IND,0,10th Pass,765000,0,765000
446,Goutam Shriram Wasnik,RAMTEK,IND,0,8th Pass,764000,0,764000
115,Anjuman Agnihotri,NEW DELHI,IND,0,12th Pass,930631,169975,760656
756,Mangleshwar Bhaiya,REWA,Naya Daur Party,0,12th Pass,760000,0,760000
515,Jagdish,SIRSA,IND,0,Graduate,759500,0,759500
734,Mahendra Ravidas,KODARMA,Bahujan Mukti Party,0,Graduate,889868,133210,756658
677,Kunnil Shajahan,THIRUVANANTHAPURAM,SDPI,3,Graduate,1105500,350000,755500
1340,Shylock P.V.,PONNANI,AAP,1,Graduate,3748638,3000000,748638
548,Jayanta Mallick,SILCHAR,IND,1,Graduate,777174,43000,734174
925,Ombir,SOUTH DELHI,Bharatiya Bahujan Party,0,12th Pass,732000,0,732000
952,Pale Ram Kashyap,KARNAL,Rashtriya Janshakti Party(Eklavya),0,10th Pass,731148,0,731148
393,Durga Thakur,AURANGABAD,IND,0,10th Pass,730000,0,730000
1507,Veena Bharti,KARAKAT,JPS,0,8th Pass,729000,0,729000
762,Manjeet Singh,SIRSA,IND,0,5th Pass,710000,0,710000
263,Charan Jeet Singh,WEST DELHI,AIFB,0,Post Graduate,709000,0,709000
1064,Raj Singh,HISAR,IND,0,Others,708500,0,708500
227,Bighna Raj Panda,KALAHANDI,Samruddha Odisha,1,12th Pass,764550,58637,705913
44,Adv. M. R. Sarin,ATTINGAL,JD(U),0,Graduate Professional,790325,87000,703325
364,Dongre Priya Anil,AMRAVATI,IND,0,8th Pass,702059,0,702059
1211,Sagar Ram,CHATRA,Akhil Bharat Hindu Mahasabha,0,Literate,700000,0,700000
1318,Sher Singh,BHIWANI-MAHENDRAGARH,IND,0,10th Pass,1200000,500000,700000
1488,Upendra Chandra Das,SILCHAR,IND,0,8th Pass,695001,0,695001
1447,Swati Kerkar,SOUTH GOA,AAP,0,12th Pass,693648,0,693648
578,K P Ratheesh,KOZHIKODE,AAP,0,Others,737252,45000,692252
235,Bilasini Nayak,KANDHAMAL,Aama Odisha Party,0,10th Pass,691500,0,691500
869,Nand Lal Ram,SASARAM,IND,0,8th Pass,688000,0,688000
694,Lalit Chauhan,MUZAFFARNAGAR,JD(U),0,12th Pass,685000,0,685000
827,Mohd. Sabir Ansari,GAUTAM BUDHHA NAGAR,AITC,0,5th Pass,681600,0,681600
1561,Yudhvir,HISAR,IND,0,10th Pass,675000,0,675000
1097,Raju Mahadeorao Sonone,AMRAVATI,IND,0,Graduate,674000,0,674000
1103,Rakesh Kumar,SOUTH DELHI,IND,0,10th Pass,660800,0,660800
866,Namdeo Shedmake,CHANDRAPUR,IND,1,10th Pass,1074059,425000,649059
1244,Sanjit Kumar Das,KARIMGANJ,IND,0,10th Pass,640607,0,640607
643,Kiran Pal Singh,SOUTH DELHI,IND,0,8th Pass,630000,0,630000
684,Labha Ram,JAMMU,IND,0,12th Pass,860000,230000,630000
150,Ashok Bisi,BARGARH,CPI,2,Graduate Professional,644707,15000,629707
1548,Vishwanath Gotuji Jamnekar,AMRAVATI,IND,0,Graduate Professional,620000,0,620000
933,P K Raman,KASARAGOD,IND,2,10th Pass,616200,0,616200
1347,Sirsat Haridas Ankush,AMRAVATI,IND,0,5th Pass,686000,70000,616000
1283,Sawake Ramkrushna Pundlikrao,YAVATMAL-WASHIM,CPI(ML) Red star,0,10th Pass,612264,0,612264
1535,Virender Mohan Vats,WEST DELHI,IND,0,Graduate,910714,300000,610714
1298,Shailender Kumar,NORTH WEST DELHI,IND,0,Graduate,620000,10000,610000
479,Harveer,BULANDSHAHR,IND,0,12th Pass,608000,0,608000
354,Dilip Narayan,NAGPUR,IND,0,Others,607658,0,607658
1382,Subash Chander,JAMMU,All J & K Kisan Majdoor Party,0,8th Pass,606100,0,606100
1225,Samsul Alam,KALIABOR,AITC,0,Graduate,605000,0,605000
1196,Rubina Khan,NEW DELHI,IND,0,Graduate,602439,0,602439
811,Mohananda Das,KARIMGANJ,IND,0,10th Pass,600000,0,600000
1207,Sachin Pandurangji Raut Alias Gurubhau,WARDHA,IND,0,12th Pass,600000,0,600000
1079,Rajendra Singh,NAWADA,AAP,0,Graduate Professional,1455858,858745,597113
274,Chhabilal Nial,KALAHANDI,Ambedkarite Party of India,0,Graduate Professional,580758,0,580758
300,Dandekar Baburao Laxman,GADCHIROLI-CHIMUR,IND,0,12th Pass,580000,0,580000
541,Jasminsha,THRISSUR,IND,2,Others,569648,0,569648
749,Mamun Imdadul Haque Chawdhury,LAKHIMPUR,AIUDF,0,Post Graduate,567483,0,567483
1008,Pramod Mangaruji Sorte,CHANDRAPUR,IND,0,12th Pass,566100,0,566100
1198,Ruksana,BAGHPAT,IND,0,Illiterate,562000,0,562000
50,Adv. Prabhakar Mahaguji Dadmal,GADCHIROLI-CHIMUR,RPI,0,Post Graduate,560000,0,560000
1062,Raj Narain Rao,SASARAM,IND,0,12th Pass,558000,100,557900
1566,Zulfikal Ali A A,ERNAKULAM,SDPI,4,Others,557800,0,557800
676,Kumbhare Hansraj Gulab,CHANDRAPUR,BSP,0,Post Graduate,551500,0,551500
708,Lokhande Ganesh Haibatrao,RAMTEK,IND,0,Graduate Professional,548000,600,547400
1487,Umesh Alies Pani,BIJNOR,IND,0,8th Pass,545918,0,545918
785,Md Jalil Ansari,KODARMA,National Loktantrik Party,0,Illiterate,541600,0,541600
1061,Raj Kumar Saini,KURUKSHETRA,IND,0,5th Pass,562200,24000,538200
804,Mohammed Faizal.P.P,LAKSHADWEEP,NCP,3,Post Graduate,538119,0,538119
1357,Smt. Sumeeti,GAUTAM BUDHHA NAGAR,IND,0,8th Pass,1201712,675000,526712
369,Dr. Dhai Akshar (Rakesh Sonkar),JABALPUR,IND,0,Graduate,620000,95000,525000
1189,Rinku Malakar,KARIMGANJ,SP,0,8th Pass,533500,13000,520500
236,Binay Debbarma,TRIPURA WEST,Indigenous Peoples Front of Tripura,1,Graduate Professional,520000,0,520000
657,Krishna Singh,KODARMA,JD(U),1,Literate,518000,0,518000
1123,Ramakant Pandey Malaihna,SIDHI,IND,0,Post Graduate,515000,0,515000
1195,Roy Arackal,KOTTAYAM,SDPI,0,10th Pass,513300,0,513300
1019,Praveen K Mohan,KOTTAYAM,IND,3,10th Pass,512500,0,512500
868,Nanak Chand,FARIDABAD,IND,0,10th Pass,512000,0,512000
204,Bante Jitendra Ramaji,BHANDARA-GONDIYA,IND,0,12th Pass,510000,0,510000
4,A Pandian,ANDAMAN & NICOBAR ISLANDS,AIFB,0,12th Pass,859410,350000,509410
543,Jaswant,SONIPAT,IND,0,10th Pass,612000,108000,504000
403,Elias Kujur,TEZPUR,IND,0,Graduate Professional,502074,0,502074
737,Mahesh Dubey,CHHINDWARA,AAP,0,Graduate,500000,0,500000
496,Indra Deo Choudhary,GAYA,Bahujan Mukti Party,0,10th Pass,507000,10000,497000
1540,Vishal Khosla,NEW DELHI,IND,0,12th Pass,489000,0,489000
1091,Rajkumar Dowarah,JORHAT,IND,0,Graduate,487600,0,487600
358,Dinesh Kumar,KARAKAT,Bahujan Mukti Party,1,Doctorate,478500,0,478500
1522,Vikas,HISAR,IND,3,Graduate,473900,0,473900
814,Mohd Mursaleem,CHANDNI CHOWK,PECP,0,12th Pass,470700,0,470700
1511,Vijay Kumar,JAMMU,IND,0,8th Pass,520000,50000,470000
478,Harsh Kumar,NORTH EAST DELHI,IND,0,Graduate Professional,466633,0,466633
1395,Sudhir Chandwas,BHIWANI-MAHENDRAGARH,IND,0,Graduate Professional,460000,0,460000
1401,Sukanta Kumar Panigrahi,KANDHAMAL,BJP,2,Post Graduate,580000,120000,460000
138,Arup Kumar Mahanta,KALIABOR,CPI(ML)L,0,Graduate,458613,0,458613
1383,Subash Chouhan,BARGARH,BJP,0,Graduate,455867,0,455867
165,Ashutosh Mudgil,CHANDNI CHOWK,IND,0,8th Pass,453921,0,453921
131,Arun Kumar,AMBALA,CPI,0,Graduate Professional,450000,0,450000
170,Asra Anjum Farooqui,BALAGHAT,RPI(A),0,Graduate,450000,0,450000
1011,Prasadi Pradhan,SAMBALPUR,SUCI(C),0,8th Pass,485502,36800,448702
837,Muhammed Riyas,KOZHIKODE,IND,0,10th Pass,441500,0,441500
987,Pintu Malakar,KARIMGANJ,IND,0,12th Pass,440000,0,440000
407,Fakir Chand,SIRSA,IND,0,8th Pass,438500,0,438500
916,Nitinkumar Sahu,CHHINDWARA,BSP,2,10th Pass,585000,150000,435000
175,Attuveppil Kunhikkannan,VADAKARA,IND,0,5th Pass,452079,19000,433079
106,Anil Kumar N S,ATTINGAL,BSP,1,12th Pass,433000,0,433000
462,Hafiz Mustaq,SOUTH DELHI,Jan Samanta Party,0,Illiterate,430000,0,430000
125,Aphajal,MEERUT,IND,1,8th Pass,425000,0,425000
324,Devender,KARNAL,RPI(A),0,12th Pass,625000,201000,424000
1106,Rakesh Kumar (Rinku Bhai),HISAR,IND,0,12th Pass,451122,28102,423020
1437,Surinder Bhardwaj,CHANDIGARH,JD(U),0,Graduate,419506,0,419506
1216,Sajalendu Malakar,KARIMGANJ,IND,0,10th Pass,417000,0,417000
510,Jagbir,SONIPAT,IND,0,8th Pass,415316,0,415316
633,Khairul Islam,LAKHIMPUR,IND,0,10th Pass,413129,0,413129
195,Baljeet,HISAR,IND,0,Graduate,410700,0,410700
953,Pallickal Surendran,MAVELIKKARA,IND,0,10th Pass,410278,0,410278
139,Arvind,BAGHPAT,IND,0,12th Pass,410000,100,409900
1367,Sreedharan,MALAPPURAM,IND,0,5th Pass,409000,0,409000
1453,T.K.Tomy,IDUKKI,CPI(ML) Red star,0,Others,404000,0,404000
994,Prabiddha Reang,TRIPURA EAST,IND,0,10th Pass,402519,0,402519
742,Mahinder Pal,KARNAL,IND,0,5th Pass,8401000,8000000,401000
434,Gicho Kabak,ARUNACHAL WEST,NCP,0,10th Pass,400000,0,400000
500,Iqra Chaudhry,MEERUT,IND,0,Not Given,400000,0,400000
1506,Veejit Kumar,AURANGABAD,IND,0,Graduate,400000,0,400000
1286,Senapati Uttam Sapan,NAGPUR,IND,1,5th Pass,398038,0,398038
1462,Tarun Kumar Das,KARIMGANJ,AAP,0,10th Pass,391000,0,391000
1154,Ramteke Jivan Namdeorao,NAGPUR,IND,0,10th Pass,390000,0,390000
441,Gopinath Jani,NABARANGPUR,BSP,0,8th Pass,426659,37200,389459
2,A Biju,ALATHUR,IND,0,8th Pass,564425,175000,389425
438,Girish Kumar Gautam,REWA,IND,0,Post Graduate,381000,0,381000
1331,Shri Subhash Shukla,CHHINDWARA,SP,0,12th Pass,380000,0,380000
1536,Virendra Kumar Sharma,JABALPUR,IND,0,Graduate,380000,0,380000
328,Dhan Raj Chauhan,CHANDNI CHOWK,Naya Daur Party,0,8th Pass,370000,0,370000
1495,V S Jayakumar,THIRUVANANTHAPURAM,IND,0,Graduate,2040500,1675000,365500
1472,Trichur Nazeer,KOZHIKODE,IND,0,10th Pass,362347,0,362347
1261,Sasikkuttan Vakathanam,KOTTAYAM,CPI(ML) Red star,0,10th Pass,361750,0,361750
171,Aswini Kumar Padhy,BERHAMPUR,BSP,0,Graduate Professional,392889,32000,360889
333,Dhaniram Yaduwanshi,CHHINDWARA,IND,0,12th Pass,504199,148810,355389
519,Jagjeet Singh,CHANDNI CHOWK,Bharatiya Gaon Taj Dal,0,10th Pass,353200,0,353200
1015,Praska Renga,KORAPUT,BSP,0,8th Pass,352000,0,352000
776,Mansid Ekka,SUNDARGARH,IND,2,12th Pass,630000,280000,350000
255,C.K. Ramakrishnan,PALAKKAD,IND,0,Not Given,729614,380200,349414
431,Ghulam Kundanam,KARAKAT,AAP,1,Graduate Professional,623000,280800,342200
829,Mohd. Sajid Saifi,MEERUT,Bahujan Mukti Party,1,5th Pass,341178,0,341178
896,Naveen Jaihind,ROHTAK,AAP,1,Doctorate,340057,0,340057
1418,Sunil Kumar,ROHTAK,AITC,0,Graduate,339277,0,339277
1199,Ruvez Alam Rahi,GAUTAM BUDHHA NAGAR,National Loktantrik Party,0,12th Pass,337000,0,337000
470,Hari Arumbil,PALAKKAD,BSP,0,12th Pass,415000,80000,335000
583,K Sudhakaran (Sreeshylam),KANNUR,IND,0,12th Pass,414862,82500,332362
1205,Sabuj Das,KARIMGANJ,IND,0,10th Pass,332000,0,332000
812,Mohd Arif Siddique,NORTH EAST DELHI,AITC,0,Illiterate,330000,0,330000
1358,Sohail Anwer,NAWADA,BSP,0,Literate,415000,85000,330000
60,Adv.P.Sudheer,MAVELIKKARA,BJP,8,Graduate Professional,329804,0,329804
1179,Ravinder,FARIDABAD,Akhil Bharat Hindu Mahasabha,0,12th Pass,327600,0,327600
1523,Vikrant,JABALPUR,IND,0,10th Pass,323500,0,323500
861,Najmudheen.C.T,LAKSHADWEEP,CPI,7,Graduate,322000,0,322000
78,Ajith Kumar K K,PATHANAMTHITTA,IND,1,Graduate,663000,342000,321000
7,A. Josekutty,KOLLAM,IND,0,10th Pass,545117,224328,320789
323,Devchand Dhruw,BASTAR,CPI(ML) Red star,0,8th Pass,371000,52235,318765
1070,Rajbir Palna,SIRSA,IND,0,Post Graduate,356000,37362,318638
993,Prabhunath Prasad Saket,REWA,IND,0,Doctorate,316246,0,316246
966,Parmeshwar Singh,SHAHDOL,CPI,0,5th Pass,515000,200000,315000
688,Lal Bahadur Singh,SIDHI,Samata Samadhan Party,0,10th Pass,312000,0,312000
196,Balkrishna Salgaonkar,SOUTH GOA,IND,0,Illiterate,311650,0,311650
532,James Joseph,IDUKKI,IND,0,10th Pass,375000,67000,308000
1006,Prakash Minj,ANDAMAN & NICOBAR ISLANDS,IND,0,Post Graduate,308000,0,308000
1322,Shiv Kumar,HISAR,IND,0,10th Pass,305500,0,305500
322,Devanand,ALIGARH,Lok Dal,0,Graduate,305016,0,305016
636,Khem Raj Chetry,TEZPUR,CPI(M),0,12th Pass,300100,0,300100
247,Borkar Ravindra,NAGPUR,IND,0,10th Pass,300000,0,300000
504,Istak Khan,WEST DELHI,IND,0,5th Pass,300000,0,300000
874,Narender Pichopa-Khurd,BHIWANI-MAHENDRAGARH,IND,0,12th Pass,300000,0,300000
1332,Shridhar Salve,NAGPUR,IND,0,12th Pass,300000,0,300000
1003,Pradip Suklabaidya,KARIMGANJ,IND,0,8th Pass,299847,0,299847
1458,Tanish Orang,LAKHIMPUR,CPI(ML)L,0,8th Pass,295642,0,295642
1501,Varsha Govind Tidke,BHANDARA-GONDIYA,IND,0,10th Pass,294378,0,294378
153,Ashok Kumar,SATNA,IND,0,Graduate,289957,0,289957
237,Bindu M.K.,PONNANI,IND,0,8th Pass,318706,33000,285706
288,Com. Bandu Ramchandra Meshram,RAMTEK,CPI(ML) Red star,0,12th Pass,285146,0,285146
326,Devi Singh,NEW DELHI,Rashtriya Jankranti Party,0,Post Graduate,285000,0,285000
907,Nilu Mandol,SILCHAR,SHS,0,8th Pass,283000,0,283000
760,Maniyangattil Sukumaran,THRISSUR,IND,0,Literate,281000,0,281000
1252,Saraswati Nanda,BOLANGIR,AAP,0,Post Graduate,279095,0,279095
194,Baleshwar Bharti,SASARAM,BSP,0,10th Pass,273200,0,273200
9,A. Raghunath Varma,BERHAMPUR,IND,0,Post Graduate,270800,0,270800
530,Jalasram Nagwanshi,CHHINDWARA,IND,0,12th Pass,268000,0,268000
417,Gajresh Kumar,BIJNOR,IND,1,Graduate,266000,0,266000
1531,Vinod Kumar,SATNA,Bhartiya Shramik Dal Socialist,0,10th Pass,260000,0,260000
1002,Pradesh Kumar,NORTH EAST DELHI,Ambedkar National Congress,0,Post Graduate,257000,0,257000
1053,Rahmat Ullah,KALIABOR,IND,0,Graduate Professional,255300,0,255300
598,Kali Charana Nayak,ASKA,IND,0,5th Pass,255213,0,255213
239,Binod Kumar Das,JAMUI,AAP,1,12th Pass,252600,0,252600
1377,Srihari Patanaik,BERHAMPUR,IND,0,12th Pass,976119,723600,252519
1007,Prakash Raghunath Raut,YAVATMAL-WASHIM,IND,0,10th Pass,250000,0,250000
92,Ambalathara Kunhikrishnan,KASARAGOD,AAP,0,10th Pass,245690,0,245690
1115,Ram Jawari,AMBALA,Rashtriya Karmyog Party,0,Graduate,245500,0,245500
1549,Vivek Mishra (Lalu Bhaiya),BALAGHAT,Jai Maha Bharath Party,0,Graduate,245500,0,245500
529,Jaivindra Kumar,BAGHPAT,IND,0,Graduate,244000,0,244000
445,Goutam Malakar,KARIMGANJ,IND,0,8th Pass,242000,0,242000
306,Davinder Singh,KARNAL,Rashtriya Karmyog Party,0,12th Pass,240000,0,240000
443,Gothra Moopan Nellikadan Kannan,KASARAGOD,IND,0,Not Given,240000,0,240000
310,Deepak Kumar,EAST DELHI,IND,0,12th Pass,236200,0,236200
1254,Saravanan,ANDAMAN & NICOBAR ISLANDS,IND,0,Graduate,236000,0,236000
1497,V V Khalid,ANDAMAN & NICOBAR ISLANDS,IND,0,8th Pass,235000,0,235000
1404,Sukhbir Singh,BHIWANI-MAHENDRAGARH,IND,0,10th Pass,234171,0,234171
374,Dr. M.V. Ibraheem,MALAPPURAM,IND,3,Graduate Professional,232700,0,232700
1537,Virendra Mayer,EAST DELHI,Samajwadi Janata Party (Rashtriya),0,Graduate,231000,0,231000
1153,Ramratan Singh Pawley,SHAHDOL,GGP,0,Post Graduate,227724,0,227724
1265,Sathyan Puthanveettil,WAYANAD,IND,0,8th Pass,226000,0,226000
668,Kuldeep S/O Karan Singh,HISAR,IND,0,8th Pass,225700,0,225700
1178,Ravikant Chaudhary,SASARAM,IND,0,10th Pass,225500,0,225500
1518,Vijay Ram,NAWADA,Moolniwasi Samaj Party,1,10th Pass,221500,0,221500
1321,Shiv Kumar,SAHARANPUR,Ambedkar Samaj Party,0,8th Pass,220619,0,220619
750,Manak Lal Gontiya,JABALPUR,Ambedkarite Party of India,0,8th Pass,220000,0,220000
713,M G Purushothaman,CHALAKUDY,BSP,0,Others,296000,78000,218000
571,Jyoti Sanjay Dewkar,AMRAVATI,IND,0,10th Pass,216572,0,216572
36,Achutananda Nag,BOLANGIR,Ambedkarite Party of India,0,Graduate Professional,208500,0,208500
729,Mahatalal Barkade,MANDLA,National Peoples Party,0,8th Pass,208000,0,208000
136,Arunangshu Bhattacharjee,SILCHAR,SUCI(C),0,Post Graduate,873605,666567,207038
280,Chole Omprakash Bakaram,BHANDARA-GONDIYA,IND,0,Graduate Professional,1007000,800000,207000
979,Perseen Singh,JAMMU,IND,0,12th Pass,205959,0,205959
1399,Sujit Mallick,KARIMGANJ,IND,0,10th Pass,200042,0,200042
16,Abdul Hafeez Abdul Aziz,BULDHANA,BSP,0,12th Pass,425000,225000,200000
782,Mathew Parey,PATHANAMTHITTA,IND,0,Graduate Professional,200000,0,200000
789,Meganada Sabar,KORAPUT,CPI(ML)L,0,10th Pass,200000,0,200000
1182,Ravindra Kumar Ravi,PALAMAU,IND,0,12th Pass,200000,0,200000
921,Om Dutt Sharma,NORTH EAST DELHI,SHS,2,12th Pass,197000,0,197000
494,Inder Singh Uikey,MANDLA,Ambedkarite Party of India,0,12th Pass,195000,0,195000
485,Hiramoni Deka Sonowal,LAKHIMPUR,AAP,0,Doctorate,192000,0,192000
626,Kaushal Rai,SIKKIM,AAP,0,Post Graduate,192000,0,192000
781,Mate Manohar Alias Mama,BHANDARA-GONDIYA,IND,0,8th Pass,191077,0,191077
624,Kartik Gajanan Kodape,CHANDRAPUR,IND,0,Others,190000,0,190000
1090,Rajkumar,SATNA,Bhartiya Shakti Chetna Party,0,10th Pass,790000,600000,190000
1546,Vishun Chaudhary,JAMUI,SHS,0,8th Pass,190000,0,190000
1121,Ram Singh,SHAHDOL,CSM,0,8th Pass,186000,0,186000
155,Ashok Kumar Masih,BALAGHAT,CPI,0,5th Pass,184000,0,184000
818,Mohd. Adil,JABALPUR,IUML,0,12th Pass,183325,0,183325
680,Kusheshwar Bhagat,GURGAON,IND,0,8th Pass,181000,0,181000
559,Jogendra Singh,SHAHDOL,Bahujan Mukti Party,0,8th Pass,180411,0,180411
405,Er. Vijay Kumar Kol,SHAHDOL,AAP,0,Post Graduate,180118,0,180118
169,Asif Khan,BALAGHAT,Minorities Democratic Party,0,10th Pass,180000,0,180000
1349,Sita Ram Sareyam,CHHINDWARA,IND,0,10th Pass,180000,0,180000
1398,Sujeet Jha,NEW DELHI,Bhartiya Janta Dal (Integrated),0,12th Pass,220000,40000,180000
1305,Shambharkar Rajendra Gulabrao,WARDHA,IND,3,Doctorate,174963,0,174963
663,Krushnarao Ingle,BULDHANA,IND,0,Literate,206100,35000,171100
766,Manoharan K,KASARAGOD,IND,2,Graduate,171100,0,171100
558,Joganati Datta,TRIPURA WEST,IND,0,8th Pass,165000,0,165000
767,Manoj Choudhury,BERHAMPUR,AITC,0,10th Pass,163000,0,163000
1386,Subhash Paswan,JAMUI,IND,0,Not Given,163000,0,163000
705,Lily Prema Kujur,SUNDARGARH,Bahujan Mukti Party,0,12th Pass,161000,0,161000
1089,Rajiv,BHIWANI-MAHENDRAGARH,Bahujan Mukti Party,0,12th Pass,161000,0,161000
1224,Samser,BHIWANI-MAHENDRAGARH,National Loktantrik Party,0,Literate,161000,0,161000
143,Arvind Tiwari,KARNAL,IND,0,Doctorate,160000,0,160000
1184,Ravindrasing Ramsing Pawar,BULDHANA,Lok Bharati,0,12th Pass,160000,0,160000
1516,Vijay Pal,BULANDSHAHR,Rashtriya Janpriya Party,0,8th Pass,159000,0,159000
671,Kuldeep S/O Pardumn,HISAR,IND,0,Post Graduate,260000,102000,158000
1547,Vishv Nath Dwivedi,REWA,IND,0,12th Pass,156000,0,156000
361,Diwakar,KAIRANA,AITC,0,12th Pass,155543,0,155543
1020,Praveen Kumar,EAST DELHI,Bhartiya Jan Manch,0,8th Pass,155178,1700,153478
1425,Surender Kumar,CHANDIGARH,Bahujan Mukti Party,0,Graduate,304607,151340,153267
664,Kulamani Urma,BARGARH,Paschimanchal Vikas Party,0,8th Pass,153000,0,153000
287,Cliffton De Souza,SOUTH GOA,Bahujan Mukti Party,0,10th Pass,152500,0,152500
932,P C Venugopal,ALAPPUZHA,IND,0,Post Graduate,309510,158235,151275
535,Janardan Mishra,REWA,IND,0,Graduate,151000,0,151000
207,Basanta Kumar Pradhan,KANDHAMAL,IND,0,12th Pass,150000,0,150000
375,Dr. Nabhit Kapur,EAST DELHI,Naya Daur Party,0,Doctorate,150000,0,150000
1039,R Chandrika Kattakada,THIRUVANANTHAPURAM,RPI,0,10th Pass,150000,0,150000
1368,Sreejith,PALAKKAD,IND,0,Post Graduate,304185,158610,145575
957,Pankaj Singh Patel,SIDHI,AAP,0,Post Graduate,144766,0,144766
142,Arvind Shamrao Lillore,WARDHA,IND,0,Others,144186,0,144186
1239,Sanjay Maurya,FARIDABAD,IND,0,8th Pass,143541,0,143541
522,Jai Prakash Das,JAMUI,CPI(ML)L,0,8th Pass,143450,0,143450
884,Naresh Kumar,SOUTH DELHI,IND,0,Illiterate,143186,0,143186
22,Abdul Mannan Barbhuiya,SILCHAR,AAP,0,Graduate,1042000,900000,142000
661,Krishnankutty V,ALATHUR,IND,0,10th Pass,146988,6000,140988
570,Jyoti Gajanan Makode,AMRAVATI,Ambedkarite Party of India,0,10th Pass,139000,0,139000
909,Niranjan Kumar,GAYA,CPI(ML)L,2,Graduate,140000,1384,138616
68,Ajaj Julmoin Khan (Ajaj Khan),NAGPUR,IND,1,12th Pass,137000,0,137000
838,Muhammed Sharafudheen,IDUKKI,SDPI,0,Graduate,415000,280000,135000
216,Bhaskar Marotrao Neware,WARDHA,IND,0,Post Graduate,132798,0,132798
996,Pradeep,PALAKKAD,IND,0,10th Pass,131500,0,131500
1426,Surender Kumar,SIRSA,IND,0,12th Pass,131500,0,131500
731,Mahavir Singh,BHIWANI-MAHENDRAGARH,IND,0,12th Pass,130100,0,130100
1250,Santosh Kumar,AURANGABAD,BSP,2,Graduate,130000,0,130000
692,Lala Kol,SHAHDOL,IND,0,8th Pass,130100,2000,128100
703,Laxman,FARIDABAD,IND,0,Not Given,127600,0,127600
1431,Suresh,BULANDSHAHR,Jai Maha Bharath Party,0,8th Pass,126500,0,126500
889,Naseem Ahmad Ansari,MUZAFFARNAGAR,IND,0,Literate,126110,0,126110
1539,Vishal Arvind Bhoyar,BHANDARA-GONDIYA,IND,0,Post Graduate,124600,0,124600
224,Bhupinder Kumar,AMBALA,IND,0,10th Pass,120000,0,120000
1423,Sunita,KAIRANA,JD(U),0,Graduate,120000,0,120000
52,Adv. Ravindra Dnyandeo Bhojane,BULDHANA,Aambedakarite Party of India,0,Graduate Professional,119757,0,119757
1470,Thulaseedharan Pallickal,ALAPPUZHA,SDPI,2,12th Pass,118200,0,118200
1263,Satheesh Chandran,WAYANAD,AITC,0,Literate,112000,0,112000
501,Ishwar Lahanu Nandagawali,BHANDARA-GONDIYA,IND,0,10th Pass,111000,0,111000
698,Lalitha Malayalappuzha,PATHANAMTHITTA,IND,0,10th Pass,110000,0,110000
1461,Tariq Mirza,CHANDNI CHOWK,RPI(A),0,8th Pass,110000,0,110000
686,Lakshi Kanta Kurmi,TEZPUR,CPI(ML)L,0,8th Pass,106200,0,106200
1245,Sanjiv Bhojraj,SIRSA,VANCHITSAMAJ INSAAF PARTY,1,10th Pass,106000,0,106000
970,Parvez Aqil,BIJNOR,All India Minorities Front,0,Graduate,104992,0,104992
1018,Pratima Engheepi,AUTONOMOUS DISTRICT,CPI(ML)L,0,Graduate,469165,365000,104165
1363,Somkuvar Vijay Sitaram,NAGPUR,IND,0,Not Given,104000,0,104000
14,Abbas Mothalappara,KASARAGOD,AITC,0,10th Pass,102000,0,102000
978,Peelipose,PATHANAMTHITTA,IND,0,8th Pass,100205,0,100205
439,Gopal Pujari,NABARANGPUR,Aama Odisha Party,1,10th Pass,100000,0,100000
527,Jain Wilson,THIRUVANANTHAPURAM,IND,0,Graduate,100000,0,100000
569,Jyothish Perumpulickal,MAVELIKKARA,SDPI,0,12th Pass,101500,5400,96100
325,Devendra Kumar Urf Gudda Bhaiyya,HOSHANGABAD,IND,0,10th Pass,95509,0,95509
304,David Horo,LAKHIMPUR,IND,0,10th Pass,94000,0,94000
793,Meshram Dnyaneshwar Tukaram,YAVATMAL-WASHIM,IND,0,Graduate,133000,39060,93940
1035,Pushpangathan,PATHANAMTHITTA,IND,0,10th Pass,92000,0,92000
649,Kishore,ERNAKULAM,IND,0,10th Pass,90000,0,90000
456,Gurnule Ramesh Vithoba,YAVATMAL-WASHIM,IND,0,8th Pass,85000,530,84470
1375,Sri.Manoj Kumar,ATTINGAL,SDPI,2,Others,284000,199789,84211
1083,Rajesh,EAST DELHI,Ambedkar National Congress,0,Graduate,83220,0,83220
761,Manjeet Singh,EAST DELHI,IND,0,Graduate Professional,143000,60000,83000
881,Narendra Singh Rawat,NEW DELHI,IND,0,12th Pass,79000,0,79000
467,Hansraj Hansa,SIRSA,Jan Morcha,0,12th Pass,77000,0,77000
555,Jitendra Aadkuji Raut,BHANDARA-GONDIYA,Akhil Bhartiya Manavta Paksh,1,Graduate,76820,0,76820
630,Keshav,SATNA,IND,0,Post Graduate,76250,0,76250
681,Kusum Kumari,FARIDABAD,All India Peoples Front,0,Post Graduate,75167,0,75167
573,K Biju,ALATHUR,IND,3,8th Pass,73500,0,73500
726,Madhu Sudhan Das,SILCHAR,IND,0,12th Pass,72053,0,72053
104,Anil Kumar,ERNAKULAM,IND,0,8th Pass,72000,0,72000
1024,Premachandran,KOLLAM,IND,0,10th Pass,71500,0,71500
787,Md. Dilbas Ansari,KARAKAT,IND,0,Post Graduate,70000,0,70000
480,Hem Kanta Miri,LAKHIMPUR,SUCI(C),0,Graduate Professional,69500,0,69500
1396,Sufeera K. P.,THRISSUR,SDPI,1,8th Pass,104500,36000,68500
144,Asha Singh,SIDHI,Rashtriya Apna Dal,0,10th Pass,67500,0,67500
1058,Raj Kumar,HISAR,IND,0,10th Pass,66000,0,66000
887,Naresh Mahadeorao Gughane,YAVATMAL-WASHIM,IND,0,8th Pass,65000,0,65000
1433,Suresh Pal,GHAZIABAD,Bharatiya Sarvodaya Kranti Party,0,12th Pass,63170,0,63170
1394,Sudhir Baban Surve,BULDHANA,AAP,0,Graduate,62153,0,62153
221,Bhup Singh,NORTH WEST DELHI,IND,0,Graduate Professional,61711,0,61711
177,Atul Khodawal,MEERUT,IND,0,Illiterate,61500,0,61500
466,Hansraj,HISAR,IND,0,12th Pass,60000,0,60000
1362,Somini Prabhakaran,IDUKKI,IND,0,10th Pass,67800,10000,57800
824,Mohd. Jahangeer Ansari,SIDHI,IND,0,Not Given,56300,0,56300
1430,Suresh,ATTINGAL,IND,0,10th Pass,56000,0,56000
8,A. P. Shamseer,VADAKARA,IND,0,Literate,55620,0,55620
670,Kuldeep S/O Narain Singh,HISAR,IND,0,5th Pass,55000,0,55000
413,Gagan Rastogi,CHANDNI CHOWK,IND,0,Graduate,53919,0,53919
1440,Sushil Kaushik,HISAR,IND,0,Post Graduate,51500,0,51500
203,Banjare Babulal Sundarlal,NAGPUR,IND,0,10th Pass,51017,0,51017
20,Abdul Latif,GURGAON,IND,0,5th Pass,50000,0,50000
228,Bijaya Kumar Mahapatro,ASKA,BSP,0,10th Pass,50000,0,50000
252,C G Saji Kumar,ANDAMAN & NICOBAR ISLANDS,IND,0,12th Pass,50000,0,50000
416,Gajendra,GAUTAM BUDHHA NAGAR,Indian Oceanic Party,0,Post Graduate,50000,0,50000
423,Gaus Mohammed Sheikh Ayyub Sheikh,NAGPUR,IND,0,10th Pass,50000,0,50000
1202,S.B.Basheer,ALAPPUZHA,IND,0,5th Pass,50000,0,50000
1230,Sandip Kisanrao Wankhede,AKOLA,IND,0,Graduate,50000,0,50000
1350,Sitender Singh,SONIPAT,IND,0,Post Graduate,50000,0,50000
202,Banamali Majhi,KORAPUT,Ambedkarite Party of India,0,Post Graduate,48000,0,48000
32,Aboobakker Sidique,PALAKKAD,AITC,0,Illiterate,47004,0,47004
1266,Sathyan Thazhemangad,WAYANAD,IND,0,Literate,47000,0,47000
97,Ananda Kumar Samal,SAMBALPUR,AAP,0,Post Graduate,169838,123121,46717
1167,Ratheesh,NEW DELHI,IND,0,Graduate,45200,0,45200
1075,Rajender Kumar,SAHARANPUR,Adarsh Rashtriya Vikas Party,0,Graduate,44300,0,44300
552,Jinti Gogoi,KALIABOR,AAP,0,Graduate,42000,0,42000
460,H.K. Mahendru,NORTH EAST DELHI,IND,0,8th Pass,41985,0,41985
997,Pradeep Kumar,ALIGARH,Bahujan Mukti Party,0,Graduate Professional,41900,0,41900
101,Anil Kumar,THIRUVANANTHAPURAM,IND,0,12th Pass,40000,0,40000
1105,Rakesh Kumar,WEST DELHI,Bhartiya Janta Dal (Integrated),0,10th Pass,40000,0,40000
1480,Uday Pratap Singh,HOSHANGABAD,IND,0,Graduate,40000,0,40000
31,Aboobacker Siddique,KASARAGOD,IND,0,8th Pass,38000,0,38000
904,Nikhil Sablania,NEW DELHI,IND,0,Graduate Professional,38000,0,38000
638,Khobragade Chandrabhan Jairam,RAMTEK,IND,0,10th Pass,37804,0,37804
1416,Sunil Gautam,GAUTAM BUDHHA NAGAR,IND,2,8th Pass,37800,0,37800
1009,Pramod Tiwari,REWA,Bhartiya Shakti Chetna Party,0,Graduate,35000,0,35000
1278,Satya Narayan Mahar,KALAHANDI,AAP,1,Graduate,32332,0,32332
791,Mehar Manav Bhagat,JAMMU,Bharatiya Bahujan Party,0,Graduate Professional,32000,0,32000
40,Adv. Bandya Sane Alias Bandu Sampatrao Sane,AMRAVATI,IND,0,Post Graduate,31300,0,31300
1337,Shyam Lal Ram,PALAMAU,IND,0,Graduate,31205,0,31205
1545,Vishnu Kumar,HISAR,IND,0,Graduate Professional,31000,0,31000
1486,Umed Singh,GURGAON,RASHTRIYA MORCHA PARTY,0,Others,30500,0,30500
414,Gaikawad Rajendra Vitthal,YAVATMAL-WASHIM,IND,1,12th Pass,30250,0,30250
796,Miss Patal Kanya Jamatia,TRIPURA EAST,IND,0,Post Graduate,30000,0,30000
822,Mohd. Hasnain,NORTH EAST DELHI,IND,2,10th Pass,30000,0,30000
956,Pankaj Sewakram Masurkar,RAMTEK,Hindustan Janta Party,0,10th Pass,30000,0,30000
1027,Probash Chandra Sarkar,KARIMGANJ,SUCI(C),0,10th Pass,30000,0,30000
1532,Vinod Kumar Baghel,ALIGARH,Rashtriya Samaj Paksha,0,12th Pass,30000,0,30000
1299,Shajar Khan,THIRUVANANTHAPURAM,SUCI(C),0,Post Graduate,26800,0,26800
1149,Ramphal,HISAR,IND,0,12th Pass,26200,0,26200
674,Kuldeep Singh S/O Shishpal,HISAR,Bahujan Mukti Party,0,Post Graduate,25500,0,25500
912,Nirupam Mandal,SILCHAR,IND,0,Graduate Professional,25500,0,25500
1285,Seleena Prakkanam,PATHANAMTHITTA,BSP,2,12th Pass,25500,0,25500
1400,Sukamal Das,SILCHAR,IND,0,8th Pass,25000,0,25000
345,Dharmendra Wasudeorao Mandlik,NAGPUR,Hindustan Janata Party,0,Post Graduate,23900,0,23900
12,A.M.Smitha,VADAKARA,CPI(ML) Red star,0,Graduate,22000,0,22000
628,Kawaljit Singh,CHANDIGARH,CPI(ML)L,4,Graduate Professional,22000,0,22000
1414,Sunil David Amravati,AMRAVATI,Bahujan Mukti Party,0,Graduate Professional,21139,0,21139
311,Deepak Kumar,WEST DELHI,Rashtriya Janadhikar Party,0,8th Pass,21000,0,21000
594,Kadeem,GAUTAM BUDHHA NAGAR,IND,0,5th Pass,20300,0,20300
188,Baikuntha Dhangada Majhi,KALAHANDI,Kalinga Sena,0,10th Pass,20000,0,20000
865,Namdeo Pundlik Dongardive,BULDHANA,IND,1,Graduate Professional,17500,0,17500
1473,Tumane Gopal Ajabrao,RAMTEK,IND,0,12th Pass,17500,0,17500
1201,S Radhamani,PATHANAMTHITTA,SUCI(C),0,Graduate,16880,0,16880
597,Kailash Sabara,KORAPUT,Samata Kranti Dal,0,Graduate Professional,16000,0,16000
1267,Satish Gokuldas Pendam,GADCHIROLI-CHIMUR,AITC,0,Graduate Professional,16000,0,16000
1494,V M Raghavan,KOZHIKODE,IND,0,10th Pass,13000,0,13000
830,Mohd. Yamin,MUZAFFARNAGAR,All India Ravidas Samata Party,0,Illiterate,12000,0,12000
111,Anita Nagdigambar Tekam,NAGPUR,IND,0,8th Pass,10500,0,10500
995,Pradeep,HOSHANGABAD,BSP,0,10th Pass,10082,0,10082
397,Dusmanta Kar,SAMBALPUR,IND,0,Graduate Professional,10000,0,10000
1219,Saleem Malik,GHAZIABAD,IND,0,8th Pass,10000,0,10000
1222,Sambare Dinkar Tukaram,BULDHANA,IND,0,10th Pass,10000,0,10000
488,Hrishikesh Baruah,LAKHIMPUR,IND,0,Post Graduate,9000,0,9000
1124,Raman Motiram Bansod,BHANDARA-GONDIYA,Ambedkarite Party of India,0,Post Graduate,58800,50000,8800
568,Justin Lugun,SUNDARGARH,SUCI(C),0,10th Pass,8092,0,8092
870,Nand Lal Uikey,BALAGHAT,CSM,0,Post Graduate,8000,0,8000
491,Imran Ali,KARAKAT,IND,0,Graduate,7845,0,7845
1381,Subarnamala Deb Barma,TRIPURA EAST,Amra Bangalee,0,8th Pass,7485,0,7485
1550,Vivekanandan,ATTINGAL,IND,0,8th Pass,4652,0,4652
1369,Sreeni Jacob,KOTTAYAM,BSP,0,12th Pass,4000,0,4000
408,Falguni Tripura,TRIPURA EAST,CPI(ML)L,0,12th Pass,3500,0,3500
1134,Ramesh Chander,CHANDIGARH,IND,0,Graduate,3324,0,3324
342,Dharm Bir S/O Hari Singh,BHIWANI-MAHENDRAGARH,IND,0,10th Pass,51000,48000,3000
1260,Sasikala K S,MAVELIKKARA,SUCI(C),0,12th Pass,2700,0,2700
1005,Prakash Hikaka,KORAPUT,CPI(ML) Red star,0,Literate,2500,0,2500
424,Gautam Ramteke,BALAGHAT,Republican Party of India (Khobragade),0,12th Pass,2000,0,2000
702,Lawrencia Lakra,SUNDARGARH,IND,0,12th Pass,1500,0,1500
1038,R Biju,ALATHUR,IND,0,10th Pass,1500,0,1500
191,Balaram Hota,KALAHANDI,CPI(ML)L,0,Others,1150,0,1150
631,Keshav Choudhary,GHAZIABAD,IND,1,12th Pass,1000,0,1000
914,Nitin,GHAZIABAD,IND,0,10th Pass,1000,0,1000
1067,Rajaneesh Babu,ERNAKULAM,IND,0,10th Pass,1000,0,1000
1168,Ratheesh Perumal,KOTTAYAM,IND,0,10th Pass,1000,0,1000
1236,Sanjay Kumar,ALIGARH,IND,0,5th Pass,1000,0,1000
82,Albin M U,ALATHUR,IND,0,12th Pass,900,0,900
855,N.K.Biju,KOTTAYAM,SUCI(C),0,12th Pass,750,0,750
1297,Shaikh Jabbar Shaikh Usuf,YAVATMAL-WASHIM,IND,0,8th Pass,500,0,500
1125,Ramanuj Patel,NEW DELHI,Samyak Parivartan Party,0,12th Pass,100,0,100
1450,T S Balakrishnan,ALAPPUZHA,IND,0,12th Pass,50,0,50
160,Ashok Mittal,BARGARH,AITC,0,10th Pass,0,0,0
189,Baishakhoo Maravi,MANDLA,Bhartiya Satya Sangharsh Party,0,5th Pass,0,0,0
249,Brahmanand Pratap Singh,SIDHI,IND,0,Graduate,0,0,0
257,Chanda Manwatkar,NAGPUR,IND,0,12th Pass,0,0,0
259,Chandrababu,ALAPPUZHA,IND,0,10th Pass,0,0,0
349,Dhiraj Jaidev Gajbhiye,NAGPUR,IND,0,12th Pass,0,0,0
607,Kamble Uttam Bhagaji,YAVATMAL-WASHIM,Prabuddha Republican Party,0,Post Graduate,0,0,0
645,Kirantai Dadarao Alias Kokubhau Kokate,AMRAVATI,IND,0,8th Pass,0,0,0
823,Mohd. Imtiaz,JAMMU,IND,0,Graduate,0,0,0
906,Nilesh Mahadeo Dhoke,RAMTEK,IND,0,8th Pass,0,0,0
1088,Rajesh Suresh Sadhankar,NAGPUR,IND,0,Not Given,0,0,0
1129,Ramesh,CHHINDWARA,Ambedkarite Party of India,0,8th Pass,0,0,0
1302,Shakil Wasi Ahamad,NAGPUR,IND,0,Not Given,0,0,0
1360,Soman Pillai,THRISSUR,Indian Gandhiyan Party,0,Not Given,0,0,0
1448,Syamalakumari,THIRUVANANTHAPURAM,IND,0,5th Pass,0,0,0
1530,Vinod Dinanath Meshram,CHANDRAPUR,IND,0,Not Given,0,0,0
411,Fr.Stephen,THIRUVANANTHAPURAM,IND,2,Post Graduate,169587,181000,0
1376,Sri.Sambath Anilkumar,ATTINGAL,IND,0,8th Pass,3262,17000,0
302,Das K Varkala,ATTINGAL,IND,2,10th Pass,13633,39000,0
772,Manoj Kumar Manjhi,JAMUI,IND,0,12th Pass,121000,150000,0
817,Mohd. Abbas Khan,JAMMU,IND,0,Graduate Professional,218316,261000,0
1364,Soni Soree,BASTAR,AAP,2,12th Pass,195000,250000,0
410,Firaj Pathan,CHANDRAPUR,Bahujan Mukti Party,1,12th Pass,6370,62000,0
1110,Rakhi Birla,NORTH WEST DELHI,AAP,0,Post Graduate,163467,230000,0
26,Abdul Wafati Ansari Urf Yuvraj Tailors,REWA,Samata Party,0,10th Pass,1131000,1200000,0
825,Mohd. Javed Mohd Mustak,NAGPUR,Democratic Secular Party,0,12th Pass,160500,250000,0
56,Adv.Dean Kuriakose,IDUKKI,INC,1,Not Given,314050,411719,0
857,Naba Krushna Danta,BOLANGIR,IND,0,Graduate Professional,482285,606700,0
1026,Premakumari,ALATHUR,BSP,1,Others,32000,158000,0
1326,Shoby Joseph,IDUKKI,IND,1,Others,10500,151600,0
551,Jiju Cheenikkal,THRISSUR,IND,0,10th Pass,226394,400000,0
999,Pradeep Kumar Joshi,KARAKAT,Rashtra Sewa Dal,21,12th Pass,11721162,11908841,0
1275,Satpal S/O Lokram,BHIWANI-MAHENDRAGARH,IND,0,12th Pass,1754500,1945000,0
1087,Rajesh S,PALAKKAD,SHS,0,10th Pass,0,255390,0
853,N Kannan,ANDAMAN & NICOBAR ISLANDS,IND,0,8th Pass,32400,549313,0
380,Dr. Sandeep Natthuji Nandeshwar,RAMTEK,Bharipa Bahujan Mahasangh,0,Post Graduate,302494,836870,0
777,Mantu Saikia,KALIABOR,IND,0,10th Pass,5575521,6168003,0
209,Basil Ekka,SUNDARGARH,AAP,0,10th Pass,333388,1000000,0
974,Patle Anjali Agastikumar,BHANDARA-GONDIYA,Bharipa Bhahujan Mahasangha,0,Post Graduate,1679100,2425000,0
675,Kumar Vivek Gautam,EAST DELHI,IND,0,Graduate,390500,1900000,0
1371,Sri Bikash Debbarma,TRIPURA EAST,Jai Maha Bharath Party,0,10th Pass,350000,1900000,0
894,Navajyoti Kalita,DIBRUGARH,AITC,0,10th Pass,25004000,32650000,0
819,Mohd. Aftab Alam,JABALPUR,BSP,1,Post Graduate,4282755,14000000,0
