Sno,ID,Candidate,Constituency,Party,Criminal Case,Education,Total Assets,Liabilities,Net Assets
1,148,Kaushal Yadav,NAWADA,JD(U),8,Post Graduate,154566136,2604969,151961167
2,1906,A Biju,ALATHUR,IND,0,8th Pass,564425,175000,389425
3,8,A N Radhakrishnan,ERNAKULAM,BJP,0,Graduate,7813475,0,7813475
4,901,A Pandian,ANDAMAN & NICOBAR ISLANDS,AIFB,0,12th Pass,859410,350000,509410
5,1105,A Prasad,KOLAR,IND,0,10th Pass,840000,0,840000
6,340,A Sampath,ATTINGAL,CPI(M),1,Doctorate,17791149,1421392,16369757
7,173,A Vijayaraghavan,KOZHIKODE,CPI(M),0,Graduate Professional,5757792,152305,5605487
8,397,A. Devadas,BELLARY,SUCI(C),0,10th Pass,1154658,0,1154658
9,336,A. Josekutty,KOLLAM,IND,0,10th Pass,545117,224328,320789
10,1850,A. P. Shamseer,VADAKARA,IND,0,Literate,55620,0,55620
11,117,A. Raghunath Varma,BERHAMPUR,IND,0,Post Graduate,270800,0,270800
12,993,A.K. Aggarwal,NORTH EAST DELHI,Agar Jan Party,1,10th Pass,14058166,0,14058166
13,2206,A.K.Parashurama Kotemallur,DAVANAGERE,BSP,0,12th Pass,215000,0,215000
14,700,A.K.Salahudeen,KOLLAM,SDPI,1,12th Pass,6562365,0,6562365
15,183,A.Krishnappa,TUMKUR,JD(S),0,Graduate,701833242,175031509,526801733
16,1847,A.M.Smitha,VADAKARA,CPI(ML) Red star,0,Graduate,22000,0,22000
17,2612,A.P. Ahamad,HASSAN,BSP,0,Illiterate,1100000,500000,600000
18,1222,A.R. Krishna Murthy,CHAMARAJANAGAR,BJP,0,Post Graduate,41281286,2886427,38394859
19,2571,A.S.Dsilva,TUMKUR,AAP,0,Graduate,33229897,0,33229897
20,1081,A.T. Dadakhalandar,DAVANAGERE,IND,0,10th Pass,36042,19623,16419
21,1951,A.V.Thamarakshan,ALAPPUZHA,Revolutionary Socialist Party of Kerala (B),1,Post Graduate,10641399,0,10641399
22,2818,Aasutosh Verma,GIRIDIH,AITC,0,Graduate Professional,384828136,46546450,338281686
23,250,Abbas Mothalappara,KASARAGOD,AITC,0,10th Pass,102000,0,102000
24,983,Abdul Amir Amiro,CHANDNI CHOWK,IND,0,5th Pass,4122551,0,4122551
25,2630,Abdul Azeem,BANGALORE NORTH,JD(S),0,Post Graduate,158909760,0,158909760
26,3451,Abdul Aziz,NAGAUR,BSP,0,Graduate,2400000,0,2400000
27,2386,Abdul Aziz Bhartiya,JAIPUR,Rashtriya Ulama Council,0,Graduate,67000,0,67000
28,212,Abdul Hafeez Abdul Aziz,BULDHANA,BSP,0,12th Pass,425000,225000,200000
29,360,Abdul Hameed,BIDAR,Welfare Party of India,0,Post Graduate,15287118,0,15287118
30,258,Abdul Jabbar K K,KANNUR,SDPI,4,10th Pass,3403545,0,3403545
31,171,Abdul Jaleel,WAYANAD,SDPI,0,Graduate,8813205,0,8813205
32,1923,Abdul Kareem,CHALAKUDY,IND,0,10th Pass,2746000,0,2746000
33,460,Abdul Latif,GURGAON,IND,0,5th Pass,50000,0,50000
34,880,Abdul Majid Chouhan,JAMMU,IND,0,10th Pass,2600000,0,2600000
35,2265,Abdul Mannan Barbhuiya,SILCHAR,AAP,0,Graduate,1042000,900000,142000
36,908,Abdul Muneer,LAKSHADWEEP,CPI(M),0,Post Graduate,1395365,0,1395365
37,3997,Abdul Rahim,HAZARIBAGH,Bahujan Mukti Party,0,Graduate,1800000,0,1800000
38,1212,Abdul Salam N U,KASARAGOD,SDPI,1,Post Graduate,3620329,1182188,2438141
39,990,Abdul Sami Salmani,NORTH EAST DELHI,BSP,0,Others,4331561,160000,4171561
40,3921,Abdul Tahir (Bablu - Advocate),BHOPAL,IND,0,Graduate Professional,2573572,1600,2571972
41,1540,Abdul Wafati Ansari Urf Yuvraj Tailors,REWA,Samata Party,0,10th Pass,1131000,1200000,0
42,1883,Abdurahiman Vadakkathinakath,PONNANI,IND,0,8th Pass,5488050,0,5488050
43,1885,Abdurahiman Varikottil,PONNANI,IND,0,Literate,13110077,0,13110077
44,1884,Abdurahiman Vayarakath,PONNANI,IND,0,Literate,3037410,375000,2662410
45,2800,Abha Pandey,MAHASAMUND,Chhattisgarh Swabhiman Manch,0,8th Pass,5708000,150000,5558000
46,3362,Abhijit Anil Apte,MAVAL,IND,0,12th Pass,462306,0,462306
47,3643,Abhijit Shriram Hegshetye,RATNAGIRI SINDHUDURG,AAP,0,Post Graduate,20692366,4273594,16418772
48,3,Abhimod,PALAKKAD,IND,0,Post Graduate,2908779,370000,2538779
49,2316,Abhinesh Maharshi,CHURU,BSP,0,Post Graduate,38238575,4130000,34108575
50,107,Abhishek Singh,RAJNANDGAON,BJP,0,Graduate Professional,44093207,0,44093207
51,253,Aboobacker Siddique,KASARAGOD,IND,0,8th Pass,38000,0,38000
52,1896,Aboobakker Sidique,PALAKKAD,AITC,0,Illiterate,47004,0,47004
53,1855,Abraham Benhur,WAYANAD,IND,0,Post Graduate,9999242,1421961,8577281
54,1507,Abrar Ahmad Mahmud Khan,YAVATMAL-WASHIM,Welfare Party of India,0,Others,6299991,700000,5599991
55,4015,Abul Hasan,RANCHI,IND,0,Post Graduate,165500,0,165500
56,277,Abullais.T.P,PONNANI,IND,0,12th Pass,6692346,0,6692346
57,3194,Acharya Pramod Krishnam,SAMBHAL,INC,0,Post Graduate,49900443,0,49900443
58,1151,Achutananda Nag,BOLANGIR,Ambedkarite Party of India,0,Graduate Professional,208500,0,208500
59,616,Adagooru H Vishwanath,MYSORE,INC,0,Graduate Professional,30187177,0,30187177
60,3391,Adhalrao Shivaji Dattatrey,SHIRUR,SHS,10,Post Graduate,253598315,61810866,191787449
61,1015,Aditya Narayan,NAWADA,IND,0,Graduate,15770000,0,15770000
62,315,Adsul Anandrao Vithoba,AMRAVATI,SHS,1,Graduate,32596257,1587104,31009153
63,3649,Adv Dipak Dattaram Nevgi,RATNAGIRI SINDHUDURG,Socialist Party (India),0,Post Graduate,13431575,92000,13339575
64,1909,Adv. A. Jayaram,THRISSUR,BSP,0,Graduate Professional,24702613,628000,24074613
65,3328,Adv. Ajay Sitaram Karande Patil,PARBHANI,SP,0,Post Graduate,9510000,330000,9180000
66,780,Adv. Bandya Sane Alias Bandu Sampatrao Sane,AMRAVATI,IND,0,Post Graduate,31300,0,31300
67,1213,Adv. Basheer Alady,KASARAGOD,BSP,0,Post Graduate,785138,0,785138
68,1976,Adv. Chirayinkeezhu Gopinathan,ATTINGAL,RPI(A),0,Graduate Professional,920662,100000,820662
69,3310,Adv. Deelip Kulkarni,NANDED,IND,0,Graduate Professional,2990000,50000,2940000
70,3022,Adv. Jawahar Leonardo Dias,SOUTH GOA,Goemcarancho Otrec Astro,1,Post Graduate,564223740,484000,563739740
71,3658,Adv. K. D. Shinde,SANGLI,JD(S),0,Post Graduate,4387851,600000,3787851
72,1975,Adv. M. R. Sarin,ATTINGAL,JD(U),0,Graduate Professional,790325,87000,703325
73,3404,Adv. Mahendra Dadasaheb Shinde,SHIRDI,BSP,0,Doctorate,52137,90000,0
74,286,Adv. N.Sreeprakash,MALAPPURAM,BJP,0,Graduate Professional,6781097,317500,6463597
75,1989,Adv. Narendra Keshav Sawaikar,SOUTH GOA,BJP,0,Graduate Professional,6260382,0,6260382
76,1858,Adv. P. P. A. Sageer,WAYANAD,AAP,0,Graduate Professional,4539401,57788,4481613
77,2487,Adv. Peelipose Thomas,PATHANAMTHITTA,IND,1,Graduate Professional,5648161,928336,4719825
78,2508,Adv. Perurkada Harikumar,THIRUVANANTHAPURAM,SHS,4,Graduate Professional,2511500,0,2511500
79,931,Adv. Prabhakar Mahaguji Dadmal,GADCHIROLI-CHIMUR,RPI,0,Post Graduate,560000,0,560000
80,1986,Adv. Raju Mangeshkar,SOUTH GOA,CPI,1,Graduate Professional,4904426,0,4904426
81,1381,Adv. Ravindra Dnyandeo Bhojane,BULDHANA,Aambedakarite Party of India,0,Graduate Professional,119757,0,119757
82,3694,Adv. Sanjeev Sidram Sadafule,SOLAPUR,BSP,0,Graduate Professional,2397559,625000,1772559
83,3568,Adv. Savita Balkrishna Shinde,MADHA,AAP,0,Graduate Professional,2737166,0,2737166
84,3593,Adv. Shailendra Rameshwar Yavalkar,OSMANABAD,SP,0,Graduate Professional,22243300,1125000,21118300
85,3664,Adv. Varsha Madgulkar,SATARA,IND,0,Graduate Professional,13052635,8706000,4346635
86,169,Adv.A.N.Shamseer,VADAKARA,CPI(M),0,Graduate Professional,1330825,0,1330825
87,694,Adv.Bindhu Krishna,ATTINGAL,INC,2,Post Graduate,3764729,853967,2910762
88,1464,Adv.Dadasaheb Alias Dhanu Bhikaji Walthare,BHANDARA-GONDIYA,IND,0,Graduate Professional,5395083,0,5395083
89,706,Adv.Dean Kuriakose,IDUKKI,INC,1,Not Given,314050,411719,0
90,712,Adv.Joice George,IDUKKI,IND,4,Graduate Professional,17396207,9417720,7978487
91,323,Adv.M.A.Bindu,ALAPPUZHA,SUCI(C),0,Graduate Professional,3543000,0,3543000
92,703,Adv.P.K.Jayakrishnan,MAVELIKKARA,BSP,0,Post Graduate,15410000,400000,15010000
93,959,Adv.P.Sudheer,MAVELIKKARA,BJP,8,Graduate Professional,329804,0,329804
94,699,Adv.S.Prahladan,KOLLAM,BSP,0,Graduate Professional,21645000,0,21645000
95,2578,Adv.Shivajirao Shivaramji Moghe,YAVATMAL-WASHIM,INC,2,Graduate Professional,42689718,11315807,31373911
96,3569,Adv.Subhash Balasaheb Patil (Anna),MADHA,Bahujan Mukti Party,1,Post Graduate,8581681,1502262,7079419
97,3873,Aghav Jayprakash Sitaram,BEED,IND,3,10th Pass,151000,0,151000
98,2093,Aherwan Dharmender Rawat,FARIDABAD,IND,0,12th Pass,6109500,335000,5774500
99,926,Ahir Hansraj Gangaram,CHANDRAPUR,BJP,11,10th Pass,15548000,99500,15448500
100,1508,Ahmad Parvez Iqbal Ahmad Nur Mohammad,YAVATMAL-WASHIM,SP,1,Graduate,3957500,0,3957500
101,2081,Ahshan Ali,GURGAON,IND,0,Graduate,2090000,0,2090000
102,150,Ajad Geeta Prasad Sharma,NAWADA,IND,0,12th Pass,7080000,0,7080000
103,2531,Ajaj Julmoin Khan (Ajaj Khan),NAGPUR,IND,1,12th Pass,137000,0,137000
104,729,Ajay Arjun Singh,SATNA,INC,2,Post Graduate,254876883,13845072,241031811
105,3107,Ajay Kumar,KHERI,BJP,2,Graduate Professional,26505977,10000000,16505977
106,2320,Ajay Kumar,CHURU,IND,0,Post Graduate,4926438,0,4926438
107,2847,Ajay Kumar,JAMSHEDPUR,JVM,7,Graduate Professional,124349901,6979341,117370560
108,3312,Ajay Kumar Behera,JAGATSINGHPUR,CPI,0,Post Graduate,5137088,0,5137088
109,969,Ajay Kumar Khemka,CHANDNI CHOWK,Kalyankari Jantantrik Party,0,Graduate,4724526,625000,4099526
110,1109,Ajay Kumar Panjabrao Hingankar,AKOLA,AAP,0,Graduate,8035000,700000,7335000
111,2361,Ajay Kumar Sharma,JAIPUR RURAL,Jago Party,0,Graduate,4550119,0,4550119
112,495,Ajay Maken,NEW DELHI,INC,1,Post Graduate,61098675,500000,60598675
113,1528,Ajay Pratap Singh,SATNA,IND,0,12th Pass,900000,0,900000
114,591,Ajay Singla,CHANDIGARH,IND,2,10th Pass,9877806,0,9877806
115,3623,Ajay Vasant Paithankar,PUNE,IND,0,Graduate,14080500,237000,13843500
116,1831,Ajaykumar Sarnaik,BAGALKOT,INC,0,Graduate,501321313,100587230,400734083
117,2344,Ajaypal,SIKAR,IND,0,10th Pass,3295920,100000,3195920
118,1650,Ajaypal,BAGHPAT,IND,0,8th Pass,5790000,0,5790000
119,3646,Ajinkya Dhondu Gawade,RATNAGIRI SINDHUDURG,IND,0,Graduate,2058757,243784,1814973
120,637,Ajit Joy,THIRUVANANTHAPURAM,AAP,0,Post Graduate,37145768,3500000,33645768
121,3996,Ajit Kumar Singh,HAZARIBAGH,AITC,0,12th Pass,6000000,912823,5087177
122,3079,Ajit Pal Singh,BADAUN,Peace Party,0,Graduate,8900000,0,8900000
123,2797,Ajit Pramod Kumar Jogi,MAHASAMUND,INC,1,Graduate Professional,61583410,1500000,60083410
124,671,Ajit Singh,BAGHPAT,RLD,0,Post Graduate,169254660,0,169254660
125,1964,Ajith Kumar K K,PATHANAMTHITTA,IND,1,Graduate,663000,342000,321000
126,2411,Ajmat Ali,KOTA,Bharatiya Yuva Shakti,0,8th Pass,193438,0,193438
127,2493,Akar Dhoj Limbu,SIKKIM,INC,0,Graduate Professional,5504900,0,5504900
128,4084,Akash Gupta,MORENA,IND,0,Graduate,505042,0,505042
129,3181,Akbar Husain,RAMPUR,BSP,0,10th Pass,62120983,3790727,58330256
130,2077,Akbar Kasmi,GURGAON,Rashtriya Ulama Council,0,Others,1592000,0,1592000
131,3182,Akbar Masood,RAMPUR,IND,0,Post Graduate,2513782,0,2513782
132,1012,Akhei Achumi,NAGALAND,Socialist Party (India),0,Graduate,3122000,0,3122000
133,2954,Akhilesh,GWALIOR,CPI(M),1,Graduate,184700,0,184700
134,3064,Akmal Khan Urf Chaman,BADAUN,BSP,0,Literate,14679858,1510000,13169858
135,1901,Albin M U,ALATHUR,IND,0,12th Pass,900,0,900
136,1988,Aleixo Reginaldo Lourenco,SOUTH GOA,INC,0,12th Pass,31453008,905729,30547279
137,967,Aleyamma Varghese,PATHANAMTHITTA,AITC,0,10th Pass,22800000,4200000,18600000
138,1846,Ali Akbar,VADAKARA,AAP,0,12th Pass,4448946,2674831,1774115
139,995,Ali Husan,NORTH EAST DELHI,IND,0,5th Pass,1047500,0,1047500
140,832,Ali Kishor Patnaik,BERHAMPUR,CPI(M),1,Graduate,7450333,0,7450333
141,2907,Alok Sanjar,BHOPAL,BJP,0,Graduate Professional,14594066,300000,14294066
142,2950,Alok Sharma,GWALIOR,BSP,0,8th Pass,20454704,0,20454704
143,3661,Altaf Abdulgani Shikalgar,SATARA,Bahujan Mukti Party,0,8th Pass,5727145,227144,5500001
144,3302,Altaf Ahamad Iqbal Ahmad,NANDED,IUML,0,Graduate,4462742,571000,3891742
145,968,Altaf Husain,CHANDNI CHOWK,Bhartiya Janta Dal (Integrated),0,12th Pass,4790000,0,4790000
146,3594,Altaf Husain Yenegure,OSMANABAD,IND,0,Graduate,1690000,0,1690000
147,851,Alur M.G. Swamy,DAVANAGERE,IND,0,Graduate,36920000,150000,36770000
148,2793,Amal Say Sori,KANKER,IND,0,Graduate,362500,400000,0
149,4007,Amanullah,RANCHI,AAP,0,Post Graduate,2391132,126000,2265132
150,2288,Amar Singh,GANGANAGAR,Bahujan Mukti Party,0,10th Pass,1230000,586706,643294
151,2343,Amara Ram,SIKAR,CPI(M),0,Post Graduate,4681929,774000,3907929
152,592,Amarjit Kaur,CHANDIGARH,IND,0,8th Pass,7020000,500000,6520000
153,1142,Amarnath Pradhan,SAMBALPUR,INC,0,Post Graduate,56069048,0,56069048
154,1011,Amarson Sankhil,OUTER MANIPUR,IND,0,Post Graduate,857093,0,857093
155,1210,Ambalathara Kunhikrishnan,KASARAGOD,AAP,0,10th Pass,245690,0,245690
156,214,Ambedkar Prakash Yashwant,AKOLA,Bharipa Bahujan Mahasangh,3,Graduate Professional,35716840,1400000,34316840
157,3013,Ambesh Kumari,TIKAMGARH,SP,1,Doctorate,15710045,3255734,12454311
158,3734,Ambrose D,BANGALORE CENTRAL,IND,0,Post Graduate,575,0,575
159,2970,Amit Bhatnagar,KHAJURAHO,AAP,0,Post Graduate,2136231,0,2136231
160,3137,Amit Kumar,MORADABAD,Bahujan Mukti Party,0,Post Graduate,446061,0,446061
161,1000,Amit Kumar Sharma,NORTH EAST DELHI,IND,0,Graduate,1710000,0,1710000
162,4016,Amit Kumar Singh,RANCHI,IND,0,12th Pass,1169044,9000,1160044
163,1798,Amita Singh Jaat,ALIGARH,Sarva Samaj Kalyan Party,0,Post Graduate,3865000,0,3865000
164,2873,Amitabh Choudhary,RANCHI,JVM,0,Graduate Professional,17931854,1095618,16836236
165,3261,Amiya Kanta Mallick,JAJPUR,BJP,0,10th Pass,10680000,5130000,5550000
166,24,Anand Kumar,NORTH EAST DELHI,AAP,0,Doctorate,29255377,72369,29183008
167,3763,Ananda G,CHAMARAJANAGAR,IND,0,Others,130000,0,130000
168,2602,Ananda Gatty,DAKSHINA KANNADA,IND,0,Graduate Professional,5328850,450000,4878850
169,794,Ananda Kumar Samal,SAMBALPUR,AAP,0,Post Graduate,169838,123121,46717
170,2180,Anandaraj Dokka,DHARWAD,IND,0,8th Pass,220000,0,220000
171,2808,Anandram Sahu,RAJNANDGAON,BSP,0,8th Pass,6680680,300000,6380680
172,2924,Anant Lal Basor,DAMOH,IND,0,10th Pass,9014000,0,9014000
173,96,Anant Nayak,KEONJHAR,BJP,0,12th Pass,5241777,875448,4366329
174,189,Ananth Kumar,BANGALORE SOUTH,BJP,0,Graduate Professional,45224706,2883233,42341473
175,398,Anantkumar Hegde,UTTARA KANNADA,BJP,0,12th Pass,32367360,15139611,17227749
176,2849,Angad Mahato,JAMSHEDPUR,Amra Bangalee,1,10th Pass,4005014,0,4005014
177,2057,Anil,ROHTAK,Rashtriya Bahujan Hitay Party,0,10th Pass,1520000,0,1520000
178,1639,Anil,MEERUT,IND,0,12th Pass,1594367,104944,1489423
179,1996,Anil,KURUKSHETRA,IND,0,5th Pass,18036000,0,18036000
180,3490,Anil Jaysing Ghanvat,AHMEDNAGAR,IND,6,Graduate,33340000,163597,33176403
181,3898,Anil Khajuria,UDHAMPUR,IND,0,Graduate Professional,25000,0,25000
182,2042,Anil Kumar,SONIPAT,Rashtriya Bahujan Hitay Party,0,10th Pass,10875000,0,10875000
183,2366,Anil Kumar,JAIPUR RURAL,AAP,0,10th Pass,2992554,201420,2791134
184,1651,Anil Kumar,BAGHPAT,Peace Party,4,12th Pass,55427000,7522794,47904206
185,1619,Anil Kumar,MUZAFFARNAGAR,Bahujan Mukti Party,0,Graduate Professional,4662600,518000,4144600
186,640,Anil Kumar,THIRUVANANTHAPURAM,IND,0,12th Pass,40000,0,40000
187,2769,Anil Kumar,PATNA SAHIB,IND,0,Post Graduate,199542,0,199542
188,1928,Anil Kumar,ERNAKULAM,IND,0,8th Pass,72000,0,72000
189,2784,Anil Kumar Gupta,UDHAMPUR,IND,0,Graduate,51621298,1717547,49903751
190,695,Anil Kumar N S,ATTINGAL,BSP,1,12th Pass,433000,0,433000
191,1240,Anil Kumar Oraon,CHATRA,IND,0,10th Pass,3490000,25000,3465000
192,2370,Anil Kumar Sharma,JAIPUR,Jago Party,0,Graduate,75100,0,75100
193,2677,Anil Kumar Sharma,JAHANABAD,JD(U),1,Doctorate,8498803720,1095393904,7403409816
194,3073,Anil Kumar Sharma,BADAUN,Labour Party of India (V.V. Prasad),0,Graduate Professional,4900000,0,4900000
195,603,Anil M.R,SHIMOGA,IND,0,Others,774819,1252161,0
196,3373,Anil Shirole,PUNE,BJP,2,Graduate,227615279,4781007,222834272
197,305,Anilkumar R,KOTTAYAM,AAP,0,Post Graduate,1686239,360000,1326239
198,3156,Anis Ahamad Khan,PILIBHIT,BSP,0,Graduate,32411744,0,32411744
199,1942,Anish Mariyil,IDUKKI,IND,0,12th Pass,8569000,0,8569000
200,2893,Anita Hitendra Chaudhary,BHIND,SP,0,Graduate,15514000,10000,15504000
201,3416,Anita Jain,AJMER,IND,0,Graduate Professional,4700000,0,4700000
202,584,Anita Mondal,ANDAMAN & NICOBAR ISLANDS,AITC,1,Graduate,5471073,6000,5465073
203,1440,Anita Nagdigambar Tekam,NAGPUR,IND,0,8th Pass,10500,0,10500
204,719,Anitha Prathap,ERNAKULAM,AAP,0,Graduate Professional,203330000,0,203330000
205,1454,Anjali Anish Damania,NAGPUR,AAP,0,Graduate Professional,193161591,1399670,191761921
206,4512,Anjana Udai Lal,JALORE,INC,0,12th Pass,658610000,202559600,456050400
207,4014,Anjani Pandey,RANCHI,IND,0,Graduate Professional,25000,0,25000
208,1729,Anju Urf Muskan,BULANDSHAHR,RLD,0,12th Pass,2995000,1656134,1338866
209,1340,Anjuman Agnihotri,NEW DELHI,IND,0,12th Pass,930631,169975,760656
210,1620,Ankur,MUZAFFARNAGAR,IND,0,12th Pass,7425346,0,7425346
211,1405,Ankush Vijayrao Nawale,WARDHA,SP,0,Graduate Professional,1551000,72000,1479000
212,1924,Annamma Joy,CHALAKUDY,AITC,0,Graduate,6397000,2040000,4357000
213,2983,Anoop Mishra,MORENA,BJP,0,12th Pass,110523112,6878160,103644952
214,2988,Anoop Nagar,MORENA,IND,0,Literate,420000,0,420000
215,2862,Anosh Ekka,KHUNTI,Jharkhand Party,3,10th Pass,36766971,4224902,32542069
216,3229,Anta Alok Baskey,MAYURBHANJ,AJSUP,0,Graduate,8604192,600000,8004192
217,964,Anto Antony,PATHANAMTHITTA,INC,0,Graduate,5410884,4211050,1199834
218,764,Anubha Munjare,BALAGHAT,SP,5,Post Graduate,36108915,2167687,33941228
219,757,Anuj Ganga Singh Patta,MANDLA,GGP,0,Graduate,4480097,2220000,2260097
220,514,Anup Phukon,DIBRUGARH,AGP,0,Post Graduate,4737100,3549764,1187336
221,2043,Anup Sing Dahiya,SONIPAT,Rashtriya Jatigat Aarakshan Virodhi Party,0,10th Pass,13153500,152500,13001000
222,3311,Anupama Sethy,JAGATSINGHPUR,AAP,0,Post Graduate,525564,10000,515564
223,3294,Anwar,TUMKUR,IND,0,Graduate,2886450,0,2886450
224,2973,Anwar Khan,KHAJURAHO,IND,0,10th Pass,901857,0,901857
225,2944,Anwar Khan,GUNA,IND,0,10th Pass,77000,0,77000
226,1875,Anwar Shakeel Omar,MALAPPURAM,IND,0,Post Graduate,4809396,0,4809396
227,3278,Aparajita Mohanty,CUTTACK,INC,0,Graduate,27791663,7903022,19888641
228,1634,Aphajal,MEERUT,IND,1,8th Pass,425000,0,425000
229,1936,Appanchira Ponnappan,IDUKKI,BSP,0,10th Pass,7611000,0,7611000
230,1819,Appasaheb Kurane,CHIKKODI,Sarva Janata Party,0,12th Pass,348900,0,348900
231,3203,Aqeel Ahmad,SAMBHAL,IND,0,12th Pass,6180000,0,6180000
232,3190,Aqeel Ur Rehman Khan,SAMBHAL,BSP,0,Post Graduate,32724982,2506410,30218572
233,1219,Arakera Shivanagouda Nayak,RAICHUR,BJP,1,Graduate,45433720,7544250,37889470
234,3808,Aravind Premanand,MANDYA,IND,0,Graduate Professional,662000,0,662000
235,2475,Arjan Puri,BARMER,IND,0,Literate,386000,0,386000
236,3251,Arjun Charan Mallik,BHADRAK,BSP,0,Graduate Professional,7817500,0,7817500
237,3246,Arjun Charan Sethi,BHADRAK,BJD,0,Post Graduate,6730000,2424000,4306000
238,3869,Arjun Hanmanta Nimbalkar,BEED,IND,0,10th Pass,225000,19000,206000
239,2304,Arjun Ram Meghwal,BIKANER,BJP,0,Post Graduate,18142863,1216408,16926455
240,466,Arjun Singh Thakur,BASTAR,Ambedkarite Party of India,0,Post Graduate,46885000,250000,46635000
241,2693,Arjun Thakur,JAHANABAD,IND,0,Post Graduate,1212500,0,1212500
242,1160,Arjuna Bhatara,NABARANGPUR,Odisha Jan Morcha,0,Graduate,4137000,815000,3322000
243,2449,Arjunlal Meena,UDAIPUR,BJP,0,Post Graduate,17049951,8195866,8854085
244,815,Arka Keshari Deo,KALAHANDI,BJD,0,Graduate,69822063,831688,68990375
245,3157,Arman Khan,PILIBHIT,IND,0,Graduate Professional,91775,40000,51775
246,537,Armerington Kharshiing,SHILLONG,AAP,0,Not Given,10547837,211214,10336623
247,4017,Arsad Ayub,RANCHI,IND,1,10th Pass,5746855,0,5746855
248,3059,Arshadurraza Khan,AONLA,IND,0,Post Graduate,3973500,0,3973500
249,2984,Arujn Singh (Pappu Kushwah),MORENA,Rashtriya Samanta Dal,0,8th Pass,2006618,0,2006618
250,3377,Arun Bhatia,PUNE,Peoples Guardian,1,Post Graduate,842515000,8000000,834515000
251,3647,Arun Harishchandra Manjrekar,RATNAGIRI SINDHUDURG,IND,0,10th Pass,3745087,26000,3719087
252,410,Arun Kumar,AMBALA,CPI,0,Graduate Professional,450000,0,450000
253,2008,Arun Kumar,HISAR,IND,0,12th Pass,13095700,320000,12775700
254,1794,Arun Kumar Agarwal,DARJEELING,IND,0,12th Pass,29039342,0,29039342
255,165,Arun Kumar Bhowmik,TRIPURA WEST,SUCI(C),0,Graduate,2443828,145939,2297889
256,2839,Arun Kumar Mishra,HAZARIBAGH,JVM,0,Graduate,55808583,23803410,32005173
257,2542,Arun Nagorao Gajbhiye,BHANDARA-GONDIYA,IND,0,Graduate,1295000,8382,1286618
258,1362,Arun Thakur,EAST DELHI,Samyak Parivartan Party,0,12th Pass,1081500,0,1081500
259,613,Arunakumara,MANDYA,IND,0,8th Pass,225000,0,225000
260,2254,Arunangshu Bhattacharjee,SILCHAR,SUCI(C),0,Post Graduate,873605,666567,207038
261,244,Arunoday Saha,TRIPURA WEST,INC,0,Doctorate,33892463,0,33892463
262,138,Arup Kumar Mahanta,KALIABOR,CPI(ML)L,0,Graduate,458613,0,458613
263,1653,Arvind,BAGHPAT,IND,0,12th Pass,410000,100,409900
264,1590,Arvind Dongre,CHHINDWARA,Bahujan Mukti Party,0,10th Pass,4084000,0,4084000
265,3109,Arvind Giri,KHERI,BSP,20,Graduate Professional,26196212,1471211,24725001
266,205,Arvind Kumar Sharma,KARNAL,INC,0,Post Graduate,35428444,15584114,19844330
267,1404,Arvind Shamrao Lillore,WARDHA,IND,0,Others,144186,0,144186
268,2034,Arvind Tiwari,KARNAL,IND,0,Doctorate,160000,0,160000
269,3138,Asarpat Singh,NAGINA,IND,0,12th Pass,600528,0,600528
270,2406,Asfak Ali,KOTA,IND,0,8th Pass,1050000,0,1050000
271,1545,Asha Singh,SIDHI,Rashtriya Apna Dal,0,10th Pass,67500,0,67500
272,3624,Ashapak Shaikh,PUNE,IND,1,8th Pass,110000,0,110000
273,2513,Ashatai Abhyankar Amravati,AMRAVATI,IND,0,Graduate,3450000,1360000,2090000
274,1814,Ashfaq Ahmed Madaki,CHIKKODI,AAP,0,Post Graduate,419204,0,419204
275,440,Ashish,KARNAL,AIFB,0,Graduate,2077000,1100000,977000
276,1238,Ashish Bhushan Pathak,CHATRA,IND,0,Post Graduate,3530500,0,3530500
277,29,Ashish Khetan,NEW DELHI,AAP,0,Post Graduate,17172618,3005294,14167324
278,2711,Ashish Ranjan Sinha,NALANDA,INC,0,Graduate,94210202,0,94210202
279,3115,Ashok,KHERI,AAP,0,Graduate Professional,392000,580000,0
280,3329,Ashok Babarao (Ambhore) Dudhgaonkar,PARBHANI,Ambedkar National Congress,0,12th Pass,50000,0,50000
281,3872,Ashok Bhagoji Thorat,BEED,IND,0,Not Given,50000,0,50000
282,2078,Ashok Bhardwaj,GURGAON,National Janhit Congress (AB),0,Graduate Professional,239374641,3790167,235584474
283,787,Ashok Bisi,BARGARH,CPI,2,Graduate Professional,644707,15000,629707
284,2416,Ashok Chandna,BHILWARA,INC,1,Graduate,141642689,89589191,52053498
285,3871,Ashok Dhondiba Sonwane,BEED,IND,0,8th Pass,0,0,0
286,3650,Ashok Dnanu Mane(Bhau),SANGLI,IND,0,12th Pass,527584,39000,488584
287,128,Ashok Kumar,SATNA,IND,0,Graduate,289957,0,289957
288,570,Ashok Kumar,JAMMU,BSP,0,10th Pass,4435000,350000,4085000
289,621,Ashok Kumar,NAWADA,Rajnaitik Vikalp Party,1,Literate,3116000,0,3116000
290,2403,Ashok Kumar,KOTA,BSP,0,5th Pass,421000,0,421000
291,393,Ashok Kumar,GAYA,JMM,0,Post Graduate,1843000,0,1843000
292,2400,Ashok Kumar Jain,KOTA,AAP,0,Graduate Professional,30617000,333466,30283534
293,131,Ashok Kumar Masih,BALAGHAT,CPI,0,5th Pass,184000,0,184000
294,1141,Ashok Kumar Panda,SAMBALPUR,IND,0,Graduate,5947626,853925,5093701
295,2238,Ashok Kumar Sharma,JAMMU,IND,0,Graduate,6156613,215602,5941011
296,2044,Ashok Kumar Vashishth,SONIPAT,RPI(A),0,10th Pass,1501000,0,1501000
297,689,Ashok Mahadeorao Nete,GADCHIROLI-CHIMUR,BJP,0,12th Pass,12125676,5830550,6295126
298,792,Ashok Mittal,BARGARH,AITC,0,10th Pass,0,0,0
299,2915,Ashok Pawar,BHOPAL,Samata Samadhan Party,1,12th Pass,4808000,600000,4208000
300,3338,Ashok Pradhan,PURI,CPI(ML)L,2,Graduate Professional,2006000,300000,1706000
301,2646,Ashok Ram,ARRAH,IND,0,12th Pass,71051,0,71051
302,1259,Ashok Ram,PALAMAU,IND,0,10th Pass,3099116,0,3099116
303,3340,Ashok Sahu,PURI,BJP,1,Post Graduate,55639509,0,55639509
304,3392,Ashok Shirpati Khandebharad,SHIRUR,MNS,2,Graduate,11569911,1781742,9788169
305,2953,Ashok Singh,GWALIOR,INC,0,Graduate,288174756,77611615,210563141
306,418,Ashok Tanwar,SIRSA,INC,1,Doctorate,72777188,11222039,61555149
307,924,Ashok Vithoba Khandale,CHANDRAPUR,RPI,0,Graduate,10956000,1000000,9956000
308,3677,Ashok Waman Gaikwad,SATARA,RPI(A),3,12th Pass,13608263,857836,12750427
309,3810,Ashraf,MANDYA,IND,0,10th Pass,7310000,0,7310000
310,3113,Ashraf Ali,KHERI,Peace Party,1,Graduate Professional,141782,18710,123072
311,490,Ashutosh,CHANDNI CHOWK,AAP,3,Post Graduate,81121758,11140787,69980971
312,22,Ashutosh Mudgil,CHANDNI CHOWK,IND,0,8th Pass,453921,0,453921
313,1038,Ashwani Malhotra,KURUKSHETRA,AITC,0,10th Pass,1284743,0,1284743
314,2272,Ashweng J. Rengma,AUTONOMOUS DISTRICT,JMM,0,10th Pass,960000,0,960000
315,1052,Ashwini Kumar,KARNAL,BJP,6,Graduate,698638135,153937858,544700277
316,2656,Ashwini Kumar Choubey,BUXAR,BJP,0,Graduate,22094499,1923552,20170947
317,1579,Asif Khan,BALAGHAT,Minorities Democratic Party,0,10th Pass,180000,0,180000
318,4078,Asif Khan,GWALIOR,IND,0,5th Pass,491000,0,491000
319,2419,Aslam Shekh Advocate,BHILWARA,IND,0,Post Graduate,7290000,0,7290000
320,3260,Asok Das,JAJPUR,INC,0,Post Graduate,14693759,5579589,9114170
321,1578,Asra Anjum Farooqui,BALAGHAT,RPI(A),0,Graduate,450000,0,450000
322,4003,Asrita Tuti,KHUNTI,IND,0,Post Graduate,3398931,560769,2838162
323,1167,Aswini Kumar Padhy,BERHAMPUR,BSP,0,Graduate Professional,392889,32000,360889
324,438,Atam Parkash,HISAR,IND,0,Post Graduate,13665554,0,13665554
325,352,Ateeque Ahmad Mohd. Badiujjama,NAGPUR,IND,2,10th Pass,14360527,7606,14352921
326,1113,Athawaley Sanjay Hiramanji,AMRAVATI,IND,1,Graduate,1120000,268900,851100
327,1848,Attuveppil Kunhikkannan,VADAKARA,IND,0,5th Pass,452079,19000,433079
328,1487,Atul Ashok Munginwar,CHANDRAPUR,IND,1,12th Pass,3400000,740000,2660000
329,1638,Atul Khodawal,MEERUT,IND,0,Illiterate,61500,0,61500
330,3072,Atul Kumar,BADAUN,IND,0,Graduate,2156941,593817,1563124
331,3002,Atul Mishra,SAGAR,AAP,1,Graduate Professional,4823372,173000,4650372
332,3535,Atul Prasannakumar Dighe,KOLHAPUR,Bharipa Bahujan Mahasangh,3,Post Graduate,15499770,0,15499770
333,2749,Avinash Kumar,PATALIPUTRA,Bharatiya Jan Kranti Dal (Democratic),0,Post Graduate,1520412,56797,1463615
334,3870,Avinash Namdev Wankhede,BEED,IND,2,Graduate Professional,745000,309000,436000
335,2971,Avnish Tiwari,KHAJURAHO,SHS,0,Graduate Professional,2918424,946893,1971531
336,1272,Avtar Singh Bhadana,FARIDABAD,INC,1,8th Pass,112529244,0,112529244
337,3496,Awade Kallappa Baburao,HATKANANGLE,INC,0,10th Pass,157503816,22322097,135181719
338,2733,Awadh Kumar,NALANDA,IND,0,Graduate,6189466,0,6189466
339,3901,Ayare Rajendra Lahu,RATNAGIRI SINDHUDURG,BSP,0,Post Graduate,1252000,200000,1052000
340,2972,Ayendr Kumar Sharma,KHAJURAHO,IND,0,Graduate,340000,0,340000
341,3082,Ayesha Islam,BAREILLY,SP,0,Graduate,26491794,4514160,21977634
342,3454,Ayub Khan,NAGAUR,SP,0,8th Pass,6579000,100000,6479000
343,3622,Azam Vakil Maniyar,PUNE,IND,0,5th Pass,284000,0,284000
344,3767,B N Gopalagowda,CHIKKBALLAPUR,IND,0,Graduate Professional,73000,0,73000
345,1895,B Padmanabhan,PALAKKAD,AAP,0,Graduate,1573288,0,1573288
346,2162,B Sreeramulu,BELLARY,BJP,8,Graduate,151392844,4050947,147341897
347,2216,B. Dharmappa,SHIMOGA,JD(U),0,Graduate Professional,13450336,700000,12750336
348,849,B. Gnana Prakash,DAVANAGERE,IND,0,Graduate,2665000,0,2665000
349,288,B. Gopalakrishnan,CHALAKUDY,BJP,2,Graduate Professional,5014237,644405,4369832
350,1097,B. R. Govindaiah,BANGALORE SOUTH,IND,0,12th Pass,4067500,23000,4044500
351,3732,B.K. Narayana-Swamy,BANGALORE CENTRAL,IND,0,10th Pass,3000,0,3000
352,2220,B.K. Shashi Kumar,SHIMOGA,Karunaadu Party,0,10th Pass,61000,0,61000
353,3783,B.M.Jayadev Mathad,HAVERI,IND,3,Graduate,3050000,300000,2750000
354,3804,B.Manohar Hanumantappa,KOPPAL,IND,0,10th Pass,2035000,0,2035000
355,1225,B.N. Bachhegouda,CHIKKBALLAPUR,BJP,0,Graduate Professional,475228512,83632650,391595862
356,1085,B.N.Chandrappa,CHITRADURGA,INC,0,Post Graduate,48303759,13800000,34503759
357,2894,B.S. Thaneswariya,BHIND,Bahujan Mukti Party,0,Post Graduate,597002,0,597002
358,399,B.S. Yeddyurappa,SHIMOGA,BJP,9,12th Pass,69746267,500000,69246267
359,842,B.T.Lalitha Naik,GULBARGA,AAP,0,8th Pass,6006253,0,6006253
360,2120,B.V.Nayak,RAICHUR,INC,0,Graduate Professional,73502466,0,73502466
361,3788,B.V.Venkatagiriyappa,KOLAR,IND,0,Graduate,100000,320000,0
362,3726,B.V.Venkateshappa,BANGALORE CENTRAL,IND,0,10th Pass,16105000,0,16105000
363,606,B.Venkatesha,TUMKUR,Karunaadu Party,0,Graduate Professional,6941000,4400000,2541000
364,2307,Baadshah,ALIGARH,Peace Party,0,8th Pass,62260000,500000,61760000
365,3331,Baban (Anna) Muley,PARBHANI,Bahujan Mukti Party,0,12th Pass,907000,400000,507000
366,2482,Babu Lal,BARMER,IND,0,8th Pass,569104,15000,554104
367,2629,Babu Mathew,BANGALORE NORTH,AAP,0,Post Graduate,94852273,494702,94357571
368,2430,Babu Meghwal,CHITTORGARH,IND,0,Literate,417102,0,417102
369,1306,Babu Singh Dukhiya,WEST DELHI,IND,1,Graduate,1851000,0,1851000
370,176,Babupasha,BIDAR,IND,0,Not Given,12500,50000,0
371,1451,Baburao Damaduji Meshram,NAGPUR,IND,0,12th Pass,3810000,200000,3610000
372,4000,Badri Gope,HAZARIBAGH,IND,0,5th Pass,1756000,0,1756000
373,3917,Badshah Khan,BHOPAL,Naya Daur Party,0,8th Pass,255000,0,255000
374,374,Bagi Kumar Verma,AURANGABAD,JD(U),0,Graduate,32766379,1600000,31166379
375,803,Bagi Lakra,SUNDARGARH,BSP,1,Graduate Professional,1925530,88983,1836547
376,456,Bahadur Singh,BHIWANI-MAHENDRAGARH,INLD,0,5th Pass,182580199,8699200,173880999
377,577,Bahadur Singh Chowdhary,JAMMU,SP,0,Graduate,1431120,298000,1133120
378,4008,Bahadur Uraon,RANCHI,CPI(ML)L,1,10th Pass,992464,600000,392464
379,3315,Baidhar Mallick,JAGATSINGHPUR,BJP,1,Graduate,6027197,700000,5327197
380,2637,Baijnath Yadav,ARRAH,Bahujan Mukti Party,0,5th Pass,6060167,350000,5710167
381,223,Baikuntha Dhangada Majhi,KALAHANDI,Kalinga Sena,0,10th Pass,20000,0,20000
382,1575,Baishakhoo Maravi,MANDLA,Bhartiya Satya Sangharsh Party,0,5th Pass,0,0,0
383,3396,Bajare Sitaram Namdeo (Baba),SHIRUR,Bahujan Mukti Party,0,Graduate,13978791,0,13978791
384,816,Balabhadra Majhi,NABARANGPUR,BJD,0,Graduate,52977088,705404,52271684
385,3550,Balaji Dnyanoba Kamble,LATUR,SP,0,Post Graduate,2860000,0,2860000
386,1152,Balaram Hota,KALAHANDI,CPI(ML)L,0,Others,1150,0,1150
387,3681,Balasaheb Dashrath Bagul,SHIRDI,IND,0,Literate,483000,0,483000
388,1377,Balasaheb Shankar Darade,BULDHANA,IND,0,Post Graduate,2334214,331493,2002721
389,3916,Balbhadra Mishra,BHOPAL,Bhartiya Jan Yug Party,0,8th Pass,1802210,350000,1452210
390,2145,Balbheem,BIDAR,IND,0,Graduate,415000,0,415000
391,1044,Balbir Singh Saini,KURUKSHETRA,INLD,0,Graduate,42261869,4284205,37977664
392,2392,Baldar,JHALAWAR-BARAN,IND,0,8th Pass,2935000,150000,2785000
393,4001,Baldeo Ganjhu,HAZARIBAGH,IND,2,10th Pass,450746,0,450746
394,366,Baleshwar Bharti,SASARAM,BSP,0,10th Pass,273200,0,273200
395,3580,Baliram Sukhdev More,MADHA,IND,0,Others,1202111,375345,826766
396,2019,Baljeet,HISAR,IND,0,Graduate,410700,0,410700
397,3025,Balkrishna Salgaonkar,SOUTH GOA,IND,0,Illiterate,311650,0,311650
398,2291,Balraj Bawari,GANGANAGAR,IND,0,10th Pass,573000,0,573000
399,972,Balram Bari,CHANDNI CHOWK,IND,0,8th Pass,2980000,0,2980000
400,4021,Balram Kumar Bedia,RANCHI,IND,0,12th Pass,5287989,125000,5162989
401,2020,Balwan Singh,HISAR,IND,0,12th Pass,3560500,300000,3260500
402,1234,Balwant Kumar,CHATRA,Jharkhand Party,1,Graduate,9514000,0,9514000
403,1998,Balwant Singh,SIRSA,Bharatiya Sant Mat Party,0,10th Pass,1053000,0,1053000
404,2292,Balwant Singh Hariyala,GANGANAGAR,Bharatiya Sant Mat Party,0,10th Pass,1053000,0,1053000
405,2961,Balwant Singh Kushwah Advocate,GWALIOR,SP,0,Graduate Professional,3200000,80000,3120000
406,417,Balwinder Kaur,KURUKSHETRA,AAP,0,10th Pass,17852106,1196325,16655781
407,1178,Banamali Majhi,KORAPUT,Ambedkarite Party of India,0,Post Graduate,48000,0,48000
408,2135,Bandeppa,BIDAR,JD(S),0,Graduate Professional,73218291,3333600,69884691
409,3659,Bandgar Nanaso Balaso,SANGLI,BSP,0,8th Pass,2743505,14000,2729505
410,2879,Bandhu Tirkey,RANCHI,AITC,7,Graduate,1832121,1261689,570432
411,1767,Bangshi Badan Barman,COOCHBEHAR,IND,5,Graduate,7528892,0,7528892
412,2537,Banjare Babulal Sundarlal,NAGPUR,IND,0,10th Pass,51017,0,51017
413,3817,Bannur Kumar,MYSORE,IND,0,Graduate,7250000,0,7250000
414,3899,Bansi Lal,UDHAMPUR,IND,0,8th Pass,6730000,200000,6530000
415,3632,Bansode Chayya Tukaram,PUNE,IND,0,8th Pass,309000,0,309000
416,3547,Bansode Dattatray Gunderao,LATUR,INC,0,Post Graduate,4006396,787720,3218676
417,3564,Bansode Kundan Fulchand,MADHA,BSP,0,5th Pass,410000,30000,380000
418,1462,Bante Jitendra Ramaji,BHANDARA-GONDIYA,IND,0,12th Pass,510000,0,510000
419,475,Banwari Saw,CHATRA,CPI,0,Literate,5765202,553000,5212202
420,3356,Barne Shrirang Chandu,MAVAL,SHS,2,8th Pass,665047926,11799786,653248140
421,3359,Barne Shrirang Chimaji,MAVAL,JD(U),0,Literate,953049,0,953049
422,2870,Basant Kumar Longa,KHUNTI,JVM,0,Graduate,5442300,0,5442300
423,497,Basant Panwar,NORTH WEST DELHI,BSP,0,8th Pass,2162778,27500,2135278
424,1165,Basanta Kumar Pradhan,KANDHAMAL,IND,0,12th Pass,150000,0,150000
425,1821,Basappa Kallappa Hanchanal,CHIKKODI,IND,0,12th Pass,15991000,270000,15721000
426,2179,Basavanteppa Honnappa Hullatti,HAVERI,Sarva Janata Party,0,Graduate Professional,0,0,0
427,1185,Basavaraj,KOPPAL,INC,0,10th Pass,38334476,2144769,36189707
428,1080,Basavaraj K.J,DAVANAGERE,AAP,0,Graduate,974000,30000,944000
429,2524,Basavegowda,BANGALORE RURAL,RPI(A),0,Graduate,447000,74000,373000
430,2529,Bashir Khan Ramzan Khan,NAGPUR,Minorities Democratic Party,0,Graduate,7839000,52000,7787000
431,800,Basil Ekka,SUNDARGARH,AAP,0,10th Pass,333388,1000000,0
432,3389,Basu Mog,TRIPURA EAST,IND,0,10th Pass,1911085,0,1911085
433,3219,Basudeb Naik,KEONJHAR,IND,2,10th Pass,27042432,2090125,24952307
434,3785,Beeda Srinivas N,KOLAR,IND,0,Literate,1356000,600000,756000
435,3127,Begum Noor Bano Urf Mehtab,MORADABAD,INC,0,10th Pass,78531612,0,78531612
436,2511,Benet Babu Benjamin,THIRUVANANTHAPURAM,IND,0,10th Pass,3503683,0,3503683
437,632,Bennet Abraham,THIRUVANANTHAPURAM,CPI,1,Post Graduate,34112353,0,34112353
438,2811,Bhagat Ram Soni,RAJNANDGAON,Chhattisgarh Swabhiman Manch,0,12th Pass,8742244,0,8742244
439,1553,Bhagawati Charan Pandey(Neelu),SIDHI,IND,0,Graduate,3425500,100000,3325500
440,2898,Bhagirath Prasad,BHIND,BJP,0,Doctorate,21240286,3687610,17552676
441,2352,Bhagirath Singh,SIKAR,Akhil Bharat Hindu Mahasabha,0,Post Graduate,258000,0,258000
442,2124,Bhagvantappa,RAICHUR,Lok Satta Party,0,Illiterate,609998,66000,543998
443,3019,Bhagwan Das,TIKAMGARH,IND,0,10th Pass,656000,0,656000
444,3140,Bhagwan Dass Rathor,NAGINA,Mahan Dal,0,Graduate Professional,9219083,0,9219083
445,1835,Bhagwan Kambale,BIJAPUR,RPI(A),0,5th Pass,906668,150000,756668
446,2141,Bhagwanth,BIDAR,BJP,0,Graduate Professional,56559290,16829000,39730290
447,3881,Bhagwat Harihar Taware,BEED,IND,0,Graduate,0,0,0
448,1793,Bhaichung Bhutia,DARJEELING,AITC,0,10th Pass,184406721,7746438,176660283
449,39,Bhairaw Dayal Singh,KARAKAT,IND,0,Post Graduate,16847000,0,16847000
450,814,Bhakta Charan Das,KALAHANDI,INC,1,Graduate Professional,11516583,3875982,7640601
451,3326,Bhambale Vijay Manikrao,PARBHANI,NCP,3,10th Pass,14944093,1895188,13048905
452,2335,Bhan Singh,JHUNJHUNU,Bharatiya Sant Mat Party,0,10th Pass,452500,0,452500
453,2441,Bhanji Bhai,BANSWARA,JD(U),0,8th Pass,15752404,250000,15502404
454,3809,Bhanuprakash.K.L,MANDYA,IND,0,Post Graduate,3828500,0,3828500
455,2300,Bhanwar Lal,BIKANER,BSP,0,10th Pass,3840000,980000,2860000
456,2440,Bhanwar Lal,CHITTORGARH,IND,0,10th Pass,1155000,0,1155000
457,2461,Bhanwar Lal Mali,RAJSAMAND,IND,0,8th Pass,2671280,171200,2500080
458,3420,Bhanwar Lal Soni,AJMER,IND,0,8th Pass,1650000,0,1650000
459,3433,Bhanwar Lal Waghela,JALORE,IND,0,12th Pass,233675,0,233675
460,3456,Bhanwar Singh Rathore,NAGAUR,AITC,0,Graduate,42000,0,42000
461,2289,Bhanwarlal Meghwal,GANGANAGAR,INC,0,Post Graduate,24098177,255803,23842374
462,3360,Bhapkar Maruti Sahebrao,MAVAL,AAP,18,12th Pass,14386607,195500,14191107
463,1187,Bharadhawaja,KOPPAL,CPI(ML)L,0,Others,430000,0,430000
464,2638,Bharat Bhushan Pandey,ARRAH,Akhil Bharatiya Jan Sangh,0,Doctorate,1757000,0,1757000
465,3560,Bharat Damodar Londhe,LATUR,IND,0,Graduate,279000,20000,259000
466,3551,Bharat Maroti Kadam,LATUR,Ambedkarite Party of India,0,10th Pass,6906,0,6906
467,2999,Bharat Sen Advocate,SAGAR,IND,0,Graduate Professional,205966,0,205966
468,3276,Bhartruhari Mahatab,CUTTACK,BJD,0,Post Graduate,88834098,0,88834098
469,3714,Bhaskar Chandra Mohanty,PURI,BSP,0,Graduate Professional,8215000,0,8215000
470,2809,Bhaskar Dwivedi,RAJNANDGAON,AAP,0,Post Graduate,12708752,4814872,7893880
471,320,Bhaskar Marotrao Neware,WARDHA,IND,0,Post Graduate,132798,0,132798
472,717,Bhaskaran K V,ERNAKULAM,IND,1,Graduate,4640900,350000,4290900
473,3403,Bhausaheb Rajaram Wakchaure,SHIRDI,INC,1,Doctorate,73540816,9030001,64510815
474,316,Bhavna Bhavesh Wasnik,AMRAVATI,AAP,0,Post Graduate,12289332,880320,11409012
475,2546,Bheemappa Dhoolappa Ajjodi,BAGALKOT,IND,0,Post Graduate,192646,31200,161446
476,1067,Bhimaraya,RAICHUR,AAP,0,10th Pass,2885000,65000,2820000
477,3366,Bhimrao Anna Kadale,MAVAL,IND,0,10th Pass,1770000,0,1770000
478,3701,Bhise Krishna Nagnath,SOLAPUR,IND,0,10th Pass,511665,0,511665
479,3465,Bhojraj,PALI,BSP,0,Others,18480000,0,18480000
480,2710,Bhola Sao,NALANDA,Krantikari Vikas Dal,0,Literate,140000,0,140000
481,3592,Bhosale Revan Vishwanath,OSMANABAD,JD(S),0,Post Graduate,11357709,1688121,9669588
482,3728,Bhovi Rama C.B.K,BANGALORE CENTRAL,IND,0,8th Pass,101000,0,101000
483,2496,Bhriguram Reang,TRIPURA EAST,AITC,0,12th Pass,1132884,31473,1101411
484,2334,Bhudar Mal,JHUNJHUNU,AITC,0,Post Graduate,12290000,100000,12190000
485,2834,Bhuneshwar Prasad Mehta,HAZARIBAGH,CPI,1,12th Pass,10483915,0,10483915
486,385,Bhuneswar Das,GAYA,Rashtriya Ahinsa Manch,0,Literate,1829000,0,1829000
487,1312,Bhup Singh,NORTH WEST DELHI,IND,0,Graduate Professional,61711,0,61711
488,136,Bhupen Kumar Borah,TEZPUR,INC,0,Post Graduate,26084515,3350225,22734290
489,2051,Bhupeshwar Dayal,SONIPAT,IND,0,Graduate Professional,3058174,0,3058174
490,196,Bhupinder Kumar,AMBALA,IND,0,10th Pass,120000,0,120000
491,1021,Bhura Ram,AMBALA,IND,0,Not Given,26119165,0,26119165
492,3314,Bibhu Prasad Tarai,JAGATSINGHPUR,INC,0,Post Graduate,5756318,799000,4957318
493,3241,Bichitra Nanda Das,BALASORE,BSP,1,Post Graduate,5325200,0,5325200
494,3665,Bichukale Abhijit Vamanrao,SATARA,IND,0,Graduate,60397,0,60397
495,3784,Bidaragaddi V.B,HAVERI,IND,0,Graduate,22810000,1150000,21660000
496,2824,Bideshi Mahto,GIRIDIH,Jharkhand Disom Party,0,Graduate,6928610,0,6928610
497,836,Bidhan Chandra Panda,BERHAMPUR,Samata Kranti Dal,0,10th Pass,3551085,950000,2601085
498,809,Bighna Raj Panda,KALAHANDI,Samruddha Odisha,1,12th Pass,764550,58637,705913
499,3349,Bijay Mohanty,BHUBANESWAR,INC,0,Others,17367991,0,17367991
500,828,Bijaya Kumar Mahapatro,ASKA,BSP,0,10th Pass,50000,0,50000
501,2050,Bijender Kumar,SONIPAT,IND,0,10th Pass,1650000,0,1650000
502,680,Bijendra Singh,ALIGARH,INC,2,Graduate,12292000,2201014,10090986
503,1785,Bijoy Chandra Barman,JALPAIGURI,AITC,0,Post Graduate,9396430,797019,8599411
504,527,Bijoy Kr. Tiru,KALIABOR,AIUDF,0,Graduate,5238298,0,5238298
505,139,Bijoy Krishna Handique,JORHAT,INC,0,Post Graduate,43378685,0,43378685
506,2263,Bijoy Krishna Nath,SILCHAR,AGP,0,Graduate,11038641,0,11038641
507,1945,Biju Joseph,IDUKKI,IND,0,10th Pass,1867208,0,1867208
508,3281,Bikash Das,CUTTACK,AAP,0,Doctorate,19920752,4700000,15220752
509,1163,Bilasini Nayak,KANDHAMAL,Aama Odisha Party,0,10th Pass,691500,0,691500
510,312,Bilkan Bara,ALIPURDUARS,Samajwadi Jan Parishad,0,Graduate Professional,9069500,62000,9007500
511,3275,Binapani Das,CUTTACK,SUCI(C),0,12th Pass,127124,0,127124
512,161,Binay Debbarma,TRIPURA WEST,Indigenous Peoples Front of Tripura,1,Graduate Professional,520000,0,520000
513,1881,Bindu M.K.,PONNANI,IND,0,8th Pass,318706,33000,285706
514,42,Binod Gogoi,KALIABOR,IND,0,Graduate,3600000,0,3600000
515,624,Binod Kumar Das,JAMUI,AAP,1,12th Pass,252600,0,252600
516,980,Bir Singh Soni,CHANDNI CHOWK,IND,0,12th Pass,1030100,0,1030100
517,2271,Biren Singh Engti,AUTONOMOUS DISTRICT,INC,0,Post Graduate,35367390,0,35367390
518,1777,Birendra Bara (Oraon),ALIPURDUARS,BJP,0,Graduate,115340,0,115340
519,484,Birendra Bhagat,LOHARDAGA,JVM,0,10th Pass,2911000,0,2911000
520,4022,Birendra Kumar Jaiswal,RANCHI,IND,0,10th Pass,10201398,1698482,8502916
521,127,Birendra Singh,SATNA,IND,0,12th Pass,2451500,100000,2351500
522,3644,Birje Yashwant Anant,RATNAGIRI SINDHUDURG,Bahujan Mukti Party,0,Post Graduate,3278000,0,3278000
523,4009,Bisheshwar Mahto,RANCHI,Samata Party,0,10th Pass,9999500,300000,9699500
524,585,Bishnu Pada Ray,ANDAMAN & NICOBAR ISLANDS,BJP,1,Graduate,5658980,175115,5483865
525,3288,Bishnu Prasad Das,KENDRAPARA,BJP,0,Graduate,1837410,0,1837410
526,3223,Bishnupriya Naik,KEONJHAR,Odisha Jan Morcha,0,10th Pass,245000,0,245000
527,3708,"Bismaya Mahapatra,",BHUBANESWAR,AAP,0,Post Graduate,15156959,3824000,11332959
528,1332,Biswajit Ranjit Chatterjee,NEW DELHI,AITC,0,12th Pass,33350000,0,33350000
529,3244,Biswajit Ray,BALASORE,IND,0,Graduate,71000,0,71000
530,3320,Bochare Shankar Mahadji,NANDED,IND,0,10th Pass,7978374,761000,7217374
531,761,Bodhsingh Bhagat,BALAGHAT,BJP,0,Graduate,24959436,1393732,23565704
532,3847,Bojanna N Somaiah,MYSORE,IND,0,Graduate Professional,2835000,500000,2335000
533,2538,Borkar Ravindra,NAGPUR,IND,0,10th Pass,300000,0,300000
534,157,Brahmadav Anand Paswan,JAMUI,BSP,0,12th Pass,9493973,175000,9318973
535,1552,Brahmanand Pratap Singh,SIDHI,IND,0,Graduate,0,0,0
536,2569,Brahmananda Reddy,TUMKUR,IND,7,Graduate Professional,261074,126000,135074
537,3925,Brajendra Gappu Chaturvedi,BHOPAL,IND,0,Post Graduate,890000,0,890000
538,3034,Brajlal,AMROHA,Bahujan Mukti Party,0,Post Graduate,6502000,0,6502000
539,2977,Brindawan Singh Sikarwar,MORENA,BSP,1,12th Pass,18606750,0,18606750
540,1537,Brmhadatta Mishra Urf Chote,REWA,IND,0,12th Pass,2283500,0,2283500
541,2865,Buday Munda,KHUNTI,Akhil Bhartiya Jharkhand Party,0,12th Pass,1669500,50000,1619500
542,401,Budayya Pujeri,BANGALORE CENTRAL,Karunaadu Party,0,Graduate,1966100,0,1966100
543,2891,Budhram Laguri,SINGHBHUM,Bahujan Mukti Party,0,12th Pass,1639671,43898,1595773
544,3165,Budhsen Verma,PILIBHIT,SP,0,8th Pass,36598361,4550000,32048361
545,328,C B Chandrababu,ALAPPUZHA,CPI(M),10,Graduate Professional,1466177,360075,1106102
546,904,C G Saji Kumar,ANDAMAN & NICOBAR ISLANDS,IND,0,12th Pass,50000,0,50000
547,2231,C J Jagannath,UDUPI CHIKMAGALUR,CPI(ML) Red star,0,5th Pass,111000,0,111000
548,2555,C Mohan Kumar,MYSORE,BSP,0,10th Pass,5250000,0,5250000
549,297,C N Jayadevan,THRISSUR,CPI,3,Post Graduate,20041642,294000,19747642
550,3452,C R Choudhary,NAGAUR,BJP,0,Post Graduate,17921949,0,17921949
551,1042,C. L. Ruala,MIZORAM,INC,0,Graduate,25733421,0,25733421
552,1201,C.H. Vijayashankar,HASSAN,BJP,0,Graduate,42165344,5100000,37065344
553,1897,C.K. Ramakrishnan,PALAKKAD,IND,0,Not Given,729614,380200,349414
554,2952,C.L. Karodiya,GWALIOR,Jan-Nyay Dal,0,Graduate,806184,0,806184
555,2632,C.Narayana Swamy,BANGALORE NORTH,INC,0,Post Graduate,247952597,922460,247030137
556,1088,C.S.Puttaraju,MANDYA,JD(S),0,12th Pass,45209196,11231000,33978196
557,3060,Captain Phool Chandra Sharma,AONLA,Jawan Kisan Morcha,0,Graduate,1010000,0,1010000
558,2948,Captan Babulal Goswami,GWALIOR,IND,0,Graduate,4300000,0,4300000
559,2198,Chalawadi Ashok Sahadevappa,UTTARA KANNADA,IND,0,Graduate,1780000,1505000,275000
560,2796,Champa Lal Patel,MAHASAMUND,IND,0,Graduate,1860000,0,1860000
561,480,Chamra Linda,LOHARDAGA,AITC,2,Graduate,7010805,1550000,5460805
562,2534,Chanda Manwatkar,NAGPUR,IND,0,12th Pass,0,0,0
563,4071,Chandoo Lal Sahu S/O Avadh Ram Sahu,MAHASAMUND,IND,0,8th Pass,4000,0,4000
564,2763,Chandra Bhushan Prasad Chandravnsi,PATNA SAHIB,Bahujan Mukti Party,1,Literate,29711938,50200,29661738
565,2759,Chandra Dev Prasad,PATALIPUTRA,Bahujan Mukti Party,0,Post Graduate,479600,0,479600
566,2436,Chandra Prakash,CHITTORGARH,BJP,0,Graduate,14134693,687284,13447409
567,2425,Chandra Prakash Gocher,BHILWARA,Bharatiya Yuva Shakti,0,12th Pass,7612000,60000,7552000
568,834,Chandra Sekhar Sahu,BERHAMPUR,INC,0,Graduate Professional,22114000,642430,21471570
569,2397,Chandra Singh,JHALAWAR-BARAN,BSP,0,8th Pass,225000,0,225000
570,1957,Chandrababu,ALAPPUZHA,IND,0,10th Pass,0,0,0
571,767,Chandrabhan Singh Choudhary,CHHINDWARA,BJP,0,Graduate Professional,88884662,2258313,86626349
572,2685,Chandrabhushan Sharma,JAHANABAD,AAP,0,Doctorate,7877980,0,7877980
573,1231,Chandradev Thakur,CHATRA,Socialist Party (India),0,8th Pass,1683317,0,1683317
574,817,Chandradhwaja Majhi,NABARANGPUR,IND,0,Graduate,2028926,0,2028926
575,2139,Chandrakant,BIDAR,AAP,0,Post Graduate,5000070,417370,4582700
576,3663,Chandrakant Tatu Khandait,SATARA,Bharipa Bahujan Mahasangh,0,Graduate,223500,100000,123500
577,2934,Chandrapal Singh Tomar,GUNA,IND,0,Post Graduate,6730000,200000,6530000
578,2550,Chandrashekaraiah,MYSORE,JD(S),0,Post Graduate,28573891,0,28573891
579,3440,Chandresh Kumari,JODHPUR,INC,0,12th Pass,307822286,4101175,303721111
580,110,Chandu Lal Sahu (Chandu Bhaiya) S/O Late Puneen Ram,MAHASAMUND,BJP,0,Graduate Professional,20879652,2700000,18179652
581,3909,Chandu Lal Sahu S/O Balchand Sahu,MAHASAMUND,IND,0,10th Pass,209000,0,209000
582,4070,Chandu Lal Sahu S/O Biju Ram Sahu,MAHASAMUND,IND,0,5th Pass,6000,0,6000
583,4067,Chandu Lal Sahu S/O Late Nathu Ram,MAHASAMUND,IND,0,5th Pass,254500,150000,104500
584,4069,Chandu Lal Sahu S/O Parmanand Sahu,MAHASAMUND,IND,0,Literate,2574000,0,2574000
585,4068,Chandu Lal Sahu S/O Same Lal Sahu,MAHASAMUND,IND,0,8th Pass,1114000,0,1114000
586,4066,Chandu Lal Sahu S/O Soju Lal Sahu,MAHASAMUND,IND,0,8th Pass,1307000,0,1307000
587,4074,Chandu Ram Sahu S/O Nakul Sahu,MAHASAMUND,IND,0,5th Pass,12000,0,12000
588,4072,Chandu Ram Sahu S/O Pilau Ram Sahu,MAHASAMUND,IND,0,8th Pass,648000,0,648000
589,4073,Chanduram Sahu S/O Ram Karosa Sahu,MAHASAMUND,IND,0,Literate,12000,0,12000
590,1301,Charan Jeet Singh,WEST DELHI,AIFB,0,Post Graduate,709000,0,709000
591,1056,Charanjeet Singh,SIRSA,INLD,0,10th Pass,8146887,3260000,4886887
592,920,Chatap Wamanrao Sadashiv,CHANDRAPUR,AAP,3,Graduate Professional,29375000,1300000,28075000
593,1626,Chater Singh Kashyap,MUZAFFARNAGAR,Vanchit Jamat Party,0,10th Pass,12559000,0,12559000
594,198,Chattar Singh,KURUKSHETRA,BSP,0,Graduate Professional,72970569,3500000,69470569
595,3018,Chaturbhuj Snehi,TIKAMGARH,IND,0,12th Pass,0,0,0
596,3384,Chaudhari Kalu Vinayak,BARAMATI,BSP,0,8th Pass,65000,0,65000
597,2092,Chaudhary Daya Chand,FARIDABAD,Bhartiya Shakti Chetna Party,0,Graduate,10745000,0,10745000
598,2598,Chavan Vinod Narayan,YAVATMAL-WASHIM,IND,0,10th Pass,3361500,570000,2791500
599,943,Chaware Maya Namdeo,RAMTEK,SP,7,Post Graduate,13746000,1220000,12526000
600,331,Chengara Surendran,MAVELIKKARA,CPI,1,Graduate,3363470,794051,2569419
601,241,Cheni Ram Moran,DIBRUGARH,AIFB,0,10th Pass,824337,0,824337
602,321,Chetan Bhimraj Pendam,WARDHA,BSP,1,Post Graduate,13251784,0,13251784
603,3207,Chetram,SHAHJAHANPUR,INC,0,Graduate Professional,13768803,0,13768803
604,3233,Chhabi Mahali,MAYURBHANJ,AAP,0,Others,75674,0,75674
605,1153,Chhabilal Nial,KALAHANDI,Ambedkarite Party of India,0,Graduate Professional,580758,0,580758
606,3426,Chhaganaram / Bhalaram,JALORE,Bahujan Mukti Party,0,8th Pass,118668,0,118668
607,3425,Chhaganaram / Prhalad,JALORE,Hindustan Janta Party,0,Literate,1652000,4000,1648000
608,2986,Chhavendra,MORENA,IND,0,Literate,785508,0,785508
609,145,Chhedi Paswan,SASARAM,BJP,0,Post Graduate,35776803,275000,35501803
610,3459,Chhoturam,NAGAUR,IND,0,10th Pass,837000,275000,562000
611,913,Chinchole Gangaram Kaluji,BULDHANA,IND,0,12th Pass,21065000,117000,20948000
612,2570,Chinnappa.V,TUMKUR,CPI,0,Graduate,201696,21412,180284
613,843,Chinnayyanaik,RAICHUR,IND,0,12th Pass,1658400,0,1658400
614,4019,Chintamani Mahto,RANCHI,IND,1,12th Pass,7763850,26150,7737700
615,158,Chirag Kumar Paswan,JAMUI,LJP,0,12th Pass,10414470,4458954,5955516
616,3766,Chitra Prasad,CHIKKBALLAPUR,BSP,0,Post Graduate,4740600,1800000,2940600
617,2886,Chitrasen Sinku,SINGHBHUM,INC,0,12th Pass,8992000,1100000,7892000
618,2063,Chitter Singh Bali,BHIWANI-MAHENDRAGARH,IND,0,10th Pass,2196500,650000,1546500
619,710,Chittoor Rajamannar,IDUKKI,IND,0,Post Graduate,60222146,1365374,58856772
620,1129,Chole Omprakash Bakaram,BHANDARA-GONDIYA,IND,0,Graduate Professional,1007000,800000,207000
621,2274,Chomang Kro,AUTONOMOUS DISTRICT,IND,0,Graduate,4122196,0,4122196
622,3657,Chopade Shriprasad Janardan,SANGLI,IND,0,12th Pass,334194,0,334194
623,3759,Chowdahalli Javaraiah,CHAMARAJANAGAR,CPI(ML)L,0,Graduate Professional,393000,0,393000
624,302,Christy Fernandez,ERNAKULAM,IND,0,Doctorate,27176949,2620749,24556200
625,195,Chungkhokai Doungel,OUTER MANIPUR,NCP,0,Graduate,6685000,0,6685000
626,197,Chuni Manoj Kumar,KURUKSHETRA,IND,0,5th Pass,1593000,0,1593000
627,1991,Churchill Alemao,SOUTH GOA,AITC,3,Others,149868252,72589679,77278573
628,1854,Cleatus,WAYANAD,IND,2,8th Pass,6905000,0,6905000
629,3026,Cliffton De Souza,SOUTH GOA,Bahujan Mukti Party,0,10th Pass,152500,0,152500
630,3381,Col Suresh Patil (Rtd),PUNE,Bahujan Mukti Party,0,12th Pass,1034609,0,1034609
631,2472,Col. Sona Ram,BARMER,BJP,1,Graduate Professional,174678454,5584331,169094123
632,3627,Colonel Jayantrao Chitale,PUNE,IND,0,Graduate Professional,1014500,0,1014500
633,940,Com. Bandu Ramchandra Meshram,RAMTEK,CPI(ML) Red star,0,12th Pass,285146,0,285146
634,912,Commander (Rtd) Ashok Raut,BULDHANA,IND,0,Graduate Professional,7250500,0,7250500
635,3327,Comrade Rajan Kshirsagar,PARBHANI,CPI,7,Graduate,4099277,700000,3399277
636,199,Comrade Ram Kumar,SIRSA,CPI(M),0,12th Pass,877705,0,877705
637,3344,Comred Bhise Ganpat Devrao,PARBHANI,IND,2,Graduate,757300,225000,532300
638,1739,Cp Verma,SAHARANPUR,IND,3,Literate,4750000,0,4750000
639,3816,D Eswar Thoremavu,MYSORE,IND,0,Graduate,500000,25000,475000
640,844,D H Pujar,KOPPAL,CPI(ML) Red star,4,5th Pass,2219600,350000,1869600
641,1283,D K Chopra,SOUTH DELHI,IND,1,Graduate,7080000,0,7080000
642,3769,D N Narasimhamurthy,CHIKKBALLAPUR,IND,0,10th Pass,290000,130000,160000
643,2176,D Prasad Sangappa,HAVERI,RPI(A),0,12th Pass,7850000,1080000,6770000
644,3814,D S Nirvanappa,MYSORE,CPI(ML) Red Star,0,5th Pass,629000,5000,624000
645,3510,D.B.Naik,HINGOLI,CPI(M),1,Graduate,4071000,470000,3601000
646,2122,D.B.Nayak,RAICHUR,JD(S),1,Graduate,10591888,0,10591888
647,2861,D.G.Raja,JAMSHEDPUR,SP,0,Graduate,1899744,265504,1634240
648,2633,D.Jayaram,BANGALORE NORTH,Gareeb Aadmi Party,0,12th Pass,40000,0,40000
649,2369,D.K. Chhangani,JAIPUR,CPI,0,Graduate,2605791,0,2605791
650,1090,D.K.Suresh,BANGALORE RURAL,INC,7,12th Pass,858713138,184854756,673858382
651,2619,D.M.Ambareesha,KOLAR,BSP,0,Post Graduate,145000,0,145000
652,1224,D.V. Sadananda Gowda,BANGALORE NORTH,BJP,0,Graduate Professional,98888874,37020152,61868722
653,2659,Dadan Yadav,BUXAR,BSP,22,10th Pass,26250000,103594500,0
654,731,Dadhibal,SATNA,Apna Dal,0,Post Graduate,2933600,0,2933600
655,3573,Dagadu Manik Pawar,MADHA,IND,0,5th Pass,1521697,0,1521697
656,915,Daharwal Ganeshdeo Raghuji,BHANDARA-GONDIYA,GGP,0,5th Pass,7113000,0,7113000
657,1154,Daitary Pradhan,KALAHANDI,Aama Odisha Party,2,Post Graduate,47792839,367818,47425021
658,447,Dalbir Singh Chahal,SONIPAT,Rashtravadi Janata Party,0,5th Pass,16475000,90000,16385000
659,1336,Dalchand,NEW DELHI,IND,0,8th Pass,2970854,300000,2670854
660,1773,Dalendra Nath Ray,COOCHBEHAR,Amra Bangalee,0,10th Pass,2358865,0,2358865
661,745,Dalpat Singh Paraste,SHAHDOL,BJP,0,Graduate Professional,5524870,0,5524870
662,3401,Damale Shivajirao Waman,AHMEDNAGAR,Bhartiya Navjawan Sena (Paksha),0,Graduate Professional,1721000,905302,815698
663,4002,Daman Chandra Bhakat,JAMSHEDPUR,BSP,0,10th Pass,38695000,40000,38655000
664,3628,Dambale Rahul Dharma,PUNE,IND,13,12th Pass,20000,0,20000
665,3688,Dambale Ram Dharma,SHIRUR,IND,0,10th Pass,1383000,105000,1278000
666,994,Dan Bahadur Yadav,NORTH EAST DELHI,IND,0,Graduate,1345000,0,1345000
667,1475,Dandekar Baburao Laxman,GADCHIROLI-CHIMUR,IND,0,12th Pass,580000,0,580000
668,2918,Daniel John,BHOPAL,IND,0,12th Pass,8081017,0,8081017
669,649,Daryl William Ch Momin,TURA,INC,0,Post Graduate,1250390,204472,1045918
670,696,Das K Varkala,ATTINGAL,IND,2,10th Pass,13633,39000,0
671,3231,Dashmat Soren,MAYURBHANJ,BSP,0,10th Pass,855000,0,855000
672,2885,Dashrath Gagrai,SINGHBHUM,JVM,3,Graduate,3940724,100000,3840724
673,1775,Dasrath Tirkey,ALIPURDUARS,AITC,0,Graduate,3550353,293909,3256444
674,1984,Dattaram Desai,NORTH GOA,AAP,0,Post Graduate,9795686,335819,9459867
675,3699,Dattatraya Vitthal Thorat,SOLAPUR,IND,0,8th Pass,227000,0,227000
676,404,David Horo,LAKHIMPUR,IND,0,10th Pass,94000,0,94000
677,1037,Davinder Kumar,KURUKSHETRA,IND,2,12th Pass,2275000,250000,2025000
678,1051,Davinder Singh,KARNAL,Rashtriya Karmyog Party,0,12th Pass,240000,0,240000
679,2869,Dayamani Barla,KHUNTI,AAP,5,Post Graduate,175500,0,175500
680,1981,Dayanand G. Narvekar,NORTH GOA,IND,2,Graduate Professional,184306689,62952534,121354155
681,1827,Dayanand Guruputrayya Chikkamath,BELGAUM,SP,0,Graduate,7050000,2000000,5050000
682,3232,Debashis Marndi,MAYURBHANJ,JMM,0,Doctorate,3993858,627225,3366633
683,3257,Debendra Kumar Mallik,JAJPUR,BSP,0,Graduate Professional,10000,0,10000
684,18,Deepak Gaur,FARIDABAD,Aarakshan Virodhi Party,0,12th Pass,1183000,325000,858000
685,467,Deepak Karma,BASTAR,INC,0,Graduate,3601587,0,3601587
686,1356,Deepak Kumar,EAST DELHI,IND,0,12th Pass,236200,0,236200
687,1304,Deepak Kumar,WEST DELHI,Rashtriya Janadhikar Party,0,8th Pass,21000,0,21000
688,2958,Deepak Kumar Bansal Rangwale (Prerak),GWALIOR,IND,0,Graduate,4059104,264727,3794377
689,3375,Deepak Natharam Paigude,PUNE,MNS,1,12th Pass,114428519,50291943,64136576
690,2609,Deepak Rajesh Coelho,DAKSHINA KANNADA,IND,0,Graduate,3328000,0,3328000
691,587,Deepak Shukla,CHANDIGARH,IND,0,Graduate,1874000,338837,1535163
692,1398,Deepaksingh Trymbakrao Deshmukh,WARDHA,IND,0,10th Pass,6900000,0,6900000
693,3402,Deepali Sayyad,AHMEDNAGAR,AAP,1,Graduate,30052370,3767489,26284881
694,1268,Deepender Singh,ROHTAK,INC,0,Post Graduate,358749354,39310300,319439054
695,774,Denis Siangshai,SHILLONG,IND,0,Graduate,1287025457,0,1287025457
696,1931,Densil Mendez,ERNAKULAM,JD(U),0,10th Pass,2634109,169614,2464495
697,736,Deoraj Singh Patel,REWA,BSP,0,Post Graduate,70149663,17924260,52225403
698,692,Deorao Monba Nannaware,GADCHIROLI-CHIMUR,Ambedkarite Party of India,0,Graduate Professional,4463077,922967,3540110
699,921,Deotale Sanjay Wamanrao,CHANDRAPUR,INC,0,Graduate Professional,45464118,3496308,41967810
700,3522,Deshmukh Balasaheb Desai,HINGOLI,IND,0,Not Given,680000,50000,630000
701,549,Deshmukh Jaideep Rajendra,WARDHA,IND,1,Post Graduate,2227258,0,2227258
702,3488,Deshmukh Vikas Nanasaheb,AHMEDNAGAR,IND,0,12th Pass,3796964,510000,3286964
703,2200,Deshpande Prashanth,UTTARA KANNADA,INC,0,Post Graduate,999522016,64619045,934902971
704,599,Dev Kumar Choudhary,GAYA,IND,0,Graduate Professional,5087170,800000,4287170
705,2747,Dev Kumar Verma,PATALIPUTRA,RPI(A),0,12th Pass,4333000,0,4333000
706,3908,Dev Prasad Kelkar,MAHASAMUND,IND,0,10th Pass,6915060,250000,6665060
707,2306,Devanand,ALIGARH,Lok Dal,0,Graduate,305016,0,305016
708,889,Devchand Dhruw,BASTAR,CPI(ML) Red star,0,8th Pass,371000,52235,318765
709,1107,Devender,KARNAL,RPI(A),0,12th Pass,625000,201000,424000
710,2920,Devendra Chaourasia,DAMOH,BSP,1,Graduate,8658000,340000,8318000
711,2978,Devendra Kumar Agrval,MORENA,AAP,0,Graduate Professional,6240542,490100,5750442
712,1604,Devendra Kumar Urf Gudda Bhaiyya,HOSHANGABAD,IND,0,10th Pass,95509,0,95509
713,3227,Devi Prasanna Besra,MAYURBHANJ,IND,0,Graduate,5178227,0,5178227
714,1329,Devi Singh,NEW DELHI,Rashtriya Jankranti Party,0,Post Graduate,285000,0,285000
715,500,Devinder Kumar Sehrawat,SOUTH DELHI,AAP,0,Post Graduate,23237892,540000,22697892
716,3521,Devji Gangaram Asole,HINGOLI,IND,0,Graduate Professional,195500,0,195500
717,3424,Devji Patel,JALORE,BJP,0,10th Pass,51846777,12780726,39066051
718,3574,Devkate Somanath Alias Someshwar Chandrakant,MADHA,IND,1,5th Pass,148500,0,148500
719,3468,Devkishan Dehiya,PALI,Megh Desham Party,0,10th Pass,443500,0,443500
720,3630,Devkule Bibhishan Jagannath,PUNE,IND,0,10th Pass,1195000,0,1195000
721,3523,Dhabe Uttam Maroti,HINGOLI,IND,0,Literate,1241000,0,1241000
722,3595,Dhale Padmasheel Ramchandra,OSMANABAD,BSP,3,Post Graduate,3372138,330000,3042138
723,23,Dhan Raj Chauhan,CHANDNI CHOWK,Naya Daur Party,0,8th Pass,370000,0,370000
724,831,Dhanada Kanta Mishra,BERHAMPUR,AAP,0,Doctorate,10787163,5662400,5124763
725,3532,Dhananjay Bhimrao Mahadik,KOLHAPUR,NCP,1,Graduate,448882000,71333000,377549000
726,389,Dhananjay Kishore,GAYA,AAP,0,Graduate Professional,6509560,6102,6503458
727,1130,Dhananjay Shamlalji Rajabhoj,BHANDARA-GONDIYA,IND,0,Post Graduate,3070000,0,3070000
728,3733,Dhananjaya. H.H,BANGALORE CENTRAL,IND,1,12th Pass,809580000,460000,809120000
729,295,Dhanapalan,THRISSUR,INC,1,Graduate,12435866,2269212,10166654
730,1598,Dhaniram Yaduwanshi,CHHINDWARA,IND,0,12th Pass,504199,148810,355389
731,3441,Dhanraj Gehlot,JODHPUR,Jai Maha Bharath Party,0,Graduate,3506231,300000,3206231
732,2780,Dharam Pal Balgotra,UDHAMPUR,BSP,0,Others,16995852,1158038,15837814
733,865,Dharambir,BHIWANI-MAHENDRAGARH,BJP,0,Graduate,50057200,4530000,45527200
734,2064,Dharambir S/O Banwari,BHIWANI-MAHENDRAGARH,IND,0,Illiterate,2715000,0,2715000
735,2066,Dharambir Singh,BHIWANI-MAHENDRAGARH,IND,0,Post Graduate,1424342,0,1424342
736,458,Dharampal,GURGAON,BSP,0,12th Pass,16990111,0,16990111
737,1030,Dharampal Dhiman,KURUKSHETRA,IND,0,10th Pass,765000,0,765000
738,462,Dharampal Yadav,GURGAON,INC,0,Graduate,76792493,0,76792493
739,1315,Dharamraj,NORTH WEST DELHI,Bhartiya Pragatisheel Congress,0,8th Pass,3486700,0,3486700
740,997,Dharamveer Singh,NORTH EAST DELHI,Rashtriya Ekta Party,1,10th Pass,6497000,0,6497000
741,3290,Dharanidhar Nayak,KENDRAPARA,INC,0,Post Graduate,35040745,11869710,23171035
742,2065,Dharm Bir S/O Hari Singh,BHIWANI-MAHENDRAGARH,IND,0,10th Pass,51000,48000,3000
743,3066,Dharmandra Yadav,BADAUN,SP,0,Post Graduate,24987715,8950291,16037424
744,1704,Dharmender,GAUTAM BUDHHA NAGAR,Dharam Nirpeksh Dal,0,8th Pass,55813000,0,55813000
745,588,Dharmender Singh,CHANDIGARH,Hindustan Ekta Party,0,Graduate,1623000,70000,1553000
746,3051,Dharmendra Kumar,AONLA,BJP,0,10th Pass,5364652,0,5364652
747,1449,Dharmendra Wasudeorao Mandlik,NAGPUR,Hindustan Janta Party,0,Post Graduate,23900,0,23900
748,3848,Dhas Suresh Ramchandra,BEED,NCP,2,Graduate,74408903,10490592,63918311
749,3861,Dhatture Hafizbhai Husain,SANGLI,IND,0,8th Pass,7288408,2035500,5252908
750,243,Dhebor Gohain Boruah,LAKHIMPUR,AITC,0,Graduate Professional,7878597,0,7878597
751,1327,Dheeraj Puri,NEW DELHI,SHS,0,10th Pass,27148834,0,27148834
752,1426,Dhimati Vidya Kishor Bhimte,RAMTEK,Ambedkarite Party of India,0,Post Graduate,3902394,69000,3833394
753,2362,Dhiraj Gurjar,JAIPUR RURAL,SP,0,Post Graduate,413290807,500000,412790807
754,2535,Dhiraj Jaidev Gajbhiye,NAGPUR,IND,0,12th Pass,0,0,0
755,2726,Dhirendra Kumar,NALANDA,Janvadi Party(Socialist),0,10th Pass,250000,0,250000
756,1784,Dhirendra Nath Roy,JALPAIGURI,Amra Bangalee,0,Graduate,1360000,0,1360000
757,950,Dhote Jambuwantrao Bapurao,YAVATMAL-WASHIM,AIFB,0,10th Pass,6545000,0,6545000
758,543,Dhotre Sanjay Shyamrao,AKOLA,BJP,3,Graduate Professional,48501735,6928458,41573277
759,1782,Dhritiman Roy,JALPAIGURI,Rashtriya Janadhikar Suraksha Party,0,8th Pass,182500,0,182500
760,1064,Dhulappa Gundappa,GULBARGA,JD(S),0,Graduate Professional,7335800,0,7335800
761,3502,Digambar Alias Gabbar Sudam Sakat,HATKANANGLE,Bharipa Bahujan Mahasangh,0,5th Pass,547074,0,547074
762,1564,Digvijay Singh,JABALPUR,Bhartiya Shakti Chetna Party,0,Post Graduate,67620000,0,67620000
763,982,Dildar Hussain Beg,CHANDNI CHOWK,IND,0,12th Pass,946408,0,946408
764,2829,Dileep Kumar Rajak,GIRIDIH,IND,0,Graduate,439561,46500,393061
765,1455,Dilip Narayan,NAGPUR,IND,0,Others,607658,0,607658
766,625,Dilip Paswan,JAMUI,IND,0,10th Pass,1531232,0,1531232
767,3298,Dilip Sarkar,JALPAIGURI,Bahujan Mukti Party,0,Graduate,1011000,0,1011000
768,801,Dillip Kumar Tirkey,SUNDARGARH,BJD,0,Graduate,70158593,831924,69326669
769,111,Dinesh Kashyap,BASTAR,BJP,1,Post Graduate,16108199,2191216,13916983
770,3111,Dinesh Kumar,KHERI,Bahujan Mukti Party,0,10th Pass,180872,0,180872
771,556,Dinesh Kumar,KARAKAT,Bahujan Mukti Party,1,Doctorate,478500,0,478500
772,1298,Dinesh Kumar,WEST DELHI,Akhand Bharat Samaj Party,0,10th Pass,7386000,252000,7134000
773,2854,Dinesh Mahato,JAMSHEDPUR,IND,0,12th Pass,5169920,0,5169920
774,3474,Dinesh Mev,PALI,IND,0,5th Pass,1387500,0,1387500
775,27,Dinesh Pal Singh,NORTH EAST DELHI,IND,0,8th Pass,6931000,0,6931000
776,3629,Dinesh Pandurang Pawar,PUNE,IND,0,10th Pass,113500,0,113500
777,311,Dipak Kumar Roy,COOCHBEHAR,AIFB,1,Post Graduate,2859128,195000,2664128
778,3549,Dipratna Prabhakarrao Nilangekar,LATUR,AAP,0,Post Graduate,2025000,26672,1998328
779,2922,Divan Upendr Pratap Singh (Raja Sab),DAMOH,Bhartiya Shakti Chetna Party,0,12th Pass,8328072,312910,8015162
780,2565,Divya Spandana Uruf Ramya,MANDYA,INC,0,12th Pass,28043931,5530653,22513278
781,1008,Diwakar,KAIRANA,AITC,0,12th Pass,155543,0,155543
782,1474,Diwakar Pendam,GADCHIROLI-CHIMUR,Bahujan Mukti Party,0,8th Pass,3850000,0,3850000
783,2158,Doddamani Prasad,BELLARY,CPI(ML)L,1,Graduate Professional,16043,0,16043
784,3852,Dongare Milind Kashinath,BEED,Prabuddha Republican Party,1,Graduate Professional,30393000,300000,30093000
785,1435,Dongre Ashok Namaji,RAMTEK,IND,0,5th Pass,980000,0,980000
786,546,Dongre Priya Anil,AMRAVATI,IND,0,8th Pass,702059,0,702059
787,827,Dr Bansidhar Tripathy,ASKA,AITC,0,Doctorate,1991383,0,1991383
788,2980,Dr Govind Singh,MORENA,INC,1,Graduate Professional,69688035,3184026,66504009
789,3453,Dr Jyoti Mirdha,NAGAUR,INC,0,Graduate Professional,582676804,230942000,351734804
790,3350,Dr Kulamani Nayak,BHUBANESWAR,"Proutist Bloc, India",0,Doctorate,2024713,0,2024713
791,841,Dr Rajesh Alias Ravi Vallyapur,BIJAPUR,IND,0,Graduate Professional,12208000,0,12208000
792,2329,Dr Rajkumar Sharma,JHUNJHUNU,IND,4,Doctorate,4537299,0,4537299
793,3119,Dr S T Hasan,MORADABAD,SP,0,Post Graduate,31217401,175000,31042401
794,3188,Dr Safiq Ur Rahman Barq,SAMBHAL,SP,0,Graduate,12883691,0,12883691
795,121,Dr Shankar Bidari,BAGALKOT,IND,0,Graduate,55962000,0,55962000
796,526,Dr. Arun Kr. Sarmah,KALIABOR,AGP,0,Doctorate,19515691,4850186,14665505
797,2671,Dr. Arun Kumar,JAHANABAD,Rashtriya Lok Samta Party,1,Doctorate,38846631,1000000,37846631
798,681,Dr. Arvind Kumar Singh,ALIGARH,BSP,0,Doctorate,41664986,6100000,35564986
799,2708,Dr. Ashok Kumar Singh,MUNGER,SHS,0,Doctorate,2054194,0,2054194
800,2287,Dr. Balkrishan Bawari,GANGANAGAR,AAP,0,Graduate Professional,3855000,1090000,2765000
801,192,Dr. Banuprakash.K,HASSAN,IND,1,Graduate Professional,244250,200000,44250
802,1214,Dr. Bhola Singh,BULANDSHAHR,BJP,0,Graduate,12577537,0,12577537
803,1102,Dr. C Mohan,KOLAR,IND,0,Graduate Professional,11910000,0,11910000
804,2365,Dr. C.P. Joshi,JAIPUR RURAL,INC,0,Doctorate,54972948,1400000,53572948
805,2567,Dr. C.S.Hanumanthappa,MANDYA,AAP,0,Post Graduate,6965000,0,6965000
806,1569,Dr. Dhai Akshar (Rakesh Sonkar),JABALPUR,IND,0,Graduate,620000,95000,525000
807,3999,Dr. Dhirendra Kumar Raj,HAZARIBAGH,IND,0,Graduate Professional,43518730,0,43518730
808,928,Dr. Gajbe Rameshkumar Baburaoji,GADCHIROLI-CHIMUR,AAP,0,Post Graduate,9315000,69000,9246000
809,2429,Dr. Girija Vyas,CHITTORGARH,INC,1,Doctorate,23585480,0,23585480
810,3483,Dr. Gurumayum Tonsana Sharma,INNER MANIPUR,Manipur Democratic Peoples Front,0,Doctorate,7135000,0,7135000
811,65,Dr. Harsh Vardhan,CHANDNI CHOWK,BJP,2,Post Graduate,28229308,1780492,26448816
812,668,Dr. Himanshu Singh,MEERUT,AAP,3,Graduate Professional,9408585,0,9408585
813,3481,Dr. Ibomcha Singh,INNER MANIPUR,AAP,0,Graduate Professional,497250,0,497250
814,2778,Dr. Jitendra Singh,UDHAMPUR,BJP,0,Graduate Professional,38464932,11881,38453051
815,3027,Dr. Kapin Ch. Boro,ALIPURDUARS,IND,0,Graduate,6782287,0,6782287
816,3747,Dr. Kodur Venkatesh,BANGALORE SOUTH,IND,0,Doctorate,44213130,0,44213130
817,464,Dr. Kshetra Pal Singh,FARIDABAD,IND,0,Graduate Professional,3280000,0,3280000
818,280,Dr. M.V. Ibraheem,MALAPPURAM,IND,3,Graduate Professional,232700,0,232700
819,1196,Dr. Meer Layaq Hussain,BANGALORE CENTRAL,IND,0,Graduate Professional,30000,0,30000
820,1358,Dr. Nabhit Kapur,EAST DELHI,Naya Daur Party,0,Doctorate,150000,0,150000
821,927,Dr. Namdeo Dalluji Usendi,GADCHIROLI-CHIMUR,INC,1,Post Graduate,14281020,9382799,4898221
822,2432,Dr. Narendra Kumar Gupta,CHITTORGARH,AAP,0,Graduate Professional,10723839,484486,10239353
823,3180,Dr. Nepal Singh,RAMPUR,BJP,0,Doctorate,27136042,1614820,25521222
824,3225,Dr. Nepole Raghu Murmu,MAYURBHANJ,BJP,0,Doctorate,4573490,419980,4153510
825,2355,Dr. Om Singh Meena,JAIPUR RURAL,IND,0,Post Graduate,19869123,800000,19069123
826,3875,Dr. Owhal Jitendra Mahadev,BEED,IND,0,Graduate Professional,3438256,1572500,1865756
827,3749,Dr. Pradeep Gadugesh,BANGALORE SOUTH,IND,0,Graduate Professional,737397,185386,552011
828,2527,Dr. Pradeep Rambhau Nagrale,NAGPUR,Ambedkarite Party of India,0,Graduate Professional,8052965,4637487,3415478
829,3666,Dr. Prakash Shamrao Pawar,SATARA,IND,0,Graduate Professional,886693,0,886693
830,1728,Dr. Rahul Dipankar,BULANDSHAHR,AAP,0,Post Graduate,74254557,10800000,63454557
831,2025,Dr. Rajesh Mahendia,HISAR,IND,0,Doctorate,3298180,350000,2948180
832,2764,Dr. Rakesh Datta Mishra,PATNA SAHIB,Bharatiya Jan Kranti Dal (Democratic),0,Post Graduate,149047,0,149047
833,3596,Dr. Ramesh Subrav Bansode,OSMANABAD,Republican Party of India,0,Graduate,410000,176114,233886
834,3192,Dr. Rashid Ali,SAMBHAL,Peace Party,0,Post Graduate,6576936,0,6576936
835,937,Dr. Sandeep Natthuji Nandeshwar,RAMTEK,Bharipa Bahujan Mahasangh,0,Post Graduate,302494,836870,0
836,663,Dr. Sanjeev Kumar Balyan,MUZAFFARNAGAR,BJP,1,Doctorate,10794222,3090803,7703419
837,672,Dr. Satyapal Singh,BAGHPAT,BJP,0,Doctorate,67402076,352000,67050076
838,64,Dr. Shashi Tharoor,THIRUVANANTHAPURAM,INC,0,Doctorate,230275186,0,230275186
839,3221,Dr. Sudarshan Lohar,KEONJHAR,Rashtriya Indepndent Morcha,0,Post Graduate,4627400,0,4627400
840,1431,Dr. Sunilbhau Vishwanathji Narnavre,RAMTEK,Republican Party of India (Khobragade),0,Not Given,2760000,0,2760000
841,1247,Dr. Suraj Mandal,KODARMA,Jharkhand Vikas Dal,2,Doctorate,7871582,700000,7171582
842,2643,Dr. Surendra Kumar Prasad,ARRAH,AAP,0,Post Graduate,12314344,0,12314344
843,422,Dr. Sushil Indora,SIRSA,Haryana Janhit Congress (BL),0,Graduate Professional,31066422,28522,31037900
844,2380,Dr. Tanmay Sharma,JAIPUR,Indian Peoples Green Party,0,Post Graduate,23869513,1000000,22869513
845,1373,Dr. Tarun Kumar,CHANDNI CHOWK,Vishva Shakti Party,0,Graduate Professional,5518804,2334044,3184760
846,3477,Dr. Thokchom Meinya,INNER MANIPUR,INC,0,Doctorate,3825200,0,3825200
847,3667,Dr. Vijaysinha Diliprao Patil,SATARA,IND,0,Graduate Professional,0,0,0
848,3011,Dr. Virendra Kumar,TIKAMGARH,BJP,0,Doctorate,8764635,0,8764635
849,2374,Dr. Virendra Singh,JAIPUR,AAP,0,Post Graduate,72141860,0,72141860
850,434,Dr. Yudhbir Singh Khyalia,HISAR,AAP,0,Doctorate,23346340,7678981,15667359
851,3582,Dr.Bhise Indrakumar Devrao,MADHA,IND,0,Graduate Professional,13265000,13550000,0
852,1132,Dr.Kohapare Harshawardhan Muneshwar,BHANDARA-GONDIYA,Bahujan Mukti Party,0,Graduate Professional,980000,14000,966000
853,1094,Dr.Meerlayaq Hussain,BANGALORE NORTH,IND,0,Graduate Professional,31000,0,31000
854,2853,Dr.Om Prakash Ananad,JAMSHEDPUR,IND,0,Post Graduate,2292704,559358,1733346
855,3578,Dr.Pramod Ramchandra Gawade,MADHA,IND,0,Doctorate,498000,266676,231324
856,2995,Dr.Prashant Tripathi,RAJGARH,AAP,1,Graduate Professional,11252908,3907073,7345835
857,781,Dr.Rajendra Ramkrishna Gawai,AMRAVATI,RPI,0,Graduate Professional,38261507,0,38261507
858,2994,Dr.Shivnarayan Verma,RAJGARH,BSP,0,Graduate Professional,410000,0,410000
859,850,Dr.Sridhar Udupa,DAVANAGERE,IND,0,Doctorate,918000,0,918000
860,3376,Dr.Vishwajeet Patangrao Kadam,PUNE,INC,0,Doctorate,874957697,204983496,669974201
861,140,Drupad Borgohain,JORHAT,CPI,0,Graduate,1479690,0,1479690
862,206,Duli Chand,KARNAL,Lok Parivartan Party(DC),0,Graduate Professional,4828000,290000,4538000
863,2351,Duli Chand Kumawat,SIKAR,IND,0,Graduate,9036500,0,9036500
864,2295,Dulichand Meghwal,GANGANAGAR,IND,0,5th Pass,6113000,0,6113000
865,3446,Dungar Mal Puniya,JODHPUR,IND,0,10th Pass,3116000,0,3116000
866,2874,Durga Munda,RANCHI,BSP,0,8th Pass,16842973,0,16842973
867,379,Durga Thakur,AURANGABAD,IND,0,10th Pass,730000,0,730000
868,1799,Durgesh Chandra Gautam,ALIGARH,AITC,0,Graduate Professional,5878725,0,5878725
869,2744,Durgesh Nandan Singh,PATALIPUTRA,IND,0,Graduate Professional,3273000,0,3273000
870,1294,Dushmanta Kumar Giri,SOUTH DELHI,IND,1,Doctorate,9500000,2720000,6780000
871,2394,Dushyant,JHALAWAR-BARAN,BJP,0,Post Graduate,239006838,2798782,236208056
872,201,Dushyant Chautala,HISAR,INLD,0,Graduate,361326990,68744460,292582530
873,797,Dusmanta Kar,SAMBALPUR,IND,0,Graduate Professional,10000,0,10000
874,1597,Dwarka Prasad Pahade,CHHINDWARA,IND,0,12th Pass,1276700,0,1276700
875,1891,E S Khaja Hussain,PALAKKAD,SDPI,2,10th Pass,6490438,35000,6455438
876,279,E. Ahamed,MALAPPURAM,IUML,1,Graduate Professional,11818952,0,11818952
877,273,E. T. Mohammed Basheer,PONNANI,IUML,0,12th Pass,13216259,0,13216259
878,3724,E.Salam,BANGALORE CENTRAL,IND,0,5th Pass,200000,0,200000
879,1920,Edappally Basheer,CHALAKUDY,IND,0,Graduate,4228516,2000000,2228516
880,503,Elias Kujur,TEZPUR,IND,0,Graduate Professional,502074,0,502074
881,1778,Eliash Narjinary,ALIPURDUARS,BSP,0,12th Pass,4236000,0,4236000
882,2196,Eliya Kati,UTTARA KANNADA,Sarva Janata Party,0,12th Pass,6330,30000,0
883,1217,Em. Narayanaswamy,KOLAR,BJP,0,Graduate,22377047,7984143,14392904
884,1456,Eng. Sanjay Raghunath Nasare,BHANDARA-GONDIYA,BSP,0,Graduate Professional,8504878,511145,7993733
885,3121,Engineer Mohammad Irfan,MORADABAD,Peace Party,0,Graduate Professional,25678455,828616,24849839
886,2299,Er. Shankar Pannu,BIKANER,INC,0,Others,56245484,3791491,52453993
887,746,Er. Vijay Kumar Kol,SHAHDOL,AAP,0,Post Graduate,180118,0,180118
888,129,Faggan Singh Kulaste,MANDLA,BJP,2,Post Graduate,25738420,98311,25640109
889,2003,Fakir Chand,SIRSA,IND,0,8th Pass,438500,0,438500
890,2498,Falguni Tripura,TRIPURA EAST,CPI(ML)L,0,12th Pass,3500,0,3500
891,3038,Farhat Hasan,AMROHA,BSP,1,10th Pass,47354896,0,47354896
892,2379,Farooq Khan,JAIPUR,BSP,0,5th Pass,13091000,0,13091000
893,211,Fauji Jai Kawar Tyagi Dixit,GURGAON,IND,0,8th Pass,42915552,0,42915552
894,2223,Fayaz Ahamed Alias Mohammad Fayaz Ahamad,SHIMOGA,Sarva Janata Party,0,8th Pass,6884684,409000,6475684
895,3319,Feroz Khan Gazi,NANDED,IND,0,12th Pass,3482000,0,3482000
896,1482,Firaj Pathan,CHANDRAPUR,Bahujan Mukti Party,1,12th Pass,6370,62000,0
897,3202,Firoj Haider,SAMBHAL,IND,0,Graduate,8301000,0,8301000
898,2786,Foolodevi Netam,KANKER,INC,0,12th Pass,4819534,0,4819534
899,16,Fr.Stephen,THIRUVANANTHAPURAM,IND,2,Post Graduate,169587,181000,0
900,3802,G Anojirao,KOPPAL,IND,0,12th Pass,2101000,0,2101000
901,602,G C Patel,DAVANAGERE,Sarva Janata Party,0,Graduate Professional,719300,0,719300
902,2621,G C Venkataramanappa,CHIKKBALLAPUR,RPI(A),0,5th Pass,375000,0,375000
903,3772,G N Ravi,CHIKKBALLAPUR,IND,0,Others,673700,50000,623700
904,2156,G Nataraja,BELLARY,Karunaadu Party,0,Others,885000,0,885000
905,853,G V Sreerama Reddy,CHIKKBALLAPUR,CPI(M),1,Graduate Professional,6720730,620000,6100730
906,3731,G. Narayanaswamy (Kapali),BANGALORE CENTRAL,IND,0,10th Pass,8146501,0,8146501
907,3752,G. Venkatesh Bhovi,BANGALORE SOUTH,IND,0,10th Pass,3532000,0,3532000
908,1220,G.M. Siddeshwara,DAVANAGERE,BJP,0,10th Pass,232375703,17951455,214424248
909,3992,G.M.Siddeshi,DAVANAGERE,IND,0,12th Pass,1501000,275000,1226000
910,3786,G.N.Venkatesh,KOLAR,IND,0,Graduate Professional,545000,80000,465000
911,2568,G.Nagendra,TUMKUR,IND,0,10th Pass,275000,0,275000
912,1087,G.S.Basavaraj,TUMKUR,BJP,0,Graduate Professional,275785995,67200540,208585455
913,1226,Gadkari Nitin Jairam,NAGPUR,BJP,4,Graduate Professional,153704475,19004037,134700438
914,978,Gagan Rastogi,CHANDNI CHOWK,IND,0,Graduate,53919,0,53919
915,2597,Gaikawad Rajendra Vitthal,YAVATMAL-WASHIM,IND,1,12th Pass,30250,0,30250
916,934,Gaikwad Mohan Ramrao,NAGPUR,BSP,0,Doctorate,47473922,33921023,13552899
917,3598,Gaikwad Ravindra Vishwanath,OSMANABAD,SHS,8,Post Graduate,32852793,5962702,26890091
918,3548,Gaikwad Sunil Baliram,LATUR,BJP,0,Doctorate,17463251,0,17463251
919,3354,Gaikwad Texas Bhausaheb,MAVAL,BSP,0,Graduate Professional,38366000,0,38366000
920,3599,Gaikwad Umaji Pandurang,OSMANABAD,IND,0,10th Pass,597,0,597
921,3561,Gajanan Pandurang Mane,LATUR,IND,0,Not Given,838628,0,838628
922,1700,Gajendra,GAUTAM BUDHHA NAGAR,Indian Oceanic Party,0,Post Graduate,50000,0,50000
923,2777,Gajendra Kumar,PATNA SAHIB,Sankhyanupati Bhagidari Party,0,Graduate,1575000,0,1575000
924,3556,Gajendra Limbaji Avghade,LATUR,IND,0,12th Pass,761000,0,761000
925,3438,Gajendrasingh Shekhawat,JODHPUR,BJP,0,Post Graduate,143491494,92198588,51292906
926,1755,Gajresh Kumar,BIJNOR,IND,1,Graduate,266000,0,266000
927,3492,Gandhi Dilipkumar Mansukhlal,AHMEDNAGAR,BJP,10,10th Pass,65316725,34176876,31139849
928,3016,Ganesh,TIKAMGARH,IND,0,5th Pass,20000,0,20000
929,938,Ganesh Bapurao Patil,RAMTEK,GGP,0,5th Pass,5220000,20000,5200000
930,2761,Ganesh Shaw,PATNA SAHIB,BSP,0,Graduate,64000,52000,12000
931,732,Ganesh Singh,SATNA,BJP,2,Post Graduate,37800000,0,37800000
932,2588,Ganesha,CHITRADURGA,IND,0,Not Given,115500,0,115500
933,2771,Ganga Vishnu Prasadq,PATNA SAHIB,IND,0,Graduate Professional,6401308,0,6401308
934,2802,Gangadhar Patel,MAHASAMUND,IND,0,5th Pass,929000,0,929000
935,178,Gangadhar S. Badiger,DHARWAD,SUCI(C),0,Graduate,60000,0,60000
936,3877,Gangadhar Sitaram Kalkute,BEED,IND,0,Graduate,425000,0,425000
937,194,Gangmumei Kamei,OUTER MANIPUR,BJP,0,Post Graduate,10656364,0,10656364
938,124,Gaur Chandra Majumder,ANDAMAN & NICOBAR ISLANDS,BSP,0,Graduate,3192819,688689,2504130
939,687,Gaurav,BIJNOR,AAP,0,Graduate Professional,28246000,24000000,4246000
940,2301,Gauri Shankar,BIKANER,AAP,0,Doctorate,2173200,300000,1873200
941,2533,Gaus Mohammed Sheikh Ayyub Sheikh,NAGPUR,IND,0,10th Pass,50000,0,50000
942,1581,Gautam Ramteke,BALAGHAT,Republican Party of India (Khobragade),0,12th Pass,2000,0,2000
943,3915,Gautam Shinde,BHOPAL,Apna Dal,0,Graduate Professional,633000,0,633000
944,1511,Gawali Bhavana Pundlikrao,YAVATMAL-WASHIM,SHS,4,Graduate,60886040,7368967,53517073
945,3668,Gawde Sukhdev Bhanudas,SATARA,IND,0,10th Pass,2170000,0,2170000
946,3259,Gayadhar Mallick,JAJPUR,Samata Kranti Dal,1,10th Pass,371500,0,371500
947,369,Geeta Arya,SASARAM,AAP,0,8th Pass,18756436,0,18756436
948,2884,Geeta Kora,SINGHBHUM,Jai Bharat Samanta Party,1,Graduate,30267735,583602,29684133
949,2947,Geeta Rajput,GWALIOR,Al-Hind Party,0,12th Pass,53000,0,53000
950,3393,Geetaram Ramchandra Kadam,SHIRUR,Socialist Party (India),0,12th Pass,6423981,1100000,5323981
951,1190,Geetha Shivarajkumar,SHIMOGA,JD(S),0,Graduate,176721674,38712502,138009172
952,638,George Mankidiyil,THIRUVANANTHAPURAM,IND,0,Graduate Professional,20103771,0,20103771
953,1335,Ghanshyam Dass,NEW DELHI,IND,0,10th Pass,21043000,0,21043000
954,1577,Ghanshyam Kudape,MANDLA,IND,0,10th Pass,1351051,0,1351051
955,3357,Gharat Santosh Rohidas,MAVAL,Bahujan Mukti Party,0,8th Pass,11200149,780879,10419270
956,1489,Ghaywan Roshan Jambuwantrao,CHANDRAPUR,Republican Party (Khoripa),0,Post Graduate,1921000,0,1921000
957,3680,Gholap Sandeep Bhaskar,SHIRDI,IND,0,8th Pass,193600,0,193600
958,555,Ghulam Kundanam,KARAKAT,AAP,1,Graduate Professional,623000,280800,342200
959,670,Ghulam Mohammed,BAGHPAT,SP,0,Post Graduate,22108104,5678445,16429659
960,2785,Ghulam Nabi Azad,UDHAMPUR,INC,0,Post Graduate,41389590,0,41389590
961,3520,Ghunnar Prakash Vitthalrao,HINGOLI,IND,0,12th Pass,10572325,300000,10272325
962,485,Ghuran Ram,PALAMAU,JVM,3,Graduate,14586699,1046647,13540052
963,874,Gicho Kabak,ARUNACHAL WEST,NCP,0,10th Pass,400000,0,400000
964,3017,Girdhari,TIKAMGARH,IND,0,12th Pass,1403342,0,1403342
965,3897,Girdhari Lal,UDHAMPUR,Bharatiya Bahujan Party,0,Post Graduate,24920000,0,24920000
966,1172,Giridhar Gamang,KORAPUT,INC,0,Graduate,5895460,2500000,3395460
967,341,Girija Kumary,ATTINGAL,BJP,0,12th Pass,3279941,146000,3133941
968,3297,Girindra Nath Barman,COOCHBEHAR,BSP,0,10th Pass,103000,0,103000
969,149,Giriraj Singh,NAWADA,BJP,1,Graduate,50054771,0,50054771
970,3148,Girish Chandra,NAGINA,BSP,1,Graduate,24839368,8097654,16741714
971,1541,Girish Kumar Gautam,REWA,IND,0,Post Graduate,381000,0,381000
972,2174,Girishgouda Channabasanagouda Bistanagoudar,HAVERI,IND,0,Graduate,6555,0,6555
973,2941,Girraj Yadav,GUNA,IND,6,10th Pass,565000,0,565000
974,2303,Gopal Balmiki,BIKANER,IND,0,10th Pass,1000,0,1000
975,2775,Gopal Prasad Sinha,PATNA SAHIB,JD(U),0,Post Graduate,59131851,0,59131851
976,1159,Gopal Pujari,NABARANGPUR,Aama Odisha Party,1,10th Pass,100000,0,100000
977,2649,Gopal Singh,ARRAH,IND,0,10th Pass,2410664,0,2410664
978,2457,Gopal Singh Shekhawat,RAJSAMAND,INC,0,Graduate Professional,4157012,796727,3360285
979,3439,Goparam Meghwal,JODHPUR,BSP,0,5th Pass,8626500,0,8626500
980,506,Gopi Chand Shahabadi,TEZPUR,AITC,0,Graduate,20624119,3437403,17186716
981,819,Gopinath Jani,NABARANGPUR,BSP,0,8th Pass,426659,37200,389459
982,282,Gopinathan.N,MALAPPURAM,IND,0,Post Graduate,2486000,201347,2284653
983,2324,Gordhan Sarswat,CHURU,AITC,0,Literate,500000,0,500000
984,2448,Gotam Lal Meena,UDAIPUR,CPI(ML)L,1,5th Pass,141876,0,141876
985,254,Gothra Moopan Nellikadan Kannan,KASARAGOD,IND,0,Not Given,240000,0,240000
986,115,Gourav Gogoi,KALIABOR,INC,0,Post Graduate,5473199,1042133,4431066
987,1791,Goutam Bhattacharya,DARJEELING,SUCI(C),0,10th Pass,1201800,0,1201800
988,2250,Goutam Malakar,KARIMGANJ,IND,0,8th Pass,242000,0,242000
989,1424,Goutam Shriram Wasnik,RAMTEK,IND,0,8th Pass,764000,0,764000
990,3756,Govind,BIDAR,SP,0,10th Pass,43703163,2740661,40962502
991,1990,Govind Gaude,SOUTH GOA,IND,4,Others,5478000,650000,4828000
992,2423,Govind Kumar Bairwa,BHILWARA,BSP,0,8th Pass,2470000,0,2470000
993,3000,Govind Singh Rajput,SAGAR,INC,1,Post Graduate,30758478,2458028,28300450
994,3295,Govindarju.G,TUMKUR,IND,0,10th Pass,3285000,50000,3235000
995,3805,Govindhareddy Pacharalli,KOPPAL,IND,0,Graduate,120000,30000,90000
996,3303,Granthi Narendrasingh Anmolsingh,NANDED,AAP,0,Graduate,14385756,36503,14349253
997,1713,Grisa Kumar,GAUTAM BUDHHA NAGAR,IND,0,8th Pass,828000,0,828000
998,227,Gufran Ahamad,MUZAFFARNAGAR,IND,0,12th Pass,2054600,125000,1929600
999,2431,Gulab Chand Sahlot,CHITTORGARH,IND,0,10th Pass,1087100,0,1087100
1000,2925,Gulab Khan,DAMOH,IND,0,Post Graduate,432000,0,432000
1001,2045,Gulab Singh,SONIPAT,POORVANCHAL RASHTRIYA CONGRESS,0,Graduate,53952000,0,53952000
1002,2456,Gulam Farid,RAJSAMAND,SP,0,8th Pass,858960,148000,710960
1003,2340,Gulam Nabi,SIKAR,BSP,0,12th Pass,6711505,293515,6417990
1004,589,Gulkirat Kaur Panag,CHANDIGARH,AAP,0,Post Graduate,129508000,2164000,127344000
1005,600,Gullihatty. D. Shekhar,CHITRADURGA,JD(S),1,Graduate,7903095,682408,7220687
1006,3620,Gulmir Khan,PARBHANI,BSP,2,8th Pass,270000,0,270000
1007,875,Gumjum Haider,ARUNACHAL WEST,AITC,0,Graduate,8808016,0,8808016
1008,3922,Gundesh Khambra,BHOPAL,IND,0,10th Pass,179000,0,179000
1009,511,Gunin Basumatari,JORHAT,SP,0,Graduate Professional,10322068,217200,10104868
1010,547,Gunwant Sudamrao Devpare,AMRAVATI,BSP,0,Others,209390631,23488366,185902265
1011,2826,Gurjeet Singh,GIRIDIH,AAP,0,Post Graduate,3182920,237000,2945920
1012,1036,Gurmeet Singh,KURUKSHETRA,Lok Dal,0,Graduate,3125677,69000,3056677
1013,1498,Gurnule Ramesh Vithoba,YAVATMAL-WASHIM,IND,0,8th Pass,85000,530,84470
1014,878,Gursagar Singh,JAMMU,Socialistic Democratic Party,0,12th Pass,19540000,3350000,16190000
1015,3711,Guru Prasad Pradhan,DHENKANAL,IND,0,Graduate Professional,1157381,0,1157381
1016,1428,Gurudas Uddhav Bawane,RAMTEK,IND,0,12th Pass,3742000,820000,2922000
1017,2230,Gurudeva S H,UDUPI CHIKMAGALUR,AAP,0,Graduate Professional,6971500,250000,6721500
1018,2188,Gurushantappa Chalwadi,DHARWAD,RPI(A),0,10th Pass,320255,0,320255
1019,3757,Guruswamy B,CHAMARAJANAGAR,SP,0,Graduate Professional,11061200,995250,10065950
1020,791,Gyan Chand,BARGARH,BSP,0,5th Pass,7854072,0,7854072
1021,3765,H D Kumara Swamy,CHIKKBALLAPUR,JD(S),1,Graduate,1677777589,729603654,948173935
1022,2626,H N Ramakrishna Reddy,CHIKKBALLAPUR,Pyramid Party of India,0,10th Pass,2626000,674000,1952000
1023,2592,H. Siddagangappa,CHITRADURGA,Ambedkar National Congress,0,12th Pass,209000,1150000,0
1024,2225,H. Suresh Poojari,SHIMOGA,IND,0,5th Pass,26000,0,26000
1025,3400,H.B.P. Ajay Sahebrao Baraskar Maharaj,AHMEDNAGAR,Bahujan Mukti Party,2,12th Pass,11185018,442109,10742909
1026,2613,H.D. Devegowda,HASSAN,JD(S),0,Graduate Professional,42721242,8648283,34072959
1027,2614,H.D. Revanna,HASSAN,Karunaadu Party,0,10th Pass,483000,50000,433000
1028,2214,H.K. Kenchveerappa,DAVANAGERE,Vichara Jagruthi Congress Paksha,1,10th Pass,4359500,50000,4309500
1029,1003,H.K. Mahendru,NORTH EAST DELHI,IND,0,8th Pass,41985,0,41985
1030,2201,H.K. Ramachandrappa,DAVANAGERE,CPI,0,10th Pass,3180981,0,3180981
1031,2566,H.K.Krishna,MANDYA,Karunaadu Party,0,Graduate,390000,0,390000
1032,3736,H.L. Manjunatha,BANGALORE CENTRAL,Kannada Chalavali Vatal Paksha,0,12th Pass,6000,0,6000
1033,2576,H.L.Mohan Kumar,TUMKUR,Hindustan Janta Party,0,8th Pass,978000,400000,578000
1034,3792,H.N.Narayanaswamy,KOLAR,IND,0,10th Pass,335000,100000,235000
1035,3796,H.V.Anjappa,KOLAR,IND,0,Post Graduate,5141000,0,5141000
1036,951,Habung Payeng,ARUNACHAL WEST,AAP,0,Post Graduate,14587055,0,14587055
1037,847,Hadapad Basavaraj,UTTARA KANNADA,Rani Chennamma Party,1,12th Pass,410000,0,410000
1038,1284,Hafiz Mustaq,SOUTH DELHI,Jan Samanta Party,0,Illiterate,430000,0,430000
1039,474,Haji Jainul Abedin,CHATRA,BSP,0,Graduate,15758303,0,15758303
1040,3123,Haji Mohd Yaqoob,MORADABAD,BSP,2,8th Pass,68484555,575735,67908820
1041,1910,Haji Moideen Shah,THRISSUR,JD(U),0,Others,2100000,0,2100000
1042,2903,Hakim Singh,BHIND,IND,0,10th Pass,741417,0,741417
1043,2175,Halappa Doddaneelappa Timmenahalli,HAVERI,BSP,0,Graduate,1080000,200000,880000
1044,95,Hamid Khan,FARIDABAD,Hindustan Kranti Dal,0,Graduate,5219608,49608,5170000
1045,2603,Haneef Khan,DAKSHINA KANNADA,SDPI,0,10th Pass,1703900,0,1703900
1046,2107,Hanmant Krishna Majukar,BELGAUM,IND,0,10th Pass,12403000,0,12403000
1047,1841,Hanmanth Holer,BIJAPUR,IND,1,12th Pass,141500,0,141500
1048,204,Hansraj,HISAR,IND,0,12th Pass,60000,0,60000
1049,2001,Hansraj Hansa,SIRSA,Jan Morcha,0,12th Pass,77000,0,77000
1050,1748,Hansraj Saini,SAHARANPUR,IND,0,Graduate Professional,3411840,42000,3369840
1051,3462,Hanuman Beniwal,NAGAUR,IND,1,Graduate Professional,3309739,0,3309739
1052,3457,Hanumanram,NAGAUR,AAP,0,Graduate Professional,3023141,80027,2943114
1053,598,Hanumantappa Kabbar,HAVERI,IND,0,Graduate,1600000,0,1600000
1054,2191,Hanumantappa Mallappa Bankapur,DHARWAD,JD(S),0,8th Pass,25257819,1710000,23547819
1055,3317,Hanumante Dhondopant Nagorao,NANDED,Rashtriya Kisan Congress Party,0,Post Graduate,1075000,26000,1049000
1056,3325,Hanumante Vijay Chandrao,NANDED,IND,0,8th Pass,86000,0,86000
1057,3070,Har Bhagwan,BADAUN,IND,0,Graduate,6395670,44625,6351045
1058,1303,Har Gobind Arora,WEST DELHI,SHS,1,12th Pass,6189246,0,6189246
1059,1771,Harekrishna Sarkar,COOCHBEHAR,RPI(A),0,Post Graduate,1562066,665800,896266
1060,3032,Harekrishna Sarkar,JALPAIGURI,RPI(A),0,Post Graduate,962066,665800,296266
1061,1888,Hari Arumbil,PALAKKAD,BSP,0,12th Pass,415000,80000,335000
1062,877,Hari Chand Jalmeria,JAMMU,JKNPP,0,Graduate Professional,4004437,500000,3504437
1063,155,Hari Manjhi,GAYA,BJP,1,8th Pass,10184120,2000000,8184120
1064,2459,Hari Om Singh Rathore,RAJSAMAND,BJP,0,Graduate,188310824,2728752,185582072
1065,448,Hari Parkash,SONIPAT,SUCI(C),0,10th Pass,5588154,0,5588154
1066,2851,Hari Uraon,JAMSHEDPUR,IND,0,12th Pass,819405,122000,697405
1067,1781,Haribhakta Sardar,JALPAIGURI,SUCI(C),1,10th Pass,1048500,70,1048430
1068,820,Harihara Karana,KANDHAMAL,INC,0,Post Graduate,96350411,269368,96081043
1069,3120,Hariom,MORADABAD,Naya Daur Party,0,12th Pass,3270600,0,3270600
1070,973,Hariom Sharma,CHANDNI CHOWK,AITC,0,10th Pass,23010474,3391550,19618924
1071,3299,Haripada Barman,JALPAIGURI,Rashtriya Janasachetan Party,0,12th Pass,239580,0,239580
1072,518,Hariprasad Dihingia,LAKHIMPUR,AGP,2,10th Pass,80659606,1997168,78662438
1073,3463,Hariram,NAGAUR,IND,0,8th Pass,1420000,0,1420000
1074,3458,Hariram Mehrada,NAGAUR,Bahujan Sangharshh Dal,0,Post Graduate,480500,0,480500
1075,2473,Harish Chaudhary,BARMER,INC,0,Post Graduate,8822577,2407054,6415523
1076,2445,Harish Rawat,BANSWARA,AAP,0,10th Pass,1941143,0,1941143
1077,1328,Harkrishan Das Nijhawan,NEW DELHI,IND,1,12th Pass,29194281,572550,28621731
1078,1370,Harsh Kumar,NORTH EAST DELHI,IND,0,Graduate Professional,466633,0,466633
1079,1726,Harveer,BULANDSHAHR,IND,0,12th Pass,608000,0,608000
1080,2169,Hasan Ali Sirquazi,HAVERI,AAP,0,Post Graduate,3439291,800000,2639291
1081,4086,Hasnein Raza,AMROHA,New All India Congress Party,1,5th Pass,588000,0,588000
1082,2460,Heera Alias Heera Bhai Kathat,RAJSAMAND,IND,0,Literate,885000,50000,835000
1083,550,Hem Chandra Barman,COOCHBEHAR,BJP,0,12th Pass,5092000,1050000,4042000
1084,516,Hem Kanta Miri,LAKHIMPUR,SUCI(C),0,Graduate Professional,69500,0,69500
1085,3065,Hema Mehra,BADAUN,AAP,0,10th Pass,103368000,0,103368000
1086,837,Hemanand Biswal,SUNDARGARH,INC,0,12th Pass,20107728,1300000,18807728
1087,2080,Hemant Kumar Saini,GURGAON,Bahujan Mukti Party,0,10th Pass,15206538,1008079,14198459
1088,3903,Hemant Pradhan,MAHASAMUND,IND,0,8th Pass,219000,0,219000
1089,1166,Hemendra Chandra Singh,KANDHAMAL,BJD,2,Graduate,503907437,4786551,499120886
1090,2792,Hemlal Markam,KANKER,GGP,1,Graduate,967000,0,967000
1091,2286,Hetram,GANGANAGAR,Rajasthan Vikas Party,0,Literate,965000,80000,885000
1092,132,Hina Likhiram Kawre,BALAGHAT,INC,0,Post Graduate,4804487,0,4804487
1093,2949,Hiraday Narayan Singh Tomar,GWALIOR,Akhil Bharat Hindu Mahasabha,0,10th Pass,398500,0,398500
1094,520,Hiramoni Deka Sonowal,LAKHIMPUR,AAP,0,Doctorate,192000,0,192000
1095,763,Hirasan Uikey,BALAGHAT,GGP,0,Graduate Professional,3765446,200000,3565446
1096,1769,Hitendra Das,COOCHBEHAR,IND,0,8th Pass,2546997,0,2546997
1097,3894,Hoke (Patil)Rajedra Achyutrao,BEED,IND,0,12th Pass,142000,60000,82000
1098,240,Horen Borgohain,JORHAT,AIFB,0,Post Graduate,3260000,800,3259200
1099,522,Hrishikesh Baruah,LAKHIMPUR,IND,0,Post Graduate,9000,0,9000
1100,655,Hukum Singh,KAIRANA,BJP,2,Graduate Professional,29078847,2941671,26137176
1101,3033,Humera Akhtar,AMROHA,SP,0,12th Pass,14344567,50000,14294567
1102,2545,Hunashyal Ravi,BAGALKOT,JD(S),0,Graduate,9950000,812000,9138000
1103,2557,Hunsur K Chandrashekar,MYSORE,Democratic Prajakranthi Party Secularist,1,Post Graduate,4106000,0,4106000
1104,2466,Idrish Mohammad,RAJSAMAND,Jago Party,0,8th Pass,2682000,0,2682000
1105,2391,Iftekar Qureshi,JAIPUR,AIFB,0,Literate,52100,0,52100
1106,2402,Ijyaraj Singh,KOTA,INC,0,Post Graduate,280354736,0,280354736
1107,1874,Illyas,MALAPPURAM,BSP,0,10th Pass,988156,44000,944156
1108,2184,Imamsab. Toragal.,DHARWAD,IND,0,10th Pass,80000,0,80000
1109,2996,Imamuddin Khan,RAJGARH,IND,0,Graduate,1882500,70000,1812500
1110,2895,Imarti Devi,BHIND,INC,0,12th Pass,12751000,1989540,10761460
1111,4081,Imran,KHAJURAHO,Peace Party,0,Graduate,391000,0,391000
1112,559,Imran Ali,KARAKAT,IND,0,Graduate,7845,0,7845
1113,684,Imran Masood,SAHARANPUR,INC,5,12th Pass,47166093,2012262,45153831
1114,3374,Imtiyaz Peerzade,PUNE,BSP,0,Graduate,83320451,7500000,75820451
1115,1309,Inder Singh,NORTH WEST DELHI,Asankhya Samaj Party,0,10th Pass,2437000,0,2437000
1116,1573,Inder Singh Uikey,MANDLA,Ambedkarite Party of India,0,12th Pass,195000,0,195000
1117,1046,Inderjit Singh,GURGAON,BJP,0,Graduate Professional,250698763,0,250698763
1118,3484,Indira Oinam,INNER MANIPUR,IND,0,Graduate,948604,0,948604
1119,390,Indra Deo Choudhary,GAYA,Bahujan Mukti Party,0,10th Pass,507000,10000,497000
1120,740,Indrajeet Kumar,SIDHI,INC,0,Graduate,62690091,2494561,60195530
1121,2315,Indrasingh Jat,CHURU,CPI(M),0,Post Graduate,8543953,0,8543953
1122,2655,Indu Singh,BUXAR,CPI(ML)L,0,Graduate Professional,10215879,0,10215879
1123,542,Ingle Krushanarao Ganpatrao,BULDHANA,NCP,0,Graduate,63065868,25092634,37973234
1124,290,Innocent,CHALAKUDY,IND,0,8th Pass,54474761,1303000,53171761
1125,1637,Iqra Chaudhry,MEERUT,IND,0,Not Given,400000,0,400000
1126,3776,Irappa Bharamappa Madar,DHARWAD,BSP,0,10th Pass,585029,80000,505029
1127,2187,Irashadbegum. Adhoni.,DHARWAD,IND,0,10th Pass,36000,0,36000
1128,2930,Irfan Khan,DAMOH,IND,2,8th Pass,161000,0,161000
1129,3062,Irshad Ali Ansari,AONLA,Peace Party,0,Post Graduate,2979192,0,2979192
1130,551,Ishabela Kujur,ALIPURDUARS,Rashtriya Janadhikar Suraksha Party,0,Graduate,88500,0,88500
1131,2543,Ishwar Lahanu Nandagawali,BHANDARA-GONDIYA,IND,0,10th Pass,111000,0,111000
1132,1020,Ishwar Singh,AMBALA,IND,0,5th Pass,6084400,37741,6046659
1133,3737,Ismail Khan Saif Ali,BANGALORE CENTRAL,AITC,0,12th Pass,97238300,0,97238300
1134,281,Ismail P.,MALAPPURAM,Welfare Party Of India,0,Post Graduate,9524919,0,9524919
1135,2144,Ismail Zabi Ullah,BIDAR,IND,0,Graduate,76000,0,76000
1136,1308,Istak Khan,WEST DELHI,IND,0,5th Pass,300000,0,300000
1137,1057,Ivoryna Shylla,SHILLONG,IND,0,10th Pass,23050000,0,23050000
1138,2910,J C Barai,BHOPAL,SUCI(C),0,10th Pass,3397000,0,3397000
1139,2516,J Nataraju,BANGALORE RURAL,IND,0,10th Pass,1912959,330000,1582959
1140,347,J Sudhakaran,THIRUVANANTHAPURAM,BSP,0,Post Graduate,40695000,2000000,38695000
1141,1092,J. T.Prakash,BANGALORE RURAL,IND,0,Graduate,4854168,0,4854168
1142,3509,Jadhav Chunnilal Mohan,HINGOLI,BSP,0,Graduate Professional,8401100,0,8401100
1143,777,Jadhav Prataprao Ganpatrao,BULDHANA,SHS,2,12th Pass,36033147,684092,35349055
1144,3621,Jadhav Sanjay (Bandu) Haribhau,PARBHANI,SHS,7,10th Pass,31016711,5976851,25039860
1145,3572,Jadhav Sunil Gunda,MADHA,IND,0,8th Pass,255987,0,255987
1146,970,Jag Mohan Singh Bakshi,CHANDNI CHOWK,Atulya Bharat Party,0,12th Pass,60404560,4500000,55904560
1147,2654,Jagadanand Singh,BUXAR,RJD,0,Graduate Professional,20142620,0,20142620
1148,3245,Jagannath Das,BALASORE,IND,0,Graduate,396000,0,396000
1149,1359,Jagannath Tiwari,EAST DELHI,IND,0,12th Pass,1476456,43236,1433220
1150,2815,Jagarnath Mahto,GIRIDIH,JMM,4,10th Pass,5992366,454475,5537891
1151,3224,Jagat Mohan Naik,KEONJHAR,BSP,0,10th Pass,170700,10000,160700
1152,2047,Jagbir,SONIPAT,IND,0,8th Pass,415316,0,415316
1153,665,Jagbir Singh,MUZAFFARNAGAR,IND,0,Graduate Professional,19380034,1100000,18280034
1154,207,Jagbir Singh Malik,SONIPAT,INC,0,Graduate Professional,69917201,2154569,67762632
1155,2036,Jagbir Singh Rana,KARNAL,IND,0,Post Graduate,54297291,2759783,51537508
1156,2963,Jagdeesh Kumar Patel,KHAJURAHO,Apna Dal,0,12th Pass,11500,0,11500
1157,3467,Jagdish,PALI,Bahujan Mukti Party,0,5th Pass,1311000,0,1311000
1158,2035,Jagdish,KARNAL,IND,0,Illiterate,4778000,60000,4718000
1159,2002,Jagdish,SIRSA,IND,0,Graduate,759500,0,759500
1160,3410,Jagdish,AJMER,BSP,0,10th Pass,3157459,0,3157459
1161,217,Jagdish Bhagwan Kadu,WARDHA,IND,0,Graduate Professional,15288413,3305000,11983413
1162,3896,Jagdish Kumar,UDHAMPUR,Jai Maha Bharath Party,0,5th Pass,880000,0,880000
1163,2305,Jagdish Kumar,BIKANER,IND,0,8th Pass,608500,0,608500
1164,2356,Jagdish Prasad,JAIPUR RURAL,Lok Dal,0,Literate,423000,0,423000
1165,3184,Jagdish Saran Sagar,RAMPUR,IND,0,5th Pass,1705000,0,1705000
1166,734,Jagdish Singh,SATNA,AAP,2,Graduate,58152000,630000,57522000
1167,683,Jagdish Singh Rana,SAHARANPUR,BSP,0,Graduate,72148732,4290563,67858169
1168,3418,Jagdish Singh Rawat,AJMER,IND,0,5th Pass,520000,0,520000
1169,1375,Jagjeet Singh,CHANDNI CHOWK,Bharatiya Gaon Taj Dal,0,10th Pass,353200,0,353200
1170,3178,Jagmohan,RAMPUR,IND,0,8th Pass,3212000,0,3212000
1171,3363,Jagtap Laxman Murlidhar,MAVAL,IND,0,8th Pass,87461,0,87461
1172,3358,Jagtap Laxman Pandurang,MAVAL,Peasants And Workers Party of India,3,10th Pass,63729286,2417066,61312220
1173,3364,Jagtap Laxman Sitaram,MAVAL,IND,0,5th Pass,2210100,0,2210100
1174,3571,Jagtap Nitin Maruti,MADHA,IND,0,8th Pass,470000,180000,290000
1175,208,Jai Karan,ROHTAK,SUCI(C),0,Post Graduate,15703701,0,15703701
1176,492,Jai Prakash Agarwal,NORTH EAST DELHI,INC,0,Graduate,83974848,0,83974848
1177,159,Jai Prakash Das,JAMUI,CPI(ML)L,0,8th Pass,143450,0,143450
1178,2740,Jai Prakash Yadav,PATALIPUTRA,IND,0,Graduate Professional,1434000,0,1434000
1179,1352,Jai Ram Lal,EAST DELHI,JKNPP,0,10th Pass,4827000,15000,4812000
1180,2058,Jai Singh,ROHTAK,IND,0,10th Pass,18187000,200000,17987000
1181,2046,Jai Singh,SONIPAT,AAP,0,Post Graduate,246912638,12140161,234772477
1182,2938,Jaibhansingh Pawaiya,GUNA,BJP,1,Others,8860522,72000,8788522
1183,1249,Jaideo Choudhary,KODARMA,SP,2,10th Pass,4620269,28831,4591438
1184,2507,Jain Wilson,THIRUVANANTHAPURAM,IND,0,Graduate,100000,0,100000
1185,421,Jaipal Bhatti,SIRSA,IND,0,5th Pass,2300000,0,2300000
1186,3136,Jaipal Singh Saini,MORADABAD,SHS,0,12th Pass,36898000,40000,36858000
1187,4006,Jaitun Tuti,KHUNTI,IND,0,10th Pass,100000,0,100000
1188,1658,Jaivindra Kumar,BAGHPAT,IND,0,Graduate,244000,0,244000
1189,1595,Jalasram Nagwanshi,CHHINDWARA,IND,0,12th Pass,268000,0,268000
1190,2817,Jaleshwar Mahato,GIRIDIH,JD(U),1,Graduate,24314128,1184627,23129501
1191,472,Jalley Sonam,ARUNACHAL WEST,PPA,0,10th Pass,4680000,0,4680000
1192,1939,James Joseph,IDUKKI,IND,0,10th Pass,375000,67000,308000
1193,1948,James Joseph P,KOTTAYAM,IND,0,12th Pass,10508400,0,10508400
1194,2789,Jamuna Mandavi,KANKER,Chhattisgarh Swabhiman Manch,0,Graduate,3321000,1065000,2256000
1195,738,Janardan Mishra,REWA,BJP,0,Graduate Professional,10156568,106977,10049591
1196,1536,Janardan Mishra,REWA,IND,0,Graduate,151000,0,151000
1197,2610,Janardhana Poojary,DAKSHINA KANNADA,INC,0,Graduate,5242284,0,5242284
1198,1086,Janardhana Swamy,CHITRADURGA,BJP,0,Post Graduate,19210602,0,19210602
1199,31,Jannat Jahan-Ul-Haq (Naina),CHANDIGARH,BSP,0,Graduate,11100000,500000,10600000
1200,3185,Jannat Nisha,RAMPUR,All India Minorities Front,0,Not Given,160344,0,160344
1201,3557,Jaripatke Dnyanoba Sopanrao,LATUR,IND,0,Graduate,200000,0,200000
1202,499,Jarnail Singh,WEST DELHI,AAP,0,Post Graduate,11542391,222000,11320391
1203,1297,Jarnail Singh S/O Gurbax Singh,WEST DELHI,IND,0,8th Pass,5955021,0,5955021
1204,2276,Jarnail Singh S/O Rajinder Singh,WEST DELHI,IND,0,10th Pass,2457012,0,2457012
1205,890,Jasmer Singh,CHANDIGARH,IND,0,10th Pass,5355500,290000,5065500
1206,1914,Jasminsha,THRISSUR,IND,2,Others,569648,0,569648
1207,1031,Jasvinder,KURUKSHETRA,IND,0,5th Pass,1730088,0,1730088
1208,2293,Jasvinder Singh,GANGANAGAR,Jai Maha Bharath Party,0,Graduate,3192000,0,3192000
1209,2048,Jaswant,SONIPAT,IND,0,10th Pass,612000,108000,504000
1210,2478,Jaswant Singh,BARMER,IND,0,Graduate,120424990,0,120424990
1211,1048,Jaswinder Singh,KARNAL,INLD,0,10th Pass,46436884,2562000,43874884
1212,2768,Jauhar Azad,PATNA SAHIB,Janta Dal Rashtravadi,0,12th Pass,560500,360000,200500
1213,3780,Javaraiah,HASSAN,IND,0,10th Pass,50000,0,50000
1214,2832,Javed Islam,HAZARIBAGH,CPI(ML)L,0,Graduate,2117600,50000,2067600
1215,3092,Javed Khan,BAREILLY,IND,3,Literate,135000,0,135000
1216,2399,Javed Khan,JHALAWAR-BARAN,Bharatiya Yuva Shakti,0,12th Pass,50200,0,50200
1217,773,Jay Prakash Patel,HOSHANGABAD,GGP,0,10th Pass,3411000,400000,3011000
1218,688,Jaya Prada Nahata,BIJNOR,RLD,0,12th Pass,226399859,3931582,222468277
1219,2562,Jayachandra,MANDYA,Bahujan Mukti Party,0,10th Pass,1006729,0,1006729
1220,324,Jayachandran Sarasamma,ALAPPUZHA,IND,1,Post Graduate,1587262,600000,987262
1221,2979,Jayant Singh Tomar,MORENA,Loktantrik Samajwadi Party,0,Post Graduate,3368500,0,3368500
1222,2835,Jayant Sinha,HAZARIBAGH,BJP,0,Post Graduate,556754579,86380600,470373979
1223,2259,Jayanta Mallick,SILCHAR,IND,1,Graduate,777174,43000,734174
1224,2233,Jayaprakash Hegde,UDUPI CHIKMAGALUR,INC,0,Graduate Professional,90305073,16640811,73664262
1225,3768,Jayaprakasha Yadav,CHIKKBALLAPUR,IND,0,10th Pass,51000,0,51000
1226,3444,Jayda,JODHPUR,IND,0,Illiterate,200000,0,200000
1227,1254,Jayram Indwar,LOHARDAGA,BSP,0,12th Pass,1965000,0,1965000
1228,3540,Jeevan Alias C.A.Patil,KOLHAPUR,IND,0,Graduate,500000,0,500000
1229,3445,Jetharam Meghwal,JODHPUR,IND,0,8th Pass,765000,25000,740000
1230,3878,Jethlia Santoshbapu Mitthulal,BEED,IND,0,Post Graduate,970125,0,970125
1231,1171,Jhina Hikaka,KORAPUT,BJD,0,Graduate,8800000,0,8800000
1232,3282,Jibesh Kishore Sundaray,CUTTACK,AITC,1,10th Pass,12814048,0,12814048
1233,1915,Jiju Cheenikkal,THRISSUR,IND,0,10th Pass,226394,400000,0
1234,3268,Jimuta Prasad Mishra,DHENKANAL,AAP,0,Post Graduate,3657868,0,3657868
1235,533,Jinti Gogoi,KALIABOR,AAP,0,Graduate,42000,0,42000
1236,33,Jitan Ram Manjhi,GAYA,JD(U),0,Graduate,2360142,13109,2347033
1237,137,Jiten Gogoi,KALIABOR,IND,1,8th Pass,14407099,2700000,11707099
1238,1136,Jitendra Aadkuji Raut,BHANDARA-GONDIYA,Akhil Bhartiya Manavta Paksh,1,Graduate,76820,0,76820
1239,2497,Jitendra Choudhury,TRIPURA EAST,CPI(M),0,12th Pass,11322979,2030773,9292206
1240,2823,Jitendra Kumar,GIRIDIH,SP,0,Graduate,8029500,4000000,4029500
1241,4005,Jitendra Manki Alias Jitendra Prasad Manki,KHUNTI,IND,0,Graduate,6120000,65000,6055000
1242,3058,Jitendra Singh,AONLA,Naitik Party,0,Post Graduate,1008091,0,1008091
1243,1817,Jitendra Subhash Nerle,CHIKKODI,IND,0,10th Pass,45500,0,45500
1244,1310,Jodhraj Paharia,NORTH WEST DELHI,IND,0,Illiterate,7221810,0,7221810
1245,245,Joganati Datta,TRIPURA WEST,IND,0,8th Pass,165000,0,165000
1246,3558,Jogdand Fakira Vaijnath,LATUR,IND,0,Graduate,27000,0,27000
1247,1555,Jogendra Singh,SHAHDOL,Bahujan Mukti Party,0,8th Pass,180411,0,180411
1248,2883,John Miran Munda,SINGHBHUM,AIFB,3,12th Pass,600000,450000,150000
1249,1260,Jorawar Ram,PALAMAU,JD(U),2,12th Pass,16525000,205000,16320000
1250,2858,Josai Mardi,JAMSHEDPUR,Rashtriya Deshaj Party,0,Graduate Professional,1246500,0,1246500
1251,11,Jose K Mani,KOTTAYAM,Kerala Congress (M),0,Post Graduate,26236371,0,26236371
1252,1774,Joseph Munda,ALIPURDUARS,INC,0,Graduate,2312000,550000,1762000
1253,507,Joseph Toppo,TEZPUR,AGP,0,10th Pass,3289490,22904,3266586
1254,2270,Joy Ram Engleng,AUTONOMOUS DISTRICT,BJP,0,10th Pass,22032158,5096806,16935352
1255,1944,Joyce George,IDUKKI,IND,0,10th Pass,1034810,0,1034810
1256,804,Jual Oram,SUNDARGARH,BJP,1,Others,24202170,0,24202170
1257,881,Jugal Kishore,JAMMU,BJP,0,10th Pass,26824308,300000,26524308
1258,1927,Juno John Baby,ERNAKULAM,IND,0,Others,934581,0,934581
1259,798,Justin Lugun,SUNDARGARH,SUCI(C),0,10th Pass,8092,0,8092
1260,702,Jyothish Perumpulickal,MAVELIKKARA,SDPI,0,12th Pass,101500,5400,96100
1261,784,Jyoti Gajanan Makode,AMRAVATI,Ambedkarite Party of India,0,10th Pass,139000,0,139000
1262,2514,Jyoti Sanjay Dewkar,AMRAVATI,IND,0,10th Pass,216572,0,216572
1263,2933,Jyotiraditya M. Scindia,GUNA,INC,0,Post Graduate,330888751,795000,330093751
1264,2515,K A Mohan,BANGALORE RURAL,Kamarajar Deseeya Congress,0,5th Pass,1733000,0,1733000
1265,294,K Ambujakshan,CHALAKUDY,Welfare Party Of India,1,Post Graduate,2134142,82000,2052142
1266,1098,K Arkesh,CHIKKBALLAPUR,AAP,0,Post Graduate,30067157,750000,29317157
1267,1905,K Biju,ALATHUR,IND,3,8th Pass,73500,0,73500
1268,1930,K C Karthikeyan,ERNAKULAM,BSP,0,10th Pass,5180540,700000,4480540
1269,327,K C Venugopal,ALAPPUZHA,INC,0,Post Graduate,12856075,456010,12400065
1270,126,K H Muniyappa,KOLAR,INC,0,Graduate Professional,184663000,27863000,156800000
1271,1804,K K Ashokan,KASARAGOD,IND,0,10th Pass,5351775,517000,4834775
1272,293,K M Noordeen,CHALAKUDY,AAP,0,Graduate,158604311,0,158604311
1273,3801,K M Ranganathreddy,KOPPAL,SP,1,Graduate Professional,5500000,0,5500000
1274,1104,K Narendra Babu,KOLAR,IND,0,Post Graduate,200000,0,200000
1275,1868,K P Ratheesh,KOZHIKODE,AAP,0,Others,737252,45000,692252
1276,1337,K P Sankaran Menon,NEW DELHI,IND,0,Doctorate,182208649,0,182208649
1277,2157,K Raghavendra,BELLARY,Pyramid Party of India,1,10th Pass,20000,0,20000
1278,2625,K S Swamy,CHIKKBALLAPUR,IND,0,Graduate,1192500,0,1192500
1279,1903,K S Velayudhan,ALATHUR,IND,0,10th Pass,1211050,0,1211050
1280,1839,K Shivram,BIJAPUR,JD(S),0,Post Graduate,26203570,0,26203570
1281,177,K Somashekar,RAICHUR,SUCI(C),0,Graduate,3539,0,3539
1282,257,K Sudhakaran,KANNUR,INC,2,Post Graduate,21659467,1969997,19689470
1283,2278,K Sudhakaran (Kollon House),KANNUR,IND,0,Post Graduate,1898622,756505,1142117
1284,2279,K Sudhakaran (Sreeshylam),KANNUR,IND,0,12th Pass,414862,82500,332362
1285,2208,K Syed Zabiulla,DAVANAGERE,IND,0,12th Pass,627000,0,627000
1286,1083,K Yadava Shetty,DAKSHINA KANNADA,CPI(M),0,12th Pass,2135040,145000,1990040
1287,334,K. Bhaskaran,KOLLAM,IND,1,Graduate,6313287,108453,6204834
1288,3774,K. Kushala Bellare,DAKSHINA KANNADA,IND,0,Not Given,16329916,6500000,9829916
1289,4076,K. P. Kamte,GWALIOR,Bharatiya Rashtriya Mazdoor Dal,0,Illiterate,4500,0,4500
1290,3764,K. S. Srinivasmurthy,CHAMARAJANAGAR,CPI(ML) Red Star,0,Graduate,323207,0,323207
1291,822,K. Shyambabu Subudhi,ASKA,IND,0,10th Pass,1660000,0,1660000
1292,830,K. Shyambabu Subudhi,BERHAMPUR,IND,0,12th Pass,16000000,0,16000000
1293,473,K. V. Pusa,NAGALAND,INC,0,Graduate,15500000,0,15500000
1294,852,K.G. Sreedhar,SHIMOGA,AAP,0,Graduate,22283800,147575,22136225
1295,900,K.G.Das,ANDAMAN & NICOBAR ISLANDS,CPI(M),0,12th Pass,4221392,0,4221392
1296,3791,K.H.Madhusoodan,KOLAR,IND,0,12th Pass,235000,0,235000
1297,3811,K.Mahadevappa,MANDYA,Bharatiya Dr. B.R.Ambedkar Janta Party,0,Graduate Professional,500,0,500
1298,3730,K.Murthy,BANGALORE CENTRAL,IND,0,10th Pass,80000,0,80000
1299,2607,K.N. Somashekar,DAKSHINA KANNADA,IND,0,Graduate,13036000,1915500,11120500
1300,276,K.Narayanan Master,PONNANI,BJP,1,12th Pass,10368303,1657088,8711215
1301,300,K.P. Sreesan,THRISSUR,BJP,1,12th Pass,4653270,0,4653270
1302,3812,K.Shivananda,MANDYA,Hindustan Janta Party,0,10th Pass,260000,0,260000
1303,299,K.Sivaraman,THRISSUR,CPI(ML) Red star,1,10th Pass,3658000,0,3658000
1304,2559,K.Udayakumar,MANDYA,IND,0,10th Pass,906000,0,906000
1305,6,K.V. Thomas,ERNAKULAM,INC,0,Post Graduate,11848550,522352,11326198
1306,2573,K.V.Srinivas Kalkere,TUMKUR,IND,0,Graduate,90600,30000,60600
1307,77,Kabindra Purkayastha,SILCHAR,BJP,0,Post Graduate,6236945,130502,6106443
1308,3669,Kadam Sagar Uttamrao,SATARA,IND,1,Graduate,150,0,150
1309,1721,Kadeem,GAUTAM BUDHHA NAGAR,IND,0,5th Pass,20300,0,20300
1310,1707,Kadir Khan Jaiswal,GAUTAM BUDHHA NAGAR,IND,0,8th Pass,1461000,0,1461000
1311,226,Kadir Rana,MUZAFFARNAGAR,BSP,5,Literate,135202262,24105110,111097152
1312,3735,Kadugudi Sonnappa,BANGALORE CENTRAL,RPI(A),0,10th Pass,4083633,546581,3537052
1313,4018,Kafilur Rahman,RANCHI,IND,0,Graduate Professional,920000,0,920000
1314,2384,Kailash Chand Saini,JAIPUR,Hindustan Janta Party,0,8th Pass,16758886,0,16758886
1315,1176,Kailash Sabara,KORAPUT,Samata Kranti Dal,0,Graduate Professional,16000,0,16000
1316,3341,Kajale Pradip Mahadev,PARBHANI,IND,1,12th Pass,744277,0,744277
1317,3398,Kakade Kisan Yashwant,AHMEDNAGAR,BSP,0,10th Pass,403500,0,403500
1318,1790,Kakali Majumdar (Roy),DARJEELING,BSP,0,10th Pass,2895875,711396,2184479
1319,3600,Kakasaheb Baburao Rathod,OSMANABAD,IND,0,10th Pass,50000,100000,0
1320,3267,Kalakar Naik,DHENKANAL,Ambedkarite Party of India,0,12th Pass,2140000,0,2140000
1321,3256,Kalandi Mallick,JAJPUR,AAP,0,12th Pass,225518,0,225518
1322,3876,Kale Bajirao Shankar,BEED,IND,0,10th Pass,755000,0,755000
1323,3851,Kale Krishna Bhanudas,BEED,Bharipa Bahujan Mahasangh,0,Graduate Professional,936000,52000,884000
1324,829,Kali Charana Nayak,ASKA,IND,0,5th Pass,255213,0,255213
1325,2864,Kalicharan Munda,KHUNTI,INC,0,12th Pass,4069525,31895,4037630
1326,807,Kalikesh Narayan Singh Deo,BOLANGIR,BJD,3,Graduate,87955818,24410449,63545369
1327,2132,Kallalinga,BIDAR,IND,0,Graduate,6241000,830000,5411000
1328,85,Kamakhya Prasad Tasa,JORHAT,BJP,0,Post Graduate,1694785,0,1694785
1329,1757,Kamal,BIJNOR,IND,0,5th Pass,1606593,0,1606593
1330,1275,Kamal Chand Arya,FARIDABAD,Bahujan Mukti Party,0,Graduate Professional,36090683,0,36090683
1331,2267,Kamal Das,SILCHAR,IND,0,5th Pass,900802,0,900802
1332,162,Kamal Kanti Debnath,TRIPURA WEST,IND,0,10th Pass,2569416,414150,2155266
1333,3094,Kamal Kishor Engineer,BAREILLY,IND,0,Graduate,2967000,500000,2467000
1334,1772,Kamal Krishna Bairagi,COOCHBEHAR,Rashtriya Janadhikar Suraksha Party,0,10th Pass,138800,0,138800
1335,2359,Kamal Kumar Gaur,JAIPUR RURAL,IND,0,12th Pass,10180000,3002800,7177200
1336,766,Kamal Nath,CHHINDWARA,INC,0,Graduate,2069080434,51172087,2017908347
1337,3130,Kamar Alam,MORADABAD,Indian Bahujan Samajwadi Party,0,12th Pass,1784350,0,1784350
1338,544,Kamble Bhanudas Chokoba,AKOLA,BSP,0,12th Pass,4607000,0,4607000
1339,3497,Kamble Chandrakant Tukaram,HATKANANGLE,BSP,0,10th Pass,30000,0,30000
1340,3534,Kamble Dayanand Vasant,KOLHAPUR,Bahujan Mukti Party,0,Graduate Professional,189918,10000,179918
1341,3546,Kamble Deepak Arvind,LATUR,BSP,0,12th Pass,3326994,0,3326994
1342,3555,Kamble Milind Haribhau,LATUR,IND,0,10th Pass,1000,0,1000
1343,3503,Kamble Sukumar Dattu,HATKANANGLE,IND,0,Post Graduate,275000,0,275000
1344,3539,Kamble Sukumar Dattu,KOLHAPUR,IND,0,Post Graduate,275000,0,275000
1345,2579,Kamble Uttam Bhagaji,YAVATMAL-WASHIM,Prabuddha Republican Party,0,Post Graduate,0,0,0
1346,487,Kameshwar Baitha,PALAMAU,AITC,48,10th Pass,1808000,0,1808000
1347,1311,Kamini Kaur,NORTH WEST DELHI,IND,0,8th Pass,233096000,0,233096000
1348,231,Kamlesh,BULANDSHAHR,SP,1,5th Pass,7593541,0,7593541
1349,3009,Kamlesh Kumar,TIKAMGARH,INC,0,Doctorate,329992919,84598565,245394354
1350,2806,Kamleshwar Verma,RAJNANDGAON,INC,1,Graduate,21111998,236375,20875623
1351,2700,Kamleshwari Mandal,MUNGER,BSP,0,Others,3065084,0,3065084
1352,3845,Kanabur Sadashiv Sidamallappa,BAGALKOT,JD(U),0,Graduate Professional,15493504,2229492,13264012
1353,641,Kanchan Kumari,KODARMA,IND,0,12th Pass,5980857,85000,5895857
1354,2795,Kanhaiya Sahu,MAHASAMUND,BSP,0,Graduate,42374312,120000,42254312
1355,3473,Kanhaiyalal Pareek,PALI,IND,0,Graduate,5021340,2182277,2839063
1356,2350,Kanhaylal,SIKAR,IND,0,10th Pass,328500,0,328500
1357,1994,Kanta,KURUKSHETRA,Indian Bahujan Sandesh Party (Kanshiram),1,10th Pass,34224262,26405000,7819262
1358,552,Kanti Singh,KARAKAT,RJD,4,Graduate,60390021,337826,60052195
1359,654,Kanwar Hasan,KAIRANA,BSP,0,Post Graduate,37686620,245671,37440949
1360,3037,Kanwar Singh Tanwar,AMROHA,BJP,0,5th Pass,1788430770,4036151,1784394619
1361,386,Kapil Choudhary,GAYA,AITC,0,12th Pass,1606000,0,1606000
1362,491,Kapil Sibal,CHANDNI CHOWK,INC,0,Graduate Professional,1144747216,0,1144747216
1363,408,Kapoor Singh,AMBALA,BSP,0,Doctorate,32373100,3483000,28890100
1364,1300,Karam Chand Lathwal,WEST DELHI,Bhartiya Pragatisheel Congress,0,Post Graduate,28936843,0,28936843
1365,92,Karan Singh,ROHTAK,IND,0,10th Pass,12226000,162000,12064000
1366,210,Karan Singh,GURGAON,IND,0,Graduate,58279661,2735214,55544447
1367,2863,Karia Munda,KHUNTI,BJP,0,Post Graduate,7474796,0,7474796
1368,144,Karra Parasu Ramaiah,SASARAM,JD(U),1,Doctorate,24500404,1672000,22828404
1369,2010,Kartar Singh,HISAR,IND,0,Graduate,36950500,0,36950500
1370,2282,Kartar Singh Bains,GANGANAGAR,AITC,0,Post Graduate,3180703,0,3180703
1371,1610,Kartar Singh Bhadana,KAIRANA,RLD,1,8th Pass,334053064,2555000,331498064
1372,1488,Kartik Gajanan Kodape,CHANDRAPUR,IND,0,Others,190000,0,190000
1373,2828,Kartik Mahto,GIRIDIH,BSP,3,10th Pass,12176000,2000000,10176000
1374,3243,Kartikeswar Patra,BALASORE,AITC,1,Not Given,4365951,0,4365951
1375,1806,Karunakaran Kalippurayil,KASARAGOD,IND,0,10th Pass,4514183,0,4514183
1376,3005,Kashiram Patel,SAGAR,GGP,0,Graduate,100500,0,100500
1377,1207,Kathavaraya,CHAMARAJANAGAR,Dr. Ambedkar Samajvadi Democratic Party,0,10th Pass,1315000,520000,795000
1378,3687,Katore Mahadev Niwritti,SHIRUR,IND,0,Graduate,1052914,0,1052914
1379,2727,Kaushal Kumar Kaushalendra Sinha Alias Bharat Manas,NALANDA,IND,1,12th Pass,3049003,0,3049003
1380,2495,Kaushal Rai,SIKKIM,AAP,0,Post Graduate,192000,0,192000
1381,2725,Kaushlendra Kumar,NALANDA,JD(U),0,12th Pass,11815717,477000,11338717
1382,2532,Kavita Vinod Kumar Tibdiwal (Agrawal),NAGPUR,IND,0,Post Graduate,3694650,600000,3094650
1383,590,Kawaljit Singh,CHANDIGARH,CPI(ML)L,4,Graduate Professional,22000,0,22000
1384,2521,Kenchaiah,BANGALORE RURAL,IND,0,Not Given,510000,0,510000
1385,2916,Kesari Singh,BHOPAL,IND,0,Graduate,15325217,0,15325217
1386,1768,Keshab Chandra Ray,COOCHBEHAR,INC,0,Graduate,6801343,0,6801343
1387,521,Keshab Gogoi,LAKHIMPUR,IND,0,Graduate,858000,0,858000
1388,1529,Keshav,SATNA,IND,0,Post Graduate,76250,0,76250
1389,1680,Keshav Choudhary,GHAZIABAD,IND,1,12th Pass,1000,0,1000
1390,1228,Keshwar Yadav,CHATRA,SP,16,5th Pass,3450487,300000,3150487
1391,3698,Kewale Chaya Nagnath,SOLAPUR,IND,0,Literate,15000,0,15000
1392,519,Khairul Islam,LAKHIMPUR,IND,0,10th Pass,413129,0,413129
1393,3043,Khajan Singh,AMROHA,Rashtriya Congress (Babu Jagjivanram),0,Literate,1025000,0,1025000
1394,3741,Khan Abdul Razack,BANGALORE SOUTH,BSP,0,10th Pass,3708254,0,3708254
1395,2031,Khatab Singh Mor,KARNAL,Bhartiya Shakti Chetna Party,0,12th Pass,14880000,200000,14680000
1396,593,Khem Lal Bansal,CHANDIGARH,Inqalab Vikas Dal,0,10th Pass,76108195,900000,75208195
1397,236,Khem Raj Chetry,TEZPUR,CPI(M),0,12th Pass,300100,0,300100
1398,1280,Kheme Thakur,FARIDABAD,SP,1,Graduate,1267000,0,1267000
1399,2805,Khemraj Lodhi,RAJNANDGAON,IND,0,Graduate,9000000,100000,8900000
1400,2477,Khet Singh Rajpurohit,BARMER,IND,0,10th Pass,50046,0,50046
1401,2467,Khima Ram Salavi,RAJSAMAND,IND,1,8th Pass,1566000,85000,1481000
1402,3626,Khirid Simkumar Bhagwan,PUNE,IND,0,Post Graduate,26532579,0,26532579
1403,50,Khobragade Chandrabhan Jairam,RAMTEK,IND,0,10th Pass,37804,0,37804
1404,759,Khuman Singh Armo,MANDLA,AAP,0,12th Pass,1178622,0,1178622
1405,2091,Khush Dil Sehgal (Kapoor),FARIDABAD,Akhil Bharatiya Hind Kranti Party,0,Post Graduate,3903000,45000,3858000
1406,248,Kim Gangte,OUTER MANIPUR,AITC,0,Post Graduate,10150000,0,10150000
1407,1997,Kiran Pal,KURUKSHETRA,Bharatiya Inqalab Party,0,12th Pass,18260000,0,18260000
1408,1296,Kiran Pal Singh,SOUTH DELHI,IND,0,8th Pass,630000,0,630000
1409,1420,Kiran Prem Kumar Rodge (Patankar),RAMTEK,BSP,0,Literate,6074383,0,6074383
1410,782,Kirantai Dadarao Alias Kokubhau Kokate,AMRAVATI,IND,0,8th Pass,0,0,0
1411,246,Kiren Rijiju,ARUNACHAL WEST,BJP,0,Graduate,12539868,475000,12064868
1412,3209,Kishan Lal,SHAHJAHANPUR,Lok Dal,0,8th Pass,140000,0,140000
1413,2959,Kishan Lal Kushwah,GWALIOR,Rashtriya Samanta Dal,0,8th Pass,3740000,0,3740000
1414,678,Kishan Pal Singh,GAUTAM BUDHHA NAGAR,AAP,0,10th Pass,14376352,592054,13784298
1415,319,Kishor Rambhau Kinkar,WARDHA,Bahujan Mukti Party,1,Graduate,12132347,345000,11787347
1416,1932,Kishore,ERNAKULAM,IND,0,10th Pass,90000,0,90000
1417,439,Kismat Sharma,KARNAL,IND,0,10th Pass,1350000,540000,810000
1418,13,Kodikunnil Suresh,MAVELIKKARA,INC,1,Graduate Professional,13251330,3439654,9811676
1419,3493,Kokare Shivaji Jaysingh,BARAMATI,IND,0,8th Pass,9381000,75000,9306000
1420,2616,Kolar Kesava,KOLAR,JD(S),7,Graduate,168319791,75522284,92797507
1421,3489,Kolsepatil Baban Gangadhar,AHMEDNAGAR,IND,3,Graduate Professional,337159952,2379701,334780251
1422,2618,Kotiganahalli Ramaiah,KOLAR,AAP,0,12th Pass,7724963,1285958,6439005
1423,1593,Kripashankar Yadav,CHHINDWARA,IND,0,12th Pass,1106345,0,1106345
1424,2313,Krishan Kumar Saran,CHURU,AAP,0,Graduate,20295507,3900000,16395507
1425,1649,Krishan Pal,BAGHPAT,Naitik Party,1,12th Pass,4414465,0,4414465
1426,1047,Krishan Pal,FARIDABAD,BJP,0,Graduate Professional,296440144,19707475,276732669
1427,1605,Krishanpal,KAIRANA,IND,0,Literate,10804500,0,10804500
1428,3112,Krishna Adhikari,KHERI,CPI(ML)L,5,10th Pass,5000,0,5000
1429,76,Krishna Das,KARIMGANJ,BJP,0,12th Pass,2794334,0,2794334
1430,2901,Krishna Devi,BHIND,AAP,0,Graduate,11415750,1325000,10090750
1431,3417,Krishna Kumar Dadhich,AJMER,IND,0,Graduate,100000,0,100000
1432,3206,Krishna Raj,SHAHJAHANPUR,BJP,0,Post Graduate,16506411,3612812,12893599
1433,2969,Krishna Sharan,KHAJURAHO,Brihattar Bharat Prajatantra Sewa Party,0,Graduate,1600500,0,1600500
1434,648,Krishna Singh,KODARMA,JD(U),1,Literate,518000,0,518000
1435,872,Krishna Tirath,NORTH WEST DELHI,INC,0,Graduate,56882796,0,56882796
1436,614,Krishnamurthy,MANDYA,RPI(A),0,12th Pass,6110000,100000,6010000
1437,2560,Krishnamurthy.M,MANDYA,BSP,0,Post Graduate,839000,0,839000
1438,1902,Krishnan Eranhikkal,ALATHUR,SDPI,0,12th Pass,903301,20000,883301
1439,304,Krishnankutty M.K.,ERNAKULAM,CPI(ML) Red star,0,10th Pass,879121,40000,839121
1440,1904,Krishnankutty V,ALATHUR,IND,0,10th Pass,146988,6000,140988
1441,942,Krupal Balaji Tumane,RAMTEK,SHS,1,Graduate,46564362,216000,46348362
1442,1385,Krushnarao Ingle,BULDHANA,IND,0,Literate,206100,35000,171100
1443,3601,Kshirsagar Shivaji Jagannath,OSMANABAD,IND,0,Post Graduate,6142200,0,6142200
1444,3602,Kshirsagar Vijay Maruti,OSMANABAD,IND,0,Post Graduate,90000,47500,42500
1445,1787,Kshitish Chandra Mandal,JALPAIGURI,BSP,0,Graduate,550000,0,550000
1446,2168,Kuber Vasudev Subbaji,HAVERI,IND,0,12th Pass,2996700,0,2996700
1447,3712,Kulamani Samal,JAGATSINGHPUR,BJD,0,Graduate Professional,25158570,0,25158570
1448,793,Kulamani Urma,BARGARH,Paschimanchal Vikas Party,0,8th Pass,153000,0,153000
1449,1054,Kuldeep Bishnoi,HISAR,Haryana Janhit Congress (BL),1,Graduate,786595116,104464405,682130711
1450,122,Kuldeep Rai Sharma,ANDAMAN & NICOBAR ISLANDS,INC,0,Graduate Professional,31594826,5034619,26560207
1451,2011,Kuldeep S/O Ishwar Singh,HISAR,IND,0,Graduate,1522160,0,1522160
1452,2012,Kuldeep S/O Karan Singh,HISAR,IND,0,8th Pass,225700,0,225700
1453,2015,Kuldeep S/O Madan Lal,HISAR,IND,0,5th Pass,1012562,48000,964562
1454,2013,Kuldeep S/O Narain Singh,HISAR,IND,0,5th Pass,55000,0,55000
1455,2014,Kuldeep S/O Pardumn,HISAR,IND,0,Post Graduate,260000,102000,158000
1456,2016,Kuldeep S/O Sajjan,HISAR,IND,0,12th Pass,6548165,137000,6411165
1457,4083,Kuldeep Singh,MORENA,IND,1,Graduate,856024,0,856024
1458,1035,Kuldeep Singh,KURUKSHETRA,RPI,0,10th Pass,53708428,0,53708428
1459,2007,Kuldeep Singh S/O Shishpal,HISAR,Bahujan Mukti Party,0,Post Graduate,25500,0,25500
1460,2166,Kulkarni Chandrashekharayya Gurulingayya,HAVERI,IND,0,Graduate,1725000,20000,1705000
1461,2855,Kumar Chandra Mardi,JAMSHEDPUR,AAP,2,8th Pass,3820000,0,3820000
1462,2752,Kumar Indra Bhushan,PATALIPUTRA,IND,2,Graduate,9122284,285000,8837284
1463,2770,Kumar Rajiv,PATNA SAHIB,IND,0,Post Graduate,0,0,0
1464,1351,Kumar Vivek Gautam,EAST DELHI,IND,0,Graduate,390500,1900000,0
1465,2296,Kumbha Ram,GANGANAGAR,IND,1,12th Pass,3550978,0,3550978
1466,925,Kumbhare Hansraj Gulab,CHANDRAPUR,BSP,0,Post Graduate,551500,0,551500
1467,2222,Kunaje Manjunatha Gowda,SHIMOGA,BSP,0,Graduate,1413790,0,1413790
1468,2766,Kunal Singh,PATNA SAHIB,INC,0,12th Pass,51271000,750000,50521000
1469,2757,Kundan Prasad Singh,PATALIPUTRA,AAP,0,12th Pass,4833000,0,4833000
1470,351,Kunnil Shajahan,THIRUVANANTHAPURAM,SDPI,3,Graduate,1105500,350000,755500
1471,345,Kunnukuzhi S Mani,THIRUVANANTHAPURAM,IND,0,10th Pass,5000040,0,5000040
1472,1764,Kunwar Bhartendra,BIJNOR,BJP,2,Post Graduate,24840646,0,24840646
1473,3050,Kunwar Sarvraj Singh,AONLA,SP,0,Graduate Professional,25118224,0,25118224
1474,3117,Kunwer Sarvesh Kumar,MORADABAD,BJP,4,10th Pass,72866898,600000,72266898
1475,3531,Kurane Ajay Prakash,KOLHAPUR,BSP,0,Graduate,2255800,0,2255800
1476,2084,Kusheshwar Bhagat,GURGAON,IND,0,8th Pass,181000,0,181000
1477,2090,Kusum Kumari,FARIDABAD,All India Peoples Front,0,Post Graduate,75167,0,75167
1478,412,Kusum Sherwal,AMBALA,INLD,0,Doctorate,21378240,696974,20681266
1479,2261,Kutub Ahmed Mazumder,SILCHAR,AIUDF,0,Graduate,1249603,190679,1058924
1480,2547,Kutubuddin Kazi,BAGALKOT,AAP,0,10th Pass,3002000,200000,2802000
1481,3819,L.P.Yadunandana,TUMKUR,IND,0,Graduate,340000,0,340000
1482,571,Labha Ram,JAMMU,IND,0,12th Pass,860000,230000,630000
1483,823,Ladu Kishore Swain,ASKA,BJD,0,Graduate,3488390,25000,3463390
1484,3081,Laiq Ahmad,BAREILLY,Naitik Party,0,Not Given,1645600,9400,1636200
1485,3020,Lakhan Lal,TIKAMGARH,IND,0,12th Pass,482600,70000,412600
1486,2935,Lakhan Singh Baghel,GUNA,BSP,0,Graduate,19797009,550000,19247009
1487,237,Lakshi Kanta Kurmi,TEZPUR,CPI(ML)L,0,8th Pass,106200,0,106200
1488,2799,Lakshman Masturiya,MAHASAMUND,AAP,0,Post Graduate,2242689,0,2242689
1489,1180,Lakshmi Hebbalkar,BELGAUM,INC,0,Post Graduate,83015088,2579238,80435850
1490,1330,Lakshmi Narayan,NEW DELHI,Bharatiya Bahujan Party,0,8th Pass,8202800,0,8202800
1491,1548,Lal Bahadur Singh,SIDHI,Samata Samadhan Party,0,10th Pass,312000,0,312000
1492,2760,Lal Bahadur Singh Patel,PATNA SAHIB,Krantikari Vikas Dal,1,10th Pass,830000,0,830000
1493,870,Lal Chand,BHIWANI-MAHENDRAGARH,Republican Backward Congress,0,Graduate,11484000,0,11484000
1494,755,Lal Das,JABALPUR,GGP,0,10th Pass,8070000,130000,7940000
1495,4012,Lal Jotindra Dev,RANCHI,Akhil Bhartiya Jharkhand Party,0,Post Graduate,7216000,0,7216000
1496,482,Lal Say Kumar Bhagat,LOHARDAGA,CPI(ML)L,0,12th Pass,1319000,0,1319000
1497,1562,Lala Kol,SHAHDOL,IND,0,8th Pass,130100,2000,128100
1498,1258,Laldev Ram,PALAMAU,Bahujan Mukti Party,0,12th Pass,7293888,0,7293888
1499,3695,Lalit Babar,SOLAPUR,AAP,0,Graduate,3798836,0,3798836
1500,1614,Lalit Chauhan,MUZAFFARNAGAR,JD(U),0,12th Pass,685000,0,685000
1501,866,Lalit Kumar,BHIWANI-MAHENDRAGARH,AAP,0,Graduate Professional,8922356,4625841,4296515
1502,2099,Lalit Mittal,FARIDABAD,IND,0,Post Graduate,4295126,0,4295126
1503,2246,Lalit Mohon Suklabaidya,KARIMGANJ,INC,2,Post Graduate,11328972,0,11328972
1504,3029,Lalit Singha,DARJEELING,Bahujan Mukti Party,0,8th Pass,269500,0,269500
1505,1967,Lalitha Malayalappuzha,PATHANAMTHITTA,IND,0,10th Pass,110000,0,110000
1506,2657,Lallan Rup Narayan Pathak,BUXAR,IND,0,Doctorate,7750000,0,7750000
1507,2943,Lalli Ram Rai,GUNA,IND,0,Illiterate,131000,0,131000
1508,2730,Lallu Ram,NALANDA,Bahujan Mukti Party,0,Literate,61000,0,61000
1509,1164,Lambodar Kanhar,KANDHAMAL,IND,2,Graduate Professional,1303200,38000,1265200
1510,1010,Lamlalmoi@ Momoi Gangte,OUTER MANIPUR,CPI(ML)L,0,Graduate,800000,0,800000
1511,536,Lamminlien Gangte,OUTER MANIPUR,JD(U),0,Illiterate,5177000,0,5177000
1512,2721,Lata Sinha,NALANDA,IND,0,Post Graduate,2330367,64000,2266367
1513,1138,Lawrencia Lakra,SUNDARGARH,IND,0,12th Pass,1500,0,1500
1514,2463,Laxman,RAJSAMAND,Jai Maha Bharath Party,0,5th Pass,397073,18000,379073
1515,2098,Laxman,FARIDABAD,IND,0,Not Given,127600,0,127600
1516,3486,Laxman Bhanudas Sonale,AHMEDNAGAR,IND,0,Graduate,3309077,0,3309077
1517,2452,Laxman Bhil,UDAIPUR,BSP,0,5th Pass,277900,0,277900
1518,2887,Laxman Giluwa,SINGHBHUM,BJP,4,12th Pass,8094301,108145,7986156
1519,3001,Laxmi Narayan Yadav,SAGAR,BJP,1,Post Graduate,23962099,956348,23005751
1520,2454,Laxmilal Gameti,UDAIPUR,Socialist Party (India),0,Literate,255700,0,255700
1521,1583,Laxminarayan Dehariya,BALAGHAT,Bahujan Mukti Party,1,12th Pass,1710000,0,1710000
1522,1137,Lily Prema Kujur,SUNDARGARH,Bahujan Mukti Party,0,12th Pass,161000,0,161000
1523,786,Lingaraj Pradhan,BARGARH,AAP,0,Post Graduate,2470000,0,2470000
1524,1174,Lingaraj Sabara@Gomango,KORAPUT,IND,0,Post Graduate,5462041,1123000,4339041
1525,3910,Lodhi Seema Kaushik,RAJNANDGAON,SP,0,8th Pass,10720000,1240000,9480000
1526,1436,Lokhande Ganesh Haibatrao,RAMTEK,IND,0,Graduate Professional,548000,600,547400
1527,3405,Lokhande Sadashiv Kisan,SHIRDI,SHS,1,10th Pass,38294539,1497168,36797371
1528,3995,Loknath Mahto,HAZARIBAGH,AJSUP,1,12th Pass,23139387,236074,22903313
1529,3095,Lotan Singh,BAREILLY,IND,5,10th Pass,1470000,0,1470000
1530,1710,Lt Col Sp Singh,GAUTAM BUDHHA NAGAR,Nav Bharat Democratic Party,0,Graduate,17777227,0,17777227
1531,1325,Lukman Khan,NEW DELHI,IND,2,5th Pass,3786699,0,3786699
1532,961,M .K Raghavan,KOZHIKODE,INC,0,Graduate,6164901,1558128,4606773
1533,1889,M B Rajesh,PALAKKAD,CPI(M),11,Graduate Professional,4676316,700680,3975636
1534,3926,M C Mittal Jai Gurudeo Tatdhari,BHOPAL,IND,0,12th Pass,8070000,569170,7500830
1535,2234,M D Mainuddin Khan Alias Asfiya,UDUPI CHIKMAGALUR,IND,0,8th Pass,163000,0,163000
1536,724,M G Purushothaman,CHALAKUDY,BSP,0,Others,296000,78000,218000
1537,960,M I Shanavas,WAYANAD,INC,0,Post Graduate,27122055,7711000,19411055
1538,1009,M Khamchinpau Zou,OUTER MANIPUR,AAP,0,Post Graduate,1010616,0,1010616
1539,330,M M Paulose,ALAPPUZHA,IND,0,10th Pass,7322508,0,7322508
1540,1867,M Raghavan,KOZHIKODE,IND,0,10th Pass,20493829,0,20493829
1541,1206,M Shivanna,CHAMARAJANAGAR,JD(S),3,Graduate Professional,31402152,7852000,23550152
1542,402,M Veerappa Moily,CHIKKBALLAPUR,INC,0,Graduate Professional,137366682,39433827,97932855
1543,2489,M. Baby,KOLLAM,IND,0,10th Pass,1871596,0,1871596
1544,2591,M. Kumbhaiah,CHITRADURGA,JD(U),0,Graduate Professional,38291000,4950000,33341000
1545,1916,M. N. Kutty,THRISSUR,IND,0,10th Pass,4251600,120000,4131600
1546,666,M. Shahid,MEERUT,BSP,0,5th Pass,1989984945,103807610,1886177335
1547,337,M.A. Baby,KOLLAM,CPI(M),2,Graduate,6430619,625000,5805619
1548,1043,M.Lalmanzuala,MIZORAM,AAP,0,Graduate,63800000,0,63800000
1549,1203,M.Mahesh Alias Harsha,HASSAN,IND,0,10th Pass,37777,0,37777
1550,3790,M.Muniyappa,KOLAR,IND,0,Illiterate,2060000,0,2060000
1551,125,M.P. Sayed Mohammaed Koya,LAKSHADWEEP,BJP,0,Graduate,14073985,0,14073985
1552,2519,M.P.Munawer Shariff,BANGALORE RURAL,IND,0,Others,25000,0,25000
1553,2227,M.S. Mainuddin,SHIMOGA,IND,0,10th Pass,160000,0,160000
1554,3793,M.S.Narayanaswamy,KOLAR,IND,0,10th Pass,1000,0,1000
1555,958,M.T. Ramesh,PATHANAMTHITTA,BJP,0,Graduate,1039808,0,1039808
1556,2134,Machendar,BIDAR,IND,0,Post Graduate,11000000,550000,10450000
1557,1058,Machindra Kadapure,CHIKKODI,BSP,0,Illiterate,101000,0,101000
1558,3071,Madan Lal,BADAUN,National Party,0,10th Pass,1447000,0,1447000
1559,575,Madan Lal Sharma,JAMMU,INC,0,10th Pass,18843802,384929,18458873
1560,2951,Madan Mohan Singh Tomar,GWALIOR,Bhartiya Jan Yug Party,0,12th Pass,4795500,8704,4786796
1561,3218,Madhaba Sardar,KEONJHAR,INC,0,Post Graduate,1757015,99665,1657350
1562,3709,"Madhu Sudan Yadav,",BHUBANESWAR,BSP,0,Graduate,2050000,1440,2048560
1563,2264,Madhu Sudhan Das,SILCHAR,IND,0,12th Pass,72053,0,72053
1564,3863,Madhukar Baburao Kambale,SANGLI,IND,0,8th Pass,742800,0,742800
1565,1816,Magadum Ismail Magadum,CHIKKODI,IND,1,10th Pass,2027500,600000,1427500
1566,498,Mahabal Mishra,WEST DELHI,INC,1,12th Pass,388226286,8691614,379534672
1567,36,Mahabali Singh,KARAKAT,JD(U),5,8th Pass,33437255,0,33437255
1568,2337,Mahabeer Prasad Kumawat,JHUNJHUNU,IND,0,10th Pass,1516293,0,1516293
1569,3383,Mahadeo Jagannath Jankar,BARAMATI,Rashtriya Samaj Paksha,0,Others,6874700,0,6874700
1570,2112,Mahadev Bhimsha,GULBARGA,BSP,1,Graduate,9222545,825000,8397545
1571,2871,Mahadev Ravinath Pahan,KHUNTI,Rashtriya Deshaj Party,0,12th Pass,2137028,0,2137028
1572,3744,Mahadeva Swamy. B. M,BANGALORE SOUTH,Bharatiya Dr. B.R.Ambedkar Janta Party,0,12th Pass,812200,586200,226000
1573,3495,Mahadik Prahlad Dagadu,BARAMATI,IND,0,12th Pass,20105000,355000,19750000
1574,3283,Mahameghabahan Aira Kharabela Swain,CUTTACK,Aama Odisha Party,0,Post Graduate,3225000,0,3225000
1575,3923,Mahant Gopal Das Baba Shahab,BHOPAL,IND,0,Literate,108000,0,108000
1576,1576,Mahatalal Barkade,MANDLA,National Peoples Party,0,8th Pass,208000,0,208000
1577,1560,Mahaveer Parshad Manjhi,SHAHDOL,IND,0,8th Pass,4568000,0,4568000
1578,2069,Mahavir Singh,BHIWANI-MAHENDRAGARH,IND,0,12th Pass,130100,0,130100
1579,2086,Mahender Jat,GURGAON,IND,0,Graduate Professional,10206000,400000,9806000
1580,2794,Mahendra Gawade,KANKER,IND,0,12th Pass,306413,0,306413
1581,3435,Mahendra K. Choudhary,JALORE,IND,0,12th Pass,26113500,0,26113500
1582,3998,Mahendra Kishor Mehta,HAZARIBAGH,IND,0,10th Pass,1035500,0,1035500
1583,2405,Mahendra Kumar,KOTA,IND,0,10th Pass,259127,0,259127
1584,2940,Mahendra Kumar,GUNA,IND,1,Graduate,1760000,320000,1440000
1585,3006,Mahendra Kumar Choudhary,SAGAR,Bahujan Mukti Party,0,Post Graduate,146079,0,146079
1586,1788,Mahendra Kumar Roy,JALPAIGURI,CPI(M),0,Graduate,10695976,0,10695976
1587,483,Mahendra Oraon,LOHARDAGA,IND,0,12th Pass,2180000,20000,2160000
1588,1795,Mahendra Prasad Lama,DARJEELING,IND,0,Doctorate,34438296,3900024,30538272
1589,2919,Mahendra Pratap Singh,DAMOH,INC,0,Post Graduate,28167705,100395,28067310
1590,1251,Mahendra Ravidas,KODARMA,Bahujan Mukti Party,0,Graduate,889868,133210,756658
1591,3078,Mahendrapal,BADAUN,Bhartiya Shakti Chetna Party,0,10th Pass,4300000,0,4300000
1592,3048,Mahesh,AMROHA,RPI(A),0,12th Pass,340000,0,340000
1593,1718,Mahesh,GAUTAM BUDHHA NAGAR,IND,0,Graduate Professional,3101000,0,3101000
1594,3722,Mahesh Basappa Nandihal,BAGALKOT,Karunaadu Party,1,Graduate,2340300,434000,1906300
1595,3469,Mahesh Bhandari,PALI,AAP,0,Post Graduate,176779000,14241000,162538000
1596,2965,Mahesh Chandra,KHAJURAHO,Rashtriya Samanta Dal,0,Others,3472884,0,3472884
1597,98,Mahesh Chandra Mohanty,ASKA,BJP,0,Graduate,2702481,1021000,1681481
1598,769,Mahesh Dubey,CHHINDWARA,AAP,0,Graduate,500000,0,500000
1599,67,Mahesh Giri,EAST DELHI,BJP,1,10th Pass,5216375,400000,4816375
1600,2375,Mahesh Joshi,JAIPUR,INC,0,Doctorate,29252918,4781745,24471173
1601,2407,Mahesh Kumar Raniwal,KOTA,AARAKSHAN VIRODHI PARTY,0,8th Pass,281100,0,281100
1602,2735,Mahesh Paswan,NALANDA,Bharat Bhrashtachar Mitao Party,1,Graduate,1930000,0,1930000
1603,60,Mahesh Sharma,GAUTAM BUDHHA NAGAR,BJP,0,Graduate Professional,473797545,40905738,432891807
1604,1232,Mahesh Singh Yadav,CHATRA,JD(U),0,Graduate,44079939,3281756,40798183
1605,1524,Mahgoo,SATNA,Dalit Vikas Party(Bharat),0,Graduate,3027000,0,3027000
1606,2202,Mahima J Patel,DAVANAGERE,JD(S),0,Graduate Professional,29683292,1245000,28438292
1607,442,Mahinder Pal,KARNAL,IND,0,5th Pass,8401000,8000000,401000
1608,2037,Mahmood Hassan,KARNAL,IND,0,8th Pass,1622345,640000,982345
1609,2160,Malagi Shivakumar Giriyappa,BELLARY,AAP,0,Post Graduate,8580500,0,8580500
1610,2471,Malam Singh,BARMER,BSP,0,Post Graduate,1752238,530000,1222238
1611,2790,Malik Ram Thakur,KANKER,Ambedkarite Party of India,0,10th Pass,2397500,805000,1592500
1612,1568,Malkhan Patel,JABALPUR,IND,0,Not Given,1738000,0,1738000
1613,2517,Mallesha,BANGALORE RURAL,IND,0,12th Pass,407000,500000,0
1614,358,Mallikarjun Kharge,GULBARGA,INC,0,Graduate Professional,102220880,7410154,94810726
1615,1763,Malook Nagar,BIJNOR,BSP,0,Graduate,2896200000,33733000,2862467000
1616,441,Mam Chand,KARNAL,CPI,0,Illiterate,37120000,2100000,35020000
1617,3237,Mamata Kundu,BALASORE,AAP,0,Graduate,15105000,4500000,10605000
1618,387,Mamta Kumari,GAYA,SP,0,12th Pass,4195976,5454,4190522
1619,435,Mamta Rani,HISAR,"Rashtrawadi Parivartan Party (L.B,)",0,8th Pass,3922079,138000,3784079
1620,142,Mamun Imdadul Haque Chawdhury,LAKHIMPUR,AIUDF,0,Post Graduate,567483,0,567483
1621,2880,Man Singh Mardi,RANCHI,Jharkhand Party (Naren),0,12th Pass,40000,0,40000
1622,1566,Manak Lal Gontiya,JABALPUR,Ambedkarite Party of India,0,8th Pass,220000,0,220000
1623,2692,Mananjay Kumar,JAHANABAD,IND,0,Graduate,3527000,0,3527000
1624,3434,Manara Ram,JALORE,IND,0,Illiterate,35000,0,35000
1625,3313,Manas Kumar Behera,JAGATSINGHPUR,IND,0,Post Graduate,7105375,163500,6941875
1626,3352,Manas Ranjan Mishra,BHUBANESWAR,IND,0,Post Graduate,38090100,0,38090100
1627,3271,Manasi Swain,DHENKANAL,SUCI(C),3,Post Graduate,453116,950000,0
1628,468,Manbodh Baghel,BASTAR,BSP,0,Graduate Professional,1405000,0,1405000
1629,3633,Manchak Trimbakrao Karale,PUNE,IND,0,Literate,1575000,0,1575000
1630,2095,Mandheer Singh Maan,FARIDABAD,IND,0,10th Pass,40072745,0,40072745
1631,3506,Mane Arvind Bhiva,HATKANANGLE,IND,0,12th Pass,557300,400000,157300
1632,2990,Maneesh Kumar Rawat,MORENA,Jai Maha Bharath Party,0,Graduate Professional,511000,0,511000
1633,3154,Maneka Sanjay Gandhi,PILIBHIT,BJP,1,12th Pass,374132826,219202,373913624
1634,419,Mange Ram,SIRSA,BSP,0,Graduate,6507759,0,6507759
1635,437,Mange Ram,HISAR,BSP,0,12th Pass,14755486,0,14755486
1636,661,Mange Ram Kashyap,MUZAFFARNAGAR,Majdoor Kisan Union Party,0,Graduate Professional,2663000,0,2663000
1637,2435,Mangi Lal Solanki,CHITTORGARH,Bahujan Mukti Party,0,10th Pass,11050206,70800,10979406
1638,2474,Mangilal,BARMER,AAP,0,Post Graduate,11414442,556105,10858337
1639,2298,Mangilal Nayak,BIKANER,National Unionist Zamindara Party,0,Graduate,1060000,0,1060000
1640,1542,Mangleshwar Bhaiya,REWA,Naya Daur Party,0,12th Pass,760000,0,760000
1641,249,Mani Charenamei,OUTER MANIPUR,IND,0,Graduate,11422552,1108000,10314552
1642,3856,Manikrao Madhavrao Bavne,BEED,SP,0,Post Graduate,39351000,80000,39271000
1643,2897,Manish Katroliya,BHIND,BSP,0,Post Graduate,3179334,0,3179334
1644,396,Manish Kumar,NAWADA,IND,2,Graduate,1798755,428000,1370755
1645,1414,Manish Vinayakrao Telrandhe,WARDHA,IND,1,Graduate,4316000,162000,4154000
1646,1917,Maniyangattil Sukumaran,THRISSUR,IND,0,Literate,281000,0,281000
1647,1353,Manjeet Singh,EAST DELHI,IND,0,Graduate Professional,143000,60000,83000
1648,2004,Manjeet Singh,SIRSA,IND,0,5th Pass,710000,0,710000
1649,28,Manju Chhibber,EAST DELHI,RPI(A),0,Graduate,31380000,0,31380000
1650,2680,Manju Devi,JAHANABAD,Krantikari Vikas Dal,1,Literate,1110000,0,1110000
1651,3142,Manju Devi,NAGINA,Lok Dal,0,10th Pass,266013,0,266013
1652,1245,Manju Kumari,KODARMA,AITC,0,Post Graduate,2598000,0,2598000
1653,2611,Manju. A.,HASSAN,INC,0,Graduate Professional,165271740,1131586,164140154
1654,3777,Manjunatha,HASSAN,Bharatiya Dr. B.R.Ambedkar Janta Party,0,5th Pass,150000,0,150000
1655,2235,Manjunatha G,UDUPI CHIKMAGALUR,IND,0,12th Pass,0,0,0
1656,1119,Manohar Baliram Sonone,AMRAVATI,IND,1,12th Pass,5006000,1705000,3301000
1657,4025,Manohar Sinku,SINGHBHUM,BSP,0,Graduate,2228000,0,2228000
1658,1779,Manohar Tirkey,ALIPURDUARS,Revolutionary Socialist Party,0,10th Pass,10594756,0,10594756
1659,1093,Manohar.H.Ayyannavar,BANGALORE NORTH,IND,0,Graduate Professional,12862871,0,12862871
1660,1805,Manoharan K,KASARAGOD,IND,2,Graduate,171100,0,171100
1661,835,Manoj Choudhury,BERHAMPUR,AITC,0,10th Pass,163000,0,163000
1662,1261,Manoj Kumar,PALAMAU,RJD,1,Graduate,8357000,2350000,6007000
1663,1270,Manoj Kumar,ROHTAK,BSP,0,12th Pass,13590000,0,13590000
1664,2052,Manoj Kumar,SONIPAT,IND,0,Graduate Professional,5915698,685000,5230698
1665,1252,Manoj Kumar,KODARMA,IND,0,Post Graduate,8410000,10000,8400000
1666,629,Manoj Kumar Manjhi,JAMUI,IND,0,12th Pass,121000,150000,0
1667,66,Manoj Tiwari,NORTH EAST DELHI,BJP,0,Post Graduate,199483924,34645630,164838294
1668,2085,Manoj Yadav,GURGAON,IND,0,12th Pass,3298000,1450000,1848000
1669,239,Manorom Gogoi,JORHAT,AAP,0,Post Graduate,6659665,1647593,5012072
1670,2442,Manshankar Ninama,BANSWARA,BJP,0,8th Pass,4040285,870146,3170139
1671,799,Mansid Ekka,SUNDARGARH,IND,2,12th Pass,630000,280000,350000
1672,530,Mantu Saikia,KALIABOR,IND,0,10th Pass,5575521,6168003,0
1673,3367,Manuel Sabino D'Souza,MAVAL,IND,0,Graduate,647000,0,647000
1674,1962,Manzoor Thengana,PATHANAMTHITTA,SDPI,1,Others,43900000,0,43900000
1675,174,Maraganna Hunnur,BIJAPUR,IND,0,Graduate,375000,0,375000
1676,46,Maratha Virender Verma,KARNAL,BSP,0,Graduate Professional,96600000,0,96600000
1677,860,Marpalli Ramiah Vasudeva,DAKSHINA KANNADA,AAP,0,Post Graduate,15692369,0,15692369
1678,2123,Maruti,RAICHUR,National Development Party,0,Graduate Professional,50000,0,50000
1679,2189,Maruti Ramappa Hanasi,DHARWAD,IND,0,Graduate,2243000,230000,2013000
1680,3086,Massarrat Warsi,BAREILLY,CPI,0,12th Pass,983000,0,983000
1681,2483,Master Bhaira Ram Meghwal,BARMER,IND,0,Graduate,20000,0,20000
1682,3920,Master Sajid Siddiqui,BHOPAL,SDPI,0,Graduate Professional,3148467,0,3148467
1683,2059,Master Sher Singh,BHIWANI-MAHENDRAGARH,CPI(M),0,Graduate Professional,12962284,500926,12461358
1684,218,Mate Manohar Alias Mama,BHANDARA-GONDIYA,IND,0,8th Pass,191077,0,191077
1685,1963,Mathew Parey,PATHANAMTHITTA,IND,0,Graduate Professional,200000,0,200000
1686,308,Mathew T Thomas,KOTTAYAM,JD(S),4,Graduate Professional,10379737,649181,9730556
1687,2605,Maxim Pinto,DAKSHINA KANNADA,IND,0,10th Pass,25265000,5500000,19765000
1688,984,Md Afaq,CHANDNI CHOWK,Jai Maha Bharath Party,0,5th Pass,4374000,0,4374000
1689,1253,Md Jalil Ansari,KODARMA,National Loktantrik Party,0,Illiterate,541600,0,541600
1690,1140,Md. Ali Hussain,SAMBALPUR,IND,0,12th Pass,9030000,4420000,4610000
1691,2914,Md. Ateek,BHOPAL,Prajatantrik Samadhan Party,0,Post Graduate,663000,0,663000
1692,560,Md. Dilbas Ansari,KARAKAT,IND,0,Post Graduate,70000,0,70000
1693,3330,Md. Iliyas Md. Amir Maniyar,PARBHANI,Bharipa Bahujan Mahasangh,0,Graduate,15000,82800,0
1694,2684,Md. Istiyak,JAHANABAD,AITC,2,Graduate Professional,9481904,0,9481904
1695,3289,Md.Samim Aktar,KENDRAPARA,AAP,0,Graduate Professional,850000,0,850000
1696,2647,Meena,ARRAH,JD(U),0,Graduate,90737486,6915766,83821720
1697,1326,Meena Singla,NEW DELHI,Poorvanchal Rashtriya Congress,0,Graduate,13840344,517041,13323303
1698,1175,Meganada Sabar,KORAPUT,CPI(ML)L,0,10th Pass,200000,0,200000
1699,946,Meghe Sagar Dattatraya,WARDHA,INC,0,Graduate,340138817,118145553,221993264
1700,2447,Meghraj Tawar,UDAIPUR,CPI,0,10th Pass,1405000,0,1405000
1701,1073,Mehaboobsab Pathan,HAVERI,IND,0,5th Pass,8300000,150000,8150000
1702,879,Mehar Manav Bhagat,JAMMU,Bharatiya Bahujan Party,0,Graduate Professional,32000,0,32000
1703,3927,Mehboob Khan,BHOPAL,IND,0,Graduate,6959000,525000,6434000
1704,3447,Mehmooda Begam Abbasi,JODHPUR,IND,0,Literate,1795520,0,1795520
1705,362,Meira Kumar,SASARAM,INC,0,Post Graduate,384751309,0,384751309
1706,220,Meshram Dnyaneshwar Tukaram,YAVATMAL-WASHIM,IND,0,Graduate,133000,39060,93940
1707,426,Mewa Singh,SIRSA,IND,0,5th Pass,5696200,0,5696200
1708,3211,Mewaram,SHAHJAHANPUR,Naitik Party,0,12th Pass,2116552,0,2116552
1709,3538,Mhamane Anil Subhash,KOLHAPUR,IND,1,Post Graduate,4920000,1282195,3637805
1710,3690,Milindraje Digambar Bhosale,SHIRUR,IND,0,10th Pass,3274,0,3274
1711,2739,Minendra Kumar Singh,PATALIPUTRA,IND,0,Others,1867902,0,1867902
1712,2820,Mirnal Kanti Dev,GIRIDIH,Socialist Party (Lohia),0,12th Pass,331000,0,331000
1713,2130,Mirza Shafee Baig,BIDAR,IND,0,8th Pass,0,0,0
1714,1458,Mirza Vahed Beg Ahmadbeg,BHANDARA-GONDIYA,IND,0,12th Pass,1513581,0,1513581
1715,2746,Misha Bharti,PATALIPUTRA,RJD,1,Graduate Professional,47634901,0,47634901
1716,2503,Miss Patal Kanya Jamatia,TRIPURA EAST,IND,0,Post Graduate,30000,0,30000
1717,1242,Mister Alam Asrafee,CHATRA,Rashtriya Jankranti Morcha,0,Graduate,911000,0,911000
1718,2843,Mithalesh Kumar Mahto,HAZARIBAGH,AAP,1,Doctorate,8251000,0,8251000
1719,3208,Mithilesh Kumar,SHAHJAHANPUR,SP,0,Graduate,28206768,7242790,20963978
1720,531,Mithual Kumar,KALIABOR,AIFB,0,8th Pass,1630000,0,1630000
1721,1982,Mittu Mujavar,NORTH GOA,IND,0,12th Pass,6871000,1121500,5749500
1722,2390,Mo. Hafiz Khan Varasi,JAIPUR,IND,0,8th Pass,75000,0,75000
1723,2437,Mo. Imtiyaz,CHITTORGARH,IND,0,8th Pass,1756000,0,1756000
1724,2842,Mo. Shanul Haque,HAZARIBAGH,IUML,0,12th Pass,194500,0,194500
1725,2846,Mobin Khan,JAMSHEDPUR,IND,0,12th Pass,2865000,117000,2748000
1726,3729,Modi Saifulla,BANGALORE CENTRAL,IND,0,5th Pass,285000,0,285000
1727,1756,Mohamad Adeeb,BIJNOR,Rashtrawadi Samaj Party,0,Post Graduate,26241383,0,26241383
1728,2323,Mohammad Ali Khan,CHURU,Bahujan Sangharshh Dal,0,Literate,3107000,1394000,1713000
1729,3085,Mohammad Aslam,BAREILLY,Peace Party,0,Graduate Professional,720729,0,720729
1730,3008,Mohammad Hanif Qurashi,SAGAR,IND,1,Literate,2850500,0,2850500
1731,1017,Mohammad Jahid Husain,NAWADA,AITC,0,Graduate,1657448,0,1657448
1732,1759,Mohammad Moosa,BIJNOR,Peace Party,0,Graduate,8740204,0,8740204
1733,991,Mohammad Shakeel Saifi,EAST DELHI,BSP,1,Literate,29743591,458360,29285231
1734,21,Mohammed Faizal.P.P,LAKSHADWEEP,NCP,3,Post Graduate,538119,0,538119
1735,1350,Mohammed Naeem,EAST DELHI,IND,1,10th Pass,2314000,59000,2255000
1736,3740,Mohammed Qutbuddin,BANGALORE NORTH,IND,0,10th Pass,465000,0,465000
1737,3755,Mohammed Rafiq,BIDAR,IND,0,5th Pass,50000,0,50000
1738,662,Mohammed Yamin,MUZAFFARNAGAR,AAP,0,10th Pass,13243000,0,13243000
1739,1291,Mohan Kanuga,SOUTH DELHI,JKNPP,0,Post Graduate,7839000,0,7839000
1740,1609,Mohan Lal,KAIRANA,IND,0,12th Pass,9741331,0,9741331
1741,2413,Mohan Lal Mahawar,KOTA,IND,0,12th Pass,9702000,0,9702000
1742,2801,Mohan Lal Patel,MAHASAMUND,Bhartiya Shakti Chetna Party,0,10th Pass,4383500,0,4383500
1743,353,Mohan Marotrao Karemore,NAGPUR,IND,0,10th Pass,6008449,200000,5808449
1744,1059,Mohan Motannavar,CHIKKODI,IND,0,Graduate,1119300,90000,1029300
1745,1825,Mohan Yallappa More,BELGAUM,IND,0,10th Pass,1267950,0,1267950
1746,2585,Mohana Dasari,CHITRADURGA,AAP,0,Graduate,1549000,63538863,0
1747,1958,Mohanan D,ALAPPUZHA,AAP,0,Post Graduate,21114000,600000,20514000
1748,2251,Mohananda Das,KARIMGANJ,IND,0,10th Pass,600000,0,600000
1749,1004,Mohd Arif Siddique,NORTH EAST DELHI,AITC,0,Illiterate,330000,0,330000
1750,3895,Mohd Arshad Malik,UDHAMPUR,JKPDP,0,10th Pass,7042892,0,7042892
1751,3198,Mohd Aslam Urf Pasha,SAMBHAL,RPI(A),0,Literate,6443300,0,6443300
1752,1001,Mohd Hasnan Khan,NORTH EAST DELHI,JKNPP,0,5th Pass,3700000,0,3700000
1753,977,Mohd Mursaleem,CHANDNI CHOWK,Peace Party,0,12th Pass,470700,0,470700
1754,3168,Mohd Naeem Ansari,PILIBHIT,IND,0,Graduate,355000,0,355000
1755,1360,Mohd Naseer,EAST DELHI,Peace Party,0,8th Pass,4398632,0,4398632
1756,1367,Mohd Shahid Siddiqui,EAST DELHI,AITC,0,12th Pass,40044000,2010000,38034000
1757,3118,Mohd Zafar Iqbal,MORADABAD,Akhil Bharatiya Muslim League (Secular),0,Graduate,1725000,0,1725000
1758,882,Mohd. Abbas Khan,JAMMU,IND,0,Graduate Professional,218316,261000,0
1759,1563,Mohd. Adil,JABALPUR,IUML,0,12th Pass,183325,0,183325
1760,751,Mohd. Aftab Alam,JABALPUR,BSP,1,Post Graduate,4282755,14000000,0
1761,945,Mohd. Alim Patel Mohd. Wahid,WARDHA,AAP,0,Post Graduate,2882200,0,2882200
1762,1750,Mohd. Firoz Aftab,SAHARANPUR,IND,1,Graduate Professional,6305818,0,6305818
1763,1371,Mohd. Hasnain,NORTH EAST DELHI,IND,2,10th Pass,30000,0,30000
1764,885,Mohd. Imtiaz,JAMMU,IND,0,Graduate,0,0,0
1765,1551,Mohd. Jahangeer Ansari,SIDHI,IND,0,Not Given,56300,0,56300
1766,3054,Mohd. Jarrar,AONLA,Bhartiya Naujawan Inklav Party,0,8th Pass,5305000,0,5305000
1767,1439,Mohd. Javed Mohd Mustak,NAGPUR,Democratic Secular Party,0,12th Pass,160500,250000,0
1768,3321,Mohd. Maroof Ab. Rauf,NANDED,IND,0,12th Pass,568655,112000,456655
1769,1276,Mohd. Mukim,FARIDABAD,National Loktantrik Party,0,10th Pass,3999000,80000,3919000
1770,1717,Mohd. Sabir Ansari,GAUTAM BUDHHA NAGAR,AITC,0,5th Pass,681600,0,681600
1771,1801,Mohd. Sabir Rahi,ALIGARH,AAP,0,10th Pass,15227199,0,15227199
1772,1632,Mohd. Sajid Saifi,MEERUT,Bahujan Mukti Party,1,5th Pass,341178,0,341178
1773,1621,Mohd. Yamin,MUZAFFARNAGAR,All India Ravidas Samata Party,0,Illiterate,12000,0,12000
1774,1633,Mohd.Usman Ghazi,MEERUT,Rashtriya Apna Dal,0,12th Pass,1005000,0,1005000
1775,3565,Mohite Patil Vijaysinh Shankarrao,MADHA,NCP,1,10th Pass,170253390,9774791,160478599
1776,3994,Mohite-Patil Pratapsinh Shankarrao,MADHA,IND,1,Graduate,262989287,23367636,239621651
1777,3478,Moirangthem Nara,INNER MANIPUR,CPI,0,Graduate Professional,1867499,2785815,0
1778,2658,Mokaram Hussain,BUXAR,Suheldev Bhartiya Samaj Party,0,10th Pass,2115487,0,2115487
1779,504,Moni Kumar Subba,TEZPUR,IND,2,8th Pass,3067535137,1400740132,1666795005
1780,2667,Monibur Rahman,BUXAR,Janta Dal Rashtravadi,0,12th Pass,3130000,0,3130000
1781,3436,Moola Ram,JALORE,IND,0,10th Pass,5430617,0,5430617
1782,2604,Moose Kunhi,DAKSHINA KANNADA,BSP,0,5th Pass,667631,152465,515166
1783,1636,Morarji Nagma Arvind,MEERUT,INC,0,Graduate,117912089,2978643,114933446
1784,1469,Moreshwar Ramaji Meshram,BHANDARA-GONDIYA,IND,0,Graduate,15858255,695510,15162745
1785,3907,Moti Lal Sahu S/O Bajaraha Ram Sahu,MAHASAMUND,IND,0,12th Pass,7759000,0,7759000
1786,4065,Moti Lal Sahu S/O Sone Lal Sahu,MAHASAMUND,IND,0,8th Pass,1354000,0,1354000
1787,75,Mrinal Kumar Saikia,KALIABOR,BJP,0,Post Graduate,3360000,50000,3310000
1788,186,Mu.Venkatesh Simha Bhovi,BANGALORE NORTH,IND,0,Not Given,9945000,0,9945000
1789,581,Muhammed Hamdullah Sayeed,LAKSHADWEEP,INC,0,Graduate Professional,40192946,358156,39834790
1790,1870,Muhammed Riyas,KOZHIKODE,IND,0,10th Pass,441500,0,441500
1791,709,Muhammed Sharafudheen,IDUKKI,SDPI,0,Graduate,415000,280000,135000
1792,1603,Mukesh Babu Ahirwar,HOSHANGABAD,IND,0,10th Pass,1260000,0,1260000
1793,228,Mukesh Kumar,MEERUT,IND,0,Graduate Professional,2150500,1200000,950500
1794,999,Mukesh Kumar Arora,NORTH EAST DELHI,IND,0,Graduate,13688864,3970000,9718864
1795,2908,Mukesh Kumar Bansal,BHOPAL,Samta Vikas Party,0,10th Pass,36300,0,36300
1796,2096,Mukesh Kumar Singh,FARIDABAD,IND,0,12th Pass,1928506,0,1928506
1797,2755,Mukul Kumar Sharma,PATALIPUTRA,Sankhyanupati Bhagidari Party,1,10th Pass,2212400,0,2212400
1798,3414,Mukul Mishra,AJMER,Akhil Bharat Hindu Mahasabha,0,12th Pass,51000,0,51000
1799,229,Mukul Upadhyay,GHAZIABAD,BSP,0,10th Pass,167355710,18751971,148603739
1800,936,Mukul Wasnik,RAMTEK,INC,2,Post Graduate,16119417,0,16119417
1801,94,Mul Chand,GURGAON,IND,0,10th Pass,33392000,750000,32642000
1802,3460,Mularam,NAGAUR,IND,0,Literate,3470000,0,3470000
1803,260,Mullappally Ramachandran,VADAKARA,INC,0,Post Graduate,9225000,2160000,7065000
1804,3849,Munde Gopinathrao Pandurang,BEED,BJP,3,Graduate Professional,380072890,335729817,44343073
1805,3160,Munesh Singh,PILIBHIT,IND,0,8th Pass,5279115,0,5279115
1806,2382,Munna Dass Dabodia,JAIPUR,IND,0,12th Pass,3312954,60000,3252954
1807,2709,Munna Prasad,NALANDA,IND,0,10th Pass,350000,0,350000
1808,3466,Munni,PALI,INC,0,10th Pass,17225722,1297049,15928673
1809,3067,Munshi Lal,BADAUN,IND,0,12th Pass,832251,50000,782251
1810,3911,Murad Bhai,RAJNANDGAON,IND,0,10th Pass,12400000,120000,12280000
1811,975,Musarrat Jahan,CHANDNI CHOWK,Rashtriya Janmorcha,0,Graduate,3119753,0,3119753
1812,272,Musthafa Kommeri,KOZHIKODE,SDPI,1,Graduate,1489200,0,1489200
1813,2627,Muthuraju,BANGALORE NORTH,RPI(A),0,Graduate,4655000,700000,3955000
1814,2104,Muttappa Channasangappa Angadi,BELGAUM,AAP,0,12th Pass,9470924,1524180,7946744
1815,3721,Muttappa Hirekumbi,BAGALKOT,IND,0,Literate,2887000,500000,2387000
1816,933,Muttemwar Vilasrao Baburao,NAGPUR,INC,0,Graduate,26382690,3569251,22813439
1817,2699,Muzaffar Fakhruddin,MUNGER,IND,0,Graduate,1883100,0,1883100
1818,1812,N Abdulla Davud,KANNUR,BSP,0,10th Pass,3226369,50000,3176369
1819,1188,N B Krishnappa Nayaka,BELLARY,IND,0,Graduate Professional,169500,0,169500
1820,303,N J Pious,ERNAKULAM,IND,0,Graduate,3722750,150000,3572750
1821,470,N K P Nair,ANDAMAN & NICOBAR ISLANDS,CPI(ML)L,0,10th Pass,5287805,43642,5244163
1822,902,N Kannan,ANDAMAN & NICOBAR ISLANDS,IND,0,8th Pass,32400,549313,0
1823,1189,N R Mallaiah Swamy,BELLARY,IND,0,12th Pass,1333000,0,1333000
1824,333,N Sadanandan,MAVELIKKARA,AAP,0,Graduate Professional,4309529,0,4309529
1825,2161,N Y Hanumantappa,BELLARY,INC,0,Post Graduate,22848300,0,22848300
1826,2561,N.C.Puttaraju,MANDYA,IND,0,12th Pass,200000,0,200000
1827,361,N.Dharam Singh,BIDAR,INC,1,Post Graduate,236308464,53289216,183019248
1828,10,N.K.Biju,KOTTAYAM,SUCI(C),0,12th Pass,750,0,750
1829,14,N.K.Premachandran,KOLLAM,Revolutionary Socialist Party,1,Graduate Professional,16228989,3114638,13114351
1830,2586,N.S. Manjunatha Nerenahal,CHITRADURGA,IND,0,10th Pass,450000,0,450000
1831,3787,N.Venkatesh,KOLAR,IND,0,10th Pass,6744000,1000000,5744000
1832,1148,Naba Krushna Danta,BOLANGIR,IND,0,Graduate Professional,482285,606700,0
1833,3258,Nabin Kumar Dalai,JAJPUR,IND,0,Graduate,307000,0,307000
1834,3855,Nadu Madhav,BEED,AAP,0,Graduate Professional,76855663,875946,75979717
1835,3122,Nafisuddin,MORADABAD,CPI(M),0,8th Pass,9951294,400000,9551294
1836,3575,Nagamani Kisan Jakkan,MADHA,IND,0,5th Pass,1165000,0,1165000
1837,2150,Naganath Patil,BIDAR,IND,0,Graduate,510000,0,510000
1838,3806,Nagappa Karatagi,KOPPAL,IND,0,Graduate,5205986,495000,4710986
1839,1830,Nagappa Shiraguppi,BAGALKOT,IND,0,Literate,45403,0,45403
1840,1068,Nagaraj,RAICHUR,CPI(ML) Red star,0,12th Pass,901500,114611,786889
1841,1082,Nagarajappa,DAVANAGERE,IND,0,Illiterate,15000,0,15000
1842,2756,Nagendra Kumar,PATALIPUTRA,Bharat Vikas Morcha,0,Graduate,1166489,0,1166489
1843,796,Nagendra Kumar Pradhan,SAMBALPUR,BJD,0,Post Graduate,12796623,1461565,11335058
1844,2962,Nagendra Singh,KHAJURAHO,BJP,0,Graduate,44538002,0,44538002
1845,1236,Nagmani,CHATRA,AJSUP,1,12th Pass,87315758,0,87315758
1846,653,Nahid Hasan,KAIRANA,SP,2,Graduate,30399449,2105000,28294449
1847,1078,Naik Santosh Omu,UTTARA KANNADA,BSP,0,Post Graduate,2577000,1230000,1347000
1848,3524,Naikwade Digambar Gunaji,HINGOLI,IND,0,5th Pass,100000,0,100000
1849,582,Najmudheen.C.T,LAKSHADWEEP,CPI,7,Graduate,322000,0,322000
1850,646,Najrul Hassan Hashmi,KODARMA,AJSUP,0,Literate,1800614,0,1800614
1851,2494,Nakul Das Rai,SIKKIM,AITC,0,Graduate,22091161,115000,21976161
1852,1221,Nalin Kumar Katil,DAKSHINA KANNADA,BJP,1,10th Pass,8789001,1493367,7295634
1853,691,Namdeo Anandrao Kannake,GADCHIROLI-CHIMUR,CPI,0,Graduate,3322000,400000,2922000
1854,540,Namdeo Pundlik Dongardive,BULDHANA,IND,1,Graduate Professional,17500,0,17500
1855,923,Namdeo Shedmake,CHANDRAPUR,IND,1,10th Pass,1074059,425000,649059
1856,3379,Nana Kshirsagar,PUNE,Bharipa Bahujan Mahasangh,0,Post Graduate,88792,0,88792
1857,917,Nanabhau Falgunrao Patole,BHANDARA-GONDIYA,BJP,5,12th Pass,12738190,0,12738190
1858,3201,Nanad Ram Khharagwansi,SAMBHAL,IND,0,Literate,7605000,0,7605000
1859,2094,Nanak Chand,FARIDABAD,IND,0,10th Pass,512000,0,512000
1860,3365,Nanaware Pramod Mahadeo,MAVAL,IND,0,Graduate,365491,0,365491
1861,2765,Nand Kishore Singh,PATNA SAHIB,IND,0,Graduate Professional,21239370,654750,20584620
1862,2942,Nand Kishore Tyagi,GUNA,IND,0,8th Pass,171000,0,171000
1863,368,Nand Lal Ram,SASARAM,IND,0,8th Pass,688000,0,688000
1864,1582,Nand Lal Uikey,BALAGHAT,Chhattisgarh Swabhiman Manch,0,Post Graduate,8000,0,8000
1865,611,Nandan Nilekani,BANGALORE SOUTH,INC,0,Graduate Professional,77102957219,0,77102957219
1866,3738,Nandini Alva,BANGALORE CENTRAL,JD(S),3,Graduate,807875641,37846084,770029557
1867,1483,Nandkishor Gangaram Rangari,CHANDRAPUR,Aambedkar-right Party of India,0,Post Graduate,4111000,1580000,2531000
1868,3770,Nanjappa,CHIKKBALLAPUR,IND,0,5th Pass,6350000,0,6350000
1869,2492,Nar Bahadur Khatiwara,SIKKIM,BJP,0,Graduate Professional,41384503,0,41384503
1870,3419,Narain Das Sindhi,AJMER,IND,0,12th Pass,402000,0,402000
1871,3247,Narayan Chandra Jena,BHADRAK,AAP,1,Graduate,2066000,0,2066000
1872,3536,Narayan Gundu Powar,KOLHAPUR,AAP,6,12th Pass,3352800,1120000,2232800
1873,3431,Narayan Lal,JALORE,IND,0,8th Pass,115000,0,115000
1874,2354,Narayan Lal Parihar,JAIPUR RURAL,Bharat Nav Nirman Party,0,8th Pass,1567700,253370,1314330
1875,135,Narayan Singh,RAJGARH,INC,4,12th Pass,13622052,1709097,11912955
1876,4079,Narayan Singh Kushwah,GWALIOR,IND,0,12th Pass,338425,0,338425
1877,3794,Narayanaswamy,KOLAR,IND,0,Literate,401390,0,401390
1878,2939,Narayanrao Gupchup,GUNA,IND,0,8th Pass,4055500,0,4055500
1879,2681,Narendar Kumar,JAHANABAD,SHS,0,Graduate,311800,0,311800
1880,2018,Narender,HISAR,IND,1,10th Pass,30260500,700000,29560500
1881,2067,Narender Pichopa-Khurd,BHIWANI-MAHENDRAGARH,IND,0,12th Pass,300000,0,300000
1882,2807,Narendra Bansod,RAJNANDGAON,Ambedkarite Party of India,0,Graduate Professional,1590000,0,1590000
1883,675,Narendra Bhati,GAUTAM BUDHHA NAGAR,SP,0,12th Pass,53617561,0,53617561
1884,2501,Narendra Chandra Deb Barma,TRIPURA EAST,Indigenous Peoples Front of Tripura,0,Graduate,11365500,0,11365500
1885,1406,Narendra Chinduji Meshram,WARDHA,GGP,0,5th Pass,4121000,20000,4101000
1886,971,Narendra Kr Pandey,CHANDNI CHOWK,BSP,0,12th Pass,48980150,3166282,45813868
1887,821,Narendra Mohanty,KANDHAMAL,AAP,9,Post Graduate,1217466,287074,930392
1888,2650,Narendra Pratap Singh,BUXAR,IND,0,Post Graduate,7294224,0,7294224
1889,26,Narendra Sharma,NORTH EAST DELHI,SUCI(C),0,Post Graduate,112772737,0,112772737
1890,1343,Narendra Singh Rawat,NEW DELHI,IND,0,12th Pass,79000,0,79000
1891,2957,Narendra Singh Tomar,GWALIOR,BJP,1,Graduate,11412622,4531444,6881178
1892,433,Naresh Batra,HISAR,IND,0,10th Pass,38729000,0,38729000
1893,3039,Naresh Chand,AMROHA,IND,0,10th Pass,11068000,0,11068000
1894,1684,Naresh Gautam,GHAZIABAD,Bahujan Mukti Party,0,Graduate,3660000,0,3660000
1895,1288,Naresh Kumar,SOUTH DELHI,IND,0,Illiterate,143186,0,143186
1896,2060,Naresh Kumar,BHIWANI-MAHENDRAGARH,SP,0,Not Given,2992100,0,2992100
1897,3040,Naresh Kumar,AMROHA,IND,0,Post Graduate,2145327,0,2145327
1898,1425,Naresh Mahadeo Patil,RAMTEK,Bahujan Mukti Party,0,Doctorate,3845000,312000,3533000
1899,1516,Naresh Mahadeorao Gughane,YAVATMAL-WASHIM,IND,0,8th Pass,65000,0,65000
1900,2715,Naresh Prasad Singh,NALANDA,IND,0,Graduate,11387000,2599000,8788000
1901,3053,Naresh Singh Solanki,AONLA,AAP,0,Graduate,32537903,8782000,23755903
1902,2017,Narinder Kumar,HISAR,IND,0,Others,8931000,600000,8331000
1903,3430,Naringa Ram Yadav,JALORE,IND,0,Post Graduate,8840490,0,8840490
1904,3355,Narwekar Rahul Suresh,MAVAL,NCP,0,Graduate Professional,100454484,13436552,87017932
1905,1615,Naseem Ahmad Ansari,MUZAFFARNAGAR,IND,0,Literate,126110,0,126110
1906,3177,Naseer Ahmad Khan,RAMPUR,SP,0,Post Graduate,36512409,0,36512409
1907,509,Nasir Ahmed,JORHAT,AIUDF,0,Graduate,1830000,0,1830000
1908,2105,Nasir Papulsab Bagwan,BELGAUM,JD(S),0,12th Pass,962297866,95826301,866471565
1909,1145,Nathu Ram,SAMBALPUR,BSP,0,Graduate,6538687,0,6538687
1910,2310,Natthi Lal Sharma,ALIGARH,IND,0,Graduate,9794000,0,9794000
1911,1243,Naushad Alam,CHATRA,AITC,0,Graduate,4839400,0,4839400
1912,513,Navajyoti Kalita,DIBRUGARH,AITC,0,10th Pass,25004000,32650000,0
1913,3566,Navanath Bhimrao Patil,MADHA,Hindusthan Praja Paksha,1,Graduate,1102500,160000,942500
1914,3186,Naved Mian,RAMPUR,IND,0,Not Given,95000,0,95000
1915,1321,Naveen Chandra,NEW DELHI,Naya Daur Party,0,Graduate,4565000,0,4565000
1916,451,Naveen Jaihind,ROHTAK,AAP,1,Doctorate,340057,0,340057
1917,754,Naveen Jain,JABALPUR,IND,0,Graduate,11687096,50000,11637096
1918,631,Naveen Jindal,KURUKSHETRA,INC,2,Post Graduate,3083154000,49114000,3034040000
1919,4026,Naveen Murmu,SINGHBHUM,Rashtriya Deshaj Party,0,12th Pass,590500,0,590500
1920,2367,Navin Pilania,JAIPUR RURAL,National Peoples Party,0,Graduate Professional,117822738,18022060,99800678
1921,3603,Navnath Dashrath Uplekar,OSMANABAD,IND,0,10th Pass,160000,0,160000
1922,216,Navneet Ravi Rana,AMRAVATI,NCP,3,10th Pass,29496562,1858727,27637835
1923,3179,Nawab Kazim Ali Khan,RAMPUR,INC,0,Post Graduate,571146438,7745000,563401438
1924,1256,Nawal Kishor Singh,LOHARDAGA,IND,0,10th Pass,1733000,0,1733000
1925,2720,Nayeb Ali,NALANDA,AITC,0,Doctorate,1896783,0,1896783
1926,3900,Nazakat Hussain,UDHAMPUR,IND,0,Post Graduate,500000,0,500000
1927,1872,Nazarudheen,MALAPPURAM,SDPI,5,10th Pass,1855691,750000,1105691
1928,3803,Nazeer Hussain,KOPPAL,Rashtriya Krantikari Samajwadi Party,0,10th Pass,582000,0,582000
1929,4077,Neelam Agrwal,GWALIOR,AAP,0,12th Pass,3461200,700000,2761200
1930,3010,Neeraj,TIKAMGARH,CPI,0,8th Pass,461000,0,461000
1931,2385,Neeru Agarwal,JAIPUR,National Unionist Zamindara Party,0,Post Graduate,2665000,0,2665000
1932,2458,Neeru Ram,RAJSAMAND,BSP,0,10th Pass,6866060,90000,6776060
1933,2867,Neil Tirkey,KHUNTI,AJSUP,1,Graduate,23771799,8400000,15371799
1934,407,Neiphiu Rio,NAGALAND,NPF,0,Graduate,315834264,0,315834264
1935,3455,Nemichand,NAGAUR,AARAKSHAN VIRODHI PARTY,0,10th Pass,246000,0,246000
1936,3102,Net Ram,BAREILLY,IND,0,Literate,6525004,0,6525004
1937,3253,Netrananda Mallick,BHADRAK,Aama Odisha Party,0,Graduate,1710000,0,1710000
1938,2281,Nihalchand,GANGANAGAR,BJP,0,Graduate,10861172,1611557,9249615
1939,3685,Nikam Devdatta Jaywant,SHIRUR,NCP,3,Graduate,7277063,296000,6981063
1940,3395,Nikam Sopanrao Pandharinath,SHIRUR,AAP,0,Post Graduate,35506712,300000,35206712
1941,372,Nikhil Kumar,AURANGABAD,INC,0,Post Graduate,297302441,0,297302441
1942,1323,Nikhil Sablania,NEW DELHI,IND,0,Graduate Professional,38000,0,38000
1943,1227,Nilam Devi,CHATRA,JVM,0,5th Pass,9780527,1048964,8731563
1944,3631,Nilesh Dhanave,PUNE,IND,0,Post Graduate,14136754,1950000,12186754
1945,1429,Nilesh Mahadeo Dhoke,RAMTEK,IND,0,8th Pass,0,0,0
1946,3641,Nilesh Narayan Rane,RATNAGIRI SINDHUDURG,INC,2,Doctorate,136811633,49129849,87681784
1947,3689,Nilesh Yashwant Mhaskule,SHIRUR,IND,0,12th Pass,819858,210000,609858
1948,3164,Nilima Sharma,PILIBHIT,Peace Party,0,Doctorate,5595570,20000,5575570
1949,2268,Nilu Mandol,SILCHAR,SHS,0,8th Pass,283000,0,283000
1950,2572,Nilufar Jamani,TUMKUR,BSP,0,Graduate,740837798,0,740837798
1951,1796,Nima Lama,DARJEELING,Gorkha Rashtriya Congress,0,Graduate,7664167,155997,7508170
1952,1096,Nina P Nayak,BANGALORE SOUTH,AAP,0,Post Graduate,35129117,1000000,34129117
1953,406,Ninong Ering,ARUNACHAL EAST,INC,0,Graduate,88065000,0,88065000
1954,3339,Nirada Barana Khuntia,PURI,AAP,0,Not Given,5004386,0,5004386
1955,2748,Niraj Kumar,PATALIPUTRA,IND,0,Graduate,51500,0,51500
1956,2722,Niraj Sharma,NALANDA,Rajnaitik Vikalp Party,0,Literate,11399238,0,11399238
1957,156,Niranjan Kumar,GAYA,CPI(ML)L,2,Graduate,140000,1384,138616
1958,3300,Niranjan Saha,DARJEELING,Amra Bangalee,0,Graduate Professional,1825400,0,1825400
1959,3274,Nirmal Samal,DHENKANAL,IND,0,8th Pass,740000,0,740000
1960,578,Nirmal Singh,JAMMU,IND,0,Graduate,30496000,904000,29592000
1961,1279,Nirmala,FARIDABAD,JD(U),0,Illiterate,2914700,0,2914700
1962,3761,Nirmala Kumari,CHAMARAJANAGAR,IND,0,Post Graduate,295000,0,295000
1963,2852,Niroop Mahanty,JAMSHEDPUR,JMM,0,Post Graduate,191088713,0,191088713
1964,2260,Nirupam Mandal,SILCHAR,IND,0,Graduate Professional,25500,0,25500
1965,3342,Nisar Subhan Khan Pathan,PARBHANI,IND,1,12th Pass,3100000,165000,2935000
1966,1660,Nishant Tyagi,BAGHPAT,IND,0,12th Pass,1147000,0,1147000
1967,2872,Nitima Bodra Bari,KHUNTI,SP,0,Graduate,6237543,0,6237543
1968,1678,Nitin,GHAZIABAD,IND,0,10th Pass,1000,0,1000
1969,3652,Nitin Ganpatrao Savgave,SANGLI,Bahujan Mukti Party,0,Doctorate,17149503,2630000,14519503
1970,3406,Nitin Navnath Udmale,SHIRDI,AAP,0,Graduate,3756000,1692146,2063854
1971,1485,Nitin Vasant Pohane,CHANDRAPUR,Lok Bharati,0,Graduate,8529000,2255000,6274000
1972,770,Nitinkumar Sahu,CHHINDWARA,BSP,2,10th Pass,585000,150000,435000
1973,2688,Nityanand Singh,JAHANABAD,IND,2,Literate,1392245,2000000,0
1974,306,Noble Mathew,KOTTAYAM,IND,0,Post Graduate,55079708,50000,55029708
1975,310,Nripendra Narayan Singha Karjee,COOCHBEHAR,SUCI(C),1,12th Pass,368300,0,368300
1976,3197,Nutan Vijay,SAMBHAL,IND,0,Post Graduate,80200000,0,80200000
1977,348,O M Jyotheendra Nath,THIRUVANANTHAPURAM,IND,0,Graduate,5620000,130000,5490000
1978,346,O Rajagopal,THIRUVANANTHAPURAM,BJP,0,Graduate Professional,1211046,0,1211046
1979,634,O V Sreedath,THIRUVANANTHAPURAM,Socialist Republican Party,4,Graduate,33965814,0,33965814
1980,3482,Oinam Jotin Singh,INNER MANIPUR,Jai Maha Bharath Party,0,Graduate,336000,0,336000
1981,2199,Olwin Mariyan Lopis,UTTARA KANNADA,Bahujan Mukti Party,0,10th Pass,398845,0,398845
1982,2409,Om Birla,KOTA,BJP,2,Post Graduate,25870497,997366,24873131
1983,1005,Om Dutt Sharma,NORTH EAST DELHI,SHS,2,12th Pass,197000,0,197000
1984,2297,Om Parkash,GANGANAGAR,IND,0,Literate,350600,0,350600
1985,2006,Om Parkash,HISAR,Bharatiya Sant Mat Party,0,10th Pass,2024000,0,2024000
1986,1045,Om Prakash Dhankhad,ROHTAK,BJP,1,Post Graduate,10587916,0,10587916
1987,2331,Om Prakash Jharoda,JHUNJHUNU,CPI(ML)L,3,10th Pass,230500,0,230500
1988,3472,Om Prakash Mali,PALI,IND,0,5th Pass,166500,0,166500
1989,3153,Om Prakash Ravi,NAGINA,SHS,0,8th Pass,468848,0,468848
1990,1289,Ombir,SOUTH DELHI,Bharatiya Bahujan Party,0,12th Pass,732000,0,732000
1991,868,Ombir,BHIWANI-MAHENDRAGARH,Lok Parivartan Party(DC),0,10th Pass,1040000,0,1040000
1992,2083,Ombir Sharma,GURGAON,IND,0,10th Pass,5496500,0,5496500
1993,756,Omkar Singh Markam,MANDLA,INC,0,Post Graduate,9618675,0,9618675
1994,1355,Ompal Singh,EAST DELHI,Kalyankari Jantantrik Party,0,Graduate,9063978,550000,8513978
1995,3063,Omveer,AONLA,Bhartiya Vikas Party,0,Literate,211000,0,211000
1996,1027,Onkar Singh,KURUKSHETRA,National Janhit Congress (AB),0,Literate,13440157,673667,12766490
1997,3423,Otaram,JALORE,BSP,0,Graduate,26365198,1604589,24760609
1998,289,P C Chacko,CHALAKUDY,INC,0,Post Graduate,28000209,2063744,25936465
1999,168,P C Mohanan Master,KANNUR,BJP,2,12th Pass,12859808,739740,12120068
2000,1955,P C Venugopal,ALAPPUZHA,IND,0,Post Graduate,309510,158235,151275
2001,1807,P K Raman,KASARAGOD,IND,2,10th Pass,616200,0,616200
2002,255,P K Sreemathi,KANNUR,CPI(M),8,Others,16939970,0,16939970
2003,251,P Karunakaran,KASARAGOD,CPI(M),6,Post Graduate,5900345,0,5900345
2004,1223,P Muniraju,BANGALORE RURAL,BJP,0,12th Pass,505854419,76201010,429653409
2005,256,P P Aboobacker,KANNUR,CPI(ML) Red star,0,10th Pass,1375736,0,1375736
2006,3464,P P Choudhary,PALI,BJP,0,Graduate Professional,353503467,7892216,345611251
2007,1808,P P Mohanan,KANNUR,IND,0,12th Pass,13953502,0,13953502
2008,266,P R Rasmilnath,WAYANAD,BJP,0,Graduate,1445000,100000,1345000
2009,325,P V Natesan,ALAPPUZHA,BSP,0,Graduate,3219698,0,3219698
2010,845,P Y Hemanth Kumar,DHARWAD,AAP,0,12th Pass,62688810,0,62688810
2011,264,P.Abdul Hameed Master,VADAKARA,SDPI,1,Graduate,4988654,0,4988654
2012,1218,P.C. Gaddigoudar,BAGALKOT,BJP,0,Graduate Professional,36362500,9589199,26773301
2013,187,P.C. Mohan,BANGALORE CENTRAL,BJP,2,12th Pass,475796999,261111285,214685714
2014,707,P.C.Jolly,IDUKKI,IND,0,12th Pass,16991308,5500000,11491308
2015,721,P.D. Chandrabhanu,ERNAKULAM,Socialist Republican Party,0,10th Pass,8306000,884000,7422000
2016,1900,P.K.Biju,ALATHUR,CPI(M),0,Post Graduate,3231047,341749,2889298
2017,1843,P.Kumarankutty,VADAKARA,IND,0,Graduate Professional,44347759,0,44347759
2018,335,P.M. Velayudhan,KOLLAM,BJP,0,10th Pass,5927000,750000,5177000
2019,234,Paban Singh Ghatowar,DIBRUGARH,INC,0,Graduate,49229437,2547986,46681451
2020,1349,Padam Chand,EAST DELHI,IND,0,10th Pass,2670000,0,2670000
2021,2049,Padam Singh,SONIPAT,IND,0,12th Pass,11672304,0,11672304
2022,443,Padam Singh,SONIPAT,INLD,0,Graduate Professional,30051128,466311,29584817
2023,1333,Padmaja Kandukuri,NEW DELHI,IND,0,Not Given,2367592,180000,2187592
2024,3559,Padmakar Kondiba Ovhal,LATUR,IND,0,Literate,500,0,500
2025,2552,Padmamma M V,MYSORE,AAP,0,Graduate,11627675,478620,11149055
2026,268,Padmanabhan .C.K.,KOZHIKODE,BJP,0,10th Pass,9306000,400000,8906000
2027,3604,Padmsinh Vijaysinh Mundhe,OSMANABAD,IND,0,12th Pass,1080000,188000,892000
2028,3844,Paglanand,BADAUN,Mahan Dal,0,10th Pass,1795492,0,1795492
2029,2285,Pala Ram,GANGANAGAR,CPI(M),0,Literate,750500,0,750500
2030,2032,Pale Ram Kashyap,KARNAL,Rashtriya Janshakti Party(Eklavya),0,10th Pass,731148,0,731148
2031,2481,Pallickal Surendran,MAVELIKKARA,IND,0,10th Pass,410278,0,410278
2032,2280,Paluskar Krishnarao Tatoba,GANGANAGAR,Prabuddha Republican Party,0,Post Graduate,3461100,1500000,1961100
2033,2741,Pancham Lal,PATALIPUTRA,IND,0,Graduate,29991521,0,29991521
2034,3670,Pandurang Ramchandra Shinde,SATARA,IND,2,Post Graduate,52408590,1700753,50707837
2035,3543,Pandurang Tukaram Chougale,KOLHAPUR,IND,0,8th Pass,2522000,0,2522000
2036,660,Pankaj Agarwal,MUZAFFARNAGAR,INC,0,Graduate,242260053,27148000,215112053
2037,2536,Pankaj Prafulkumar Bhansali,NAGPUR,IND,0,12th Pass,20684589,0,20684589
2038,51,Pankaj Sewakram Masurkar,RAMTEK,Hindustan Janta Party,0,10th Pass,30000,0,30000
2039,742,Pankaj Singh Patel,SIDHI,AAP,0,Post Graduate,144766,0,144766
2040,922,Pankajkumar Sharma,CHANDRAPUR,AITC,0,Graduate,9757822,450000,9307822
2041,810,Parameswar Kand,KALAHANDI,Samata Kranti Dal,1,12th Pass,2270000,100000,2170000
2042,1050,Paramjit Singh,KARNAL,AAP,0,Graduate,2863613,1382819,1480794
2043,1824,Parappa Shankareppa Antakkanavar,BELGAUM,IND,1,Graduate Professional,12751189,1053795,11697394
2044,1061,Parashuram Rathod,BAGALKOT,IND,0,12th Pass,776342,84800,691542
2045,2204,Parasuram S,DAVANAGERE,CPI(ML)L,0,Literate,271500,125000,146500
2046,768,Pardaeshi Lal Uikey,CHHINDWARA,GGP,0,12th Pass,864500,0,864500
2047,2068,Pardeep Singh Tanwar,BHIWANI-MAHENDRAGARH,IND,0,Graduate,17720045,225000,17495045
2048,1607,Pardip,KAIRANA,Bahujan Mukti Party,0,12th Pass,871000,0,871000
2049,623,Parmendra Kumar Yadav,NAWADA,Bharatiya Ekta Dal,0,12th Pass,1030800,0,1030800
2050,1383,Parmeshwar Hiraman Gawai,BULDHANA,Ambedkarist Republican Party,0,12th Pass,8810000,60000,8750000
2051,748,Parmeshwar Singh,SHAHDOL,CPI,0,5th Pass,515000,200000,315000
2052,2712,Parnav Prakash,NALANDA,AAP,0,Graduate Professional,58483543,16000000,42483543
2053,818,Parsuram Majhi,NABARANGPUR,BJP,0,Graduate,8274821,61600,8213221
2054,524,Partha Karmakar,TRIPURA WEST,CPI(ML)L,0,Graduate,5540194,0,5540194
2055,2762,Parveen Amanullah,PATNA SAHIB,AAP,0,Graduate,34292500,0,34292500
2056,70,Parvesh Sahib Singh,WEST DELHI,BJP,1,Post Graduate,107235461,26650000,80585461
2057,1762,Parvez Aqil,BIJNOR,All India Minorities Front,0,Graduate,104992,0,104992
2058,2776,Parwez Ahmad,PATNA SAHIB,Loktantrik Janata Party (Secular),0,Graduate,88692,0,88692
2059,314,Patel Hidayat Ulla Barkat Ulla,AKOLA,INC,1,12th Pass,12476287,202500,12273787
2060,919,Patel Praful Manoharbhai,BHANDARA-GONDIYA,NCP,0,Graduate,1959685779,40000000,1919685779
2061,2798,Patel Shri Dhar Chandrakar,MAHASAMUND,Apna Dal,1,Post Graduate,24903805,1378101,23525704
2062,3318,Pathan Jafar Ali Kha Md. Ali Kha,NANDED,IND,0,12th Pass,3642000,0,3642000
2063,3542,Patil Bajrang Krishna,KOLHAPUR,IND,0,10th Pass,352142,0,352142
2064,3605,Patil Manohar Anandrao,OSMANABAD,IND,0,12th Pass,215000,0,215000
2065,3606,Patil Padmasinha Bajirao,OSMANABAD,NCP,6,Graduate Professional,131918437,10174735,121743702
2066,3656,Patil Pratik Prakashbapu,SANGLI,INC,0,10th Pass,52543606,8891772,43651834
2067,3505,Patil S R Tatya,HATKANANGLE,IND,0,Graduate Professional,3500000,200000,3300000
2068,1506,Patil Upendra Babarao,YAVATMAL-WASHIM,IND,0,Graduate Professional,3675000,315000,3360000
2069,1459,Patle Anjali Agastikumar,BHANDARA-GONDIYA,Bharipa Bhahujan Mahasangha,0,Post Graduate,1679100,2425000,0
2070,1780,Paul Dexion Khariya,ALIPURDUARS,IND,0,Graduate,406000,0,406000
2071,119,Paul Lyngdoh,SHILLONG,UDP,0,Post Graduate,17371929,0,17371929
2072,30,Pawan Kumar Bansal,CHANDIGARH,INC,0,Graduate Professional,77478000,0,77478000
2073,895,Pawan Kumar Sharma,CHANDIGARH,IND,0,12th Pass,9196223,720000,8476223
2074,2373,Pawan Singh Shekhawat,JAIPUR,IND,1,10th Pass,418893,154152,264741
2075,3301,Pawar (Patil) Digambar Bapuji,NANDED,BJP,0,12th Pass,43054709,1538191,41516518
2076,3407,Pawar Vijay Banderao,SHIRDI,The Lok Party of India,0,10th Pass,110000,0,110000
2077,3700,Pawar Yuvraj Sidram,SOLAPUR,IND,0,Graduate,45000,0,45000
2078,1961,Peelipose,PATHANAMTHITTA,IND,0,8th Pass,100205,0,100205
2079,2917,Peeyush Soni,BHOPAL,IND,0,12th Pass,639500,550,638950
2080,884,Perseen Singh,JAMMU,IND,0,12th Pass,205959,0,205959
2081,3487,Petras Kisan Gaware,AHMEDNAGAR,IND,2,Illiterate,366073,20000,346073
2082,644,Phaljit Mahto,KODARMA,IND,0,Illiterate,995000,15000,980000
2083,411,Phool Chand,AMBALA,IND,0,8th Pass,3750000,0,3750000
2084,1574,Phool Singh Dhurwey,MANDLA,Chhattisgarh Swabhiman Manch,3,Graduate,2820609,20000,2800609
2085,1624,Phool Singh Pal,MUZAFFARNAGAR,IND,0,12th Pass,17502382,0,17502382
2086,747,Phool Singh Paraste,SHAHDOL,BSP,2,Post Graduate,5694356,120000,5574356
2087,2896,Phoolsingh Baraiya,BHIND,Bahujan Sangharshh Dal,0,Graduate Professional,21329109,4815877,16513232
2088,429,Phul Singh,HISAR,CPI(M),0,Graduate,14551828,1022496,13529332
2089,2528,Phusey Ghanshyam Ramaji,NAGPUR,RPI,0,Graduate,4987645,577000,4410645
2090,1770,Pijush Barman,COOCHBEHAR,Welfare Party Of India,0,Post Graduate,1670000,0,1670000
2091,3715,Pinaki Mishra,PURI,BJD,0,Graduate Professional,1370991203,19975839,1351015364
2092,2244,Pintu Malakar,KARIMGANJ,IND,0,12th Pass,440000,0,440000
2093,704,Piravathoor Sreedharan,MAVELIKKARA,IND,0,Post Graduate,829000,0,829000
2094,728,Pjech Debbarma,TRIPURA WEST,IND,0,10th Pass,15085500,10373,15075127
2095,3576,Pol Sudhir Arjun,MADHA,IND,0,12th Pass,25000,0,25000
2096,425,Poonam Chand,SIRSA,AAP,0,12th Pass,3825442,0,3825442
2097,3399,Popat Manik Fule,AHMEDNAGAR,Maharashtra Parivartan Sena (T),0,5th Pass,500,0,500
2098,2480,Popat Ram,BARMER,IND,0,5th Pass,180000,0,180000
2099,3862,Pournima Vilas Korpale,SANGLI,IND,0,Post Graduate,60000,0,60000
2100,789,Prabhas Kumar Singh,BARGARH,BJD,0,Doctorate,5786971,670000,5116971
2101,826,Prabhat Kumar Mahanty,ASKA,AAP,1,Graduate,989407,0,989407
2102,3924,Prabhawati Shakya Khot,BHOPAL,IND,0,12th Pass,100000,0,100000
2103,2129,Prabhu,BIDAR,IND,0,10th Pass,2200000,0,2200000
2104,612,Prabhu,BANGALORE SOUTH,IND,0,Literate,90000,0,90000
2105,2438,Prabhu Lal Gujjar,CHITTORGARH,Jai Maha Bharath Party,0,8th Pass,615000,100000,515000
2106,3234,Prabhudan Marandi,MAYURBHANJ,Aama Odisha Party,0,Graduate Professional,2683854,0,2683854
2107,2451,Prabhulal Meena,UDAIPUR,Bahujan Mukti Party,0,8th Pass,595000,50000,545000
2108,1535,Prabhunath Prasad Saket,REWA,IND,0,Doctorate,316246,0,316246
2109,2499,Prabiddha Reang,TRIPURA EAST,IND,0,10th Pass,402519,0,402519
2110,1898,Pradeep,PALAKKAD,IND,0,10th Pass,131500,0,131500
2111,771,Pradeep,HOSHANGABAD,BSP,0,10th Pass,10082,0,10082
2112,1800,Pradeep Kumar,ALIGARH,Bahujan Mukti Party,0,Graduate Professional,41900,0,41900
2113,1727,Pradeep Kumar Jatav,BULANDSHAHR,BSP,1,12th Pass,25731324,557571,25173753
2114,37,Pradeep Kumar Joshi,KARAKAT,Rashtra Sewa Dal,21,12th Pass,11721162,11908841,0
2115,1208,Pradeep Kumar M,CHAMARAJANAGAR,Karunaadu Party,0,12th Pass,45000,0,45000
2116,116,Pradeep Kumar Majhi,NABARANGPUR,INC,0,Graduate,6978000,36000,6942000
2117,2653,Pradeep Kumar Prasad,BUXAR,Pragatisheel Manav Samaj Party,0,10th Pass,1994000,0,1994000
2118,1331,Pradeep Varma,NEW DELHI,Bharat Vishal Party,0,Graduate Professional,4200000,500000,3700000
2119,1006,Pradesh Kumar,NORTH EAST DELHI,Ambedkar National Congress,0,Post Graduate,257000,0,257000
2120,3316,Pradip Kumar Mallick,JAGATSINGHPUR,BSP,0,Post Graduate,1760000,0,1760000
2121,2465,Pradip Singh Bhatnagar,RAJSAMAND,AAP,0,Post Graduate,12368765,520000,11848765
2122,2253,Pradip Suklabaidya,KARIMGANJ,IND,0,8th Pass,299847,0,299847
2123,813,Pradipta Kumar Naik,KALAHANDI,BJP,0,Graduate Professional,42970197,0,42970197
2124,3269,Pradyumna Kumar Naik,DHENKANAL,Bahujan Mukti Party,0,Graduate Professional,1427000,0,1427000
2125,3577,Prafull Shivrao Kadam,MADHA,IND,0,Post Graduate,4595131,347241,4247890
2126,2694,Pragati Mehta,MUNGER,RJD,0,Graduate,6422050,0,6422050
2127,2921,Prahlad Singh Patel,DAMOH,BJP,0,Graduate Professional,39586235,12429302,27156933
2128,2928,Prahlad Singh Patel-Mukundilal,DAMOH,IND,0,Illiterate,176000,0,176000
2129,2929,Prahlad-Gabdu,DAMOH,IND,0,Illiterate,857000,0,857000
2130,4080,Prajesh Choudhary,GWALIOR,IND,0,8th Pass,1057799,0,1057799
2131,1170,Prakash Hikaka,KORAPUT,CPI(ML) Red star,0,Literate,2500,0,2500
2132,1815,Prakash Hukkeri,CHIKKODI,INC,0,12th Pass,75717628,3635650,72081978
2133,2912,Prakash Mangilal Sharma,BHOPAL,INC,5,Graduate Professional,27818657,1799934,26018723
2134,586,Prakash Minj,ANDAMAN & NICOBAR ISLANDS,IND,0,Post Graduate,308000,0,308000
2135,1502,Prakash Raghunath Raut,YAVATMAL-WASHIM,IND,0,10th Pass,250000,0,250000
2136,565,Prakash Rathod,BIJAPUR,INC,3,Post Graduate,113403666,27599682,85803984
2137,1075,Pralhad Joshi,DHARWAD,BJP,1,Graduate,41979658,6739989,35239669
2138,3347,Pramila Behera,BHUBANESWAR,CPI(ML) Red star,0,Graduate,166297,0,166297
2139,2396,Pramod Kumar,JHALAWAR-BARAN,INC,0,12th Pass,290302756,92884227,197418529
2140,2705,Pramod Kumar,MUNGER,SUCI(C),0,Post Graduate,1741914,0,1741914
2141,3284,Pramod Kumar Mallick,CUTTACK,BSP,0,Graduate,136000,0,136000
2142,2724,Pramod Kumar Nirala,NALANDA,Sankhyanupati Bhagidari Party,0,Graduate,7929000,67000,7862000
2143,3052,Pramod Kumar Yadav,AONLA,Bhartiya Krishak Dal,0,Post Graduate,477000,0,477000
2144,1494,Pramod Mangaruji Sorte,CHANDRAPUR,IND,0,12th Pass,566100,0,566100
2145,3343,Pramod Maroti Panditkar,PARBHANI,IND,0,Graduate,180000,0,180000
2146,3750,Pramod Mutalik,BANGALORE SOUTH,IND,8,Graduate,268756,0,268756
2147,2193,Pramod Mutalik.,DHARWAD,IND,8,Graduate,268756,0,268756
2148,3291,Pramod Sahu,KENDRAPARA,IND,0,Graduate Professional,1263856,0,1263856
2149,1533,Pramod Tiwari,REWA,Bhartiya Shakti Chetna Party,0,Graduate,35000,0,35000
2150,3346,Prana Krushna Dalabehera,BHUBANESWAR,Samruddha Odisha,0,Graduate Professional,2790039,255034,2535005
2151,642,Pranav Kumar Verma,KODARMA,JVM,0,Post Graduate,1386131,0,1386131
2152,795,Prasadi Pradhan,SAMBALPUR,SUCI(C),0,8th Pass,485502,36800,448702
2153,3710,"Prasanna Kumar Patasani,",BHUBANESWAR,BJD,0,Post Graduate,13557443,9590067,3967376
2154,3236,Prasanta Kumar Mishra,BALASORE,CPI,1,Graduate Professional,2357346,8000,2349346
2155,59,Prashant Chaudhary,BAGHPAT,BSP,0,Post Graduate,258289957,3950000,254339957
2156,1503,Prashant Pandharinath Surve,YAVATMAL-WASHIM,IND,0,Post Graduate,26770200,4600000,22170200
2157,918,Prashant Shyamsundar Mishra,BHANDARA-GONDIYA,AAP,0,Post Graduate,41306880,559171,40747709
2158,3662,Prashant Vasant Chavan,SATARA,BSP,0,Graduate,1930279,793050,1137229
2159,3880,Prashant Vishnu Sasane,BEED,IND,0,Graduate,0,0,0
2160,1198,Prashanth.S.M,BANGALORE CENTRAL,IND,0,Post Graduate,210000,0,210000
2161,2682,Prashuram Bind,JAHANABAD,Bahujan Mukti Party,0,Graduate,2636206,0,2636206
2162,2662,Prashuram Prasad,BUXAR,Bahujan Mukti Party,1,12th Pass,460000,0,460000
2163,1177,Praska Renga,KORAPUT,BSP,0,8th Pass,352000,0,352000
2164,3242,Pratap Chandra Sarangi,BALASORE,BJP,10,Graduate,1018629,160,1018469
2165,939,Pratap Goswami,RAMTEK,AAP,0,Graduate,23772549,2075378,21697171
2166,2349,Pratap Singh,SIKAR,IND,0,8th Pass,3003000,0,3003000
2167,2319,Pratap Singh,CHURU,INC,0,Post Graduate,12282074,1241053,11041021
2168,2339,Pratap Singh Jat,SIKAR,INC,0,Graduate Professional,22669772,1123169,21546603
2169,838,Prataprao Alagouda Patil,CHIKKODI,NCP,1,Post Graduate,19483000,37260000,0
2170,271,Prathap Kumar. N. P,KOZHIKODE,IND,0,Graduate Professional,4356708,100000,4256708
2171,1216,Prathap Simha,MYSORE,BJP,0,Post Graduate,6321591,4399048,1922543
2172,2273,Pratima Engheepi,AUTONOMOUS DISTRICT,CPI(ML)L,0,Graduate,469165,365000,104165
2173,1950,Praveen K Mohan,KOTTAYAM,IND,3,10th Pass,512500,0,512500
2174,2338,Praveen Kumar,JHUNJHUNU,IND,0,Post Graduate,10556850,1355300,9201550
2175,1365,Praveen Kumar,EAST DELHI,Bhartiya Jan Manch,0,8th Pass,155178,1700,153478
2176,618,Praveen M S,MYSORE,IND,0,Post Graduate,198500,0,198500
2177,3087,Praveen Singh Aron,BAREILLY,INC,1,Graduate Professional,274576248,383067,274193181
2178,2838,Prayag Prasad,HAZARIBAGH,IND,0,Literate,4063000,150000,3913000
2179,652,Prechard B. M. Basaiawmoit,SHILLONG,IND,0,12th Pass,39194012,0,39194012
2180,2803,Preeti Dhruw,MAHASAMUND,GGP,0,Others,150000,0,150000
2181,2490,Prem Das Rai,SIKKIM,SDF,0,Post Graduate,32389223,0,32389223
2182,1354,Prem Singh,EAST DELHI,Socialist Party (India),0,Doctorate,13650000,200000,13450000
2183,338,Premachandran,KOLLAM,IND,0,10th Pass,71500,0,71500
2184,2488,Premachandran,KOLLAM,IND,1,10th Pass,2605267,0,2605267
2185,963,Premakumari,ALATHUR,BSP,1,Others,32000,158000,0
2186,3264,Premananda Sahoo,DHENKANAL,BSP,0,Post Graduate,1650041,55253,1594788
2187,3517,Principal Dr.Vithal Namdeorao Kadam,HINGOLI,AAP,0,Doctorate,9525025,926227,8598798
2188,3351,Prithiviraj Harichandan,BHUBANESWAR,BJP,1,Post Graduate,10162181,5087000,5075181
2189,3270,Priyabrata Garnaik,DHENKANAL,Samata Kranti Dal,0,Graduate,1191000,350000,841000
2190,2239,Probash Chandra Sarkar,KARIMGANJ,SUCI(C),0,10th Pass,30000,0,30000
2191,141,Prodip Hazarika,JORHAT,AGP,0,Post Graduate,6989852,650000,6339852
2192,2781,Prof. Bhim Singh,UDHAMPUR,JKNPP,0,Post Graduate,3895677,1410000,2485677
2193,1423,Prof. Dr. Natthu Madhao Lokhande,RAMTEK,IND,0,Doctorate,5276500,0,5276500
2194,2844,Promod Kumar Mahatha,HAZARIBAGH,Pragatisheel Magahi Samaj,0,12th Pass,3030000,653525,2376475
2195,93,Puran Mal,BHIWANI-MAHENDRAGARH,IND,0,10th Pass,4158000,290000,3868000
2196,2033,Puran Singh Panwar,KARNAL,Rashtravadi Janata Party,0,Graduate Professional,3621304,296000,3325304
2197,737,Purnanand Tiwari,REWA,AAP,0,Post Graduate,1533286,0,1533286
2198,650,Purno Agitok Sangma,TURA,NPP,0,Post Graduate,215134618,0,215134618
2199,1274,Purshotam,FARIDABAD,AAP,0,10th Pass,27376208,1193221,26182987
2200,3671,Purushottam Jadhav,SATARA,IND,5,10th Pass,106966036,4653805,102312231
2201,1965,Pushpangathan,PATHANAMTHITTA,IND,0,10th Pass,92000,0,92000
2202,1547,Puspendra Singh,SIDHI,GGP,1,Graduate Professional,10453934,2020000,8433934
2203,1724,Pyare Lal,BULANDSHAHR,Bahujan Mukti Party,0,Graduate Professional,11325000,900000,10425000
2204,3210,Pyare Urf Rajkumar Gautam,SHAHJAHANPUR,VANCHITSAMAJ INSAAF PARTY,0,Not Given,65000,0,65000
2205,1907,R Biju,ALATHUR,IND,0,10th Pass,1500,0,1500
2206,2512,R Chandrika Kattakada,THIRUVANANTHAPURAM,RPI,0,10th Pass,150000,0,150000
2207,3743,R Gayathri,BANGALORE SOUTH,Pyramid Party of India,0,Post Graduate,2973000,300000,2673000
2208,1278,R K Anand,FARIDABAD,INLD,0,Graduate Professional,149352852,15495731,133857121
2209,2328,R S Kadyan,JHUNJHUNU,AAP,0,Post Graduate,130227500,0,130227500
2210,863,R. Dhruvanarayana,CHAMARAJANAGAR,INC,0,Graduate,31519950,2605818,28914132
2211,1194,R. Mohan Raju,BANGALORE CENTRAL,BSP,0,Post Graduate,6774000,460000,6314000
2212,1091,R. Prabhakara Reddy,BANGALORE RURAL,JD(S),0,Graduate,2243612066,2218003086,25608980
2213,2163,R. Ravinayaka,BELLARY,JD(S),2,12th Pass,5286536,273603,5012933
2214,1534,R.D. Vishwkarma,REWA,Apna Dal,0,10th Pass,1575000,0,1575000
2215,3797,R.Ravindra Kumar,KOLAR,Bharatiya Dr. B.R.Ambedkar Janta Party,0,Graduate,10601000,8332000,2269000
2216,123,R.S.Uma Bharatthy,ANDAMAN & NICOBAR ISLANDS,NCP,0,Post Graduate,1380999,253000,1127999
2217,3239,Rabindra Kumar Jena,BALASORE,BJD,0,Post Graduate,570139716,55893020,514246696
2218,3353,Rabindra Nath Behera,BHUBANESWAR,SP,0,Post Graduate,4697137,1714853,2982284
2219,2252,Rabindra Nath Choudhury,KARIMGANJ,AGP,0,Graduate Professional,15546810,0,15546810
2220,3028,Rabindra Roy Basunia,DARJEELING,IND,0,Post Graduate,3398828,230346,3168482
2221,2911,Rachna Dhingra,BHOPAL,AAP,3,Graduate Professional,7192772,0,7192772
2222,2427,Radha Devi,CHITTORGARH,CPI,0,Post Graduate,10625129,125000,10500129
2223,1933,Radhakrishnan P T,ERNAKULAM,IND,0,Graduate Professional,3488000,0,3488000
2224,2240,Radheshyam Biswas,KARIMGANJ,AIUDF,0,12th Pass,7068281,0,7068281
2225,2420,Radhy Shyam Vaishnav,BHILWARA,Bahujan Sangharshh Dal,0,10th Pass,35000,0,35000
2226,685,Raghav Lakhanpal,SAHARANPUR,BJP,0,Post Graduate,35406431,0,35406431
2227,2195,Raghavendra Krishnarao Thane,UTTARA KANNADA,AAP,0,Post Graduate,4952691,5616664,0
2228,907,Raghubir Singh,ANDAMAN & NICOBAR ISLANDS,SP,1,8th Pass,1128697,20000,1108697
2229,643,Raghunandan Prasad Vishwakarma,KODARMA,AIFB,0,10th Pass,4822232,487351,4334881
2230,3408,Raghunath Ramji Makasare,SHIRDI,Bharipa Bahujan Mahasangh,0,Post Graduate,2132555,289000,1843555
2231,2590,Raghunath Shankarrao Shelke,YAVATMAL-WASHIM,Ambedkarist Republican Party,0,Graduate,9692000,0,9692000
2232,3499,Raghunathdada Patil,HATKANANGLE,AAP,4,Graduate,20095000,695000,19400000
2233,1732,Raghuraj Pratap Singh,BULANDSHAHR,Rashtriya Kranti Party,0,12th Pass,849500,21000,828500
2234,1736,Raghuveer Singh Bodh,SAHARANPUR,IND,0,8th Pass,2590110,0,2590110
2235,2450,Raghuvir Singh,UDAIPUR,INC,0,Graduate Professional,26644500,3527476,23117024
2236,380,Ragini Lata Singh,AURANGABAD,AAP,0,Post Graduate,14532000,183755,14348245
2237,2333,Rahisa Bano,JHUNJHUNU,BSP,0,Literate,661308,0,661308
2238,528,Rahmat Ullah,KALIABOR,IND,0,Graduate Professional,255300,0,255300
2239,2312,Rahul Kaswan,CHURU,BJP,0,Graduate,25721266,5386104,20335162
2240,3857,Rahul Prabhakar Kamble,BEED,Ambedkarite Party of India,0,Graduate Professional,102000,0,102000
2241,2669,Rahul Ranjan,JAHANABAD,JMM,0,Graduate,3431000,0,3431000
2242,1422,Rahul Sheshraoji Meshram,RAMTEK,IND,0,12th Pass,10938968,0,10938968
2243,1427,Rahulkant Alias Ramesh Sinha,RAMTEK,IND,0,Graduate Professional,6520000,700000,5820000
2244,1685,Raj Babbar,GHAZIABAD,INC,1,12th Pass,197233950,22896345,174337605
2245,2023,Raj Kumar,HISAR,IND,0,10th Pass,66000,0,66000
2246,871,Raj Kumar,AMBALA,INC,0,10th Pass,36214599,5883900,30330699
2247,572,Raj Kumar,JAMMU,IND,0,12th Pass,2268500,0,2268500
2248,3128,Raj Kumar Gupta,MORADABAD,IND,0,8th Pass,1973100,0,1973100
2249,1999,Raj Kumar Nagar,SIRSA,SP,0,Graduate,5675000,3200000,2475000
2250,2738,Raj Kumar Ram,PATALIPUTRA,BSP,0,10th Pass,660000,450000,210000
2251,1034,Raj Kumar Saini,KURUKSHETRA,IND,0,5th Pass,562200,24000,538200
2252,2641,Raj Kumar Singh,ARRAH,BJP,0,Graduate Professional,48403293,0,48403293
2253,367,Raj Narain Rao,SASARAM,IND,0,12th Pass,558000,100,557900
2254,992,Raj Pal Singh,WEST DELHI,BSP,0,Graduate,30390435,0,30390435
2255,2024,Raj Singh,HISAR,IND,0,Others,708500,0,708500
2256,2966,Raja Pateriya,KHAJURAHO,INC,0,12th Pass,52438292,552639,51885653
2257,34,Raja Ram Singh,KARAKAT,CPI(ML)L,4,Graduate Professional,6796970,0,6796970
2258,2121,Raja Thimmappa Nayak,RAICHUR,BSP,0,12th Pass,15732000,100000,15632000
2259,2582,Rajagiri T.D,CHITRADURGA,BSP,3,Post Graduate,3875000,500000,3375000
2260,1369,Rajan Lal,NORTH EAST DELHI,Bharatiya Republican Paksha,0,Graduate Professional,11571000,0,11571000
2261,1934,Rajaneesh Babu,ERNAKULAM,IND,0,10th Pass,1000,0,1000
2262,38,Rajani Dubey,KARAKAT,Akhil Bharatiya Jan Sangh,0,Graduate,8324677,0,8324677
2263,3918,Rajaram Mehar,BHOPAL,Proutist Sarva Samaj,0,Post Graduate,1530000,0,1530000
2264,2336,Rajbala,JHUNJHUNU,IND,0,8th Pass,816752,0,816752
2265,2326,Rajbala Ola,JHUNJHUNU,INC,0,Doctorate,58115000,500000,57615000
2266,147,Rajballabh Prasad,NAWADA,RJD,3,10th Pass,83137973,1387290,81750683
2267,423,Rajbir Palna,SIRSA,IND,0,Post Graduate,356000,37362,318638
2268,3161,Rajeev Agrawal,PILIBHIT,AAP,1,12th Pass,54959664,2264609,52695055
2269,3491,Rajeev Appasaheb Rajale,AHMEDNAGAR,NCP,3,Graduate Professional,63094594,17101039,45993555
2270,3511,Rajeev Shankarrao Satav,HINGOLI,INC,0,Graduate Professional,49681499,584357,49097142
2271,2087,Rajeev Yadav,GURGAON,IND,0,Post Graduate,3963909,0,3963909
2272,505,Rajen Saikia,TEZPUR,AIFB,0,10th Pass,1318447,0,1318447
2273,463,Rajender,FARIDABAD,BSP,0,Graduate,17146020,250000,16896020
2274,2097,Rajender,FARIDABAD,IND,0,10th Pass,940500,0,940500
2275,1749,Rajender Kumar,SAHARANPUR,Adarsh Rashtriya Vikas Party,0,Graduate,44300,0,44300
2276,1993,Rajender Kumar,AMBALA,Bhartiya Shakti Chetna Party,0,10th Pass,4150500,0,4150500
2277,667,Rajendra Agarwal,MEERUT,BJP,2,Post Graduate,8803517,3074600,5728917
2278,3702,Rajendra Dnyandeo Randive,SOLAPUR,IND,0,Graduate Professional,34000,0,34000
2279,1155,Rajendra Kumar Mund,KALAHANDI,IND,0,Post Graduate,32280000,48000,32232000
2280,2665,Rajendra Kumar Singh Chauhan,BUXAR,Bharat Vikas Morcha,0,Literate,35000,0,35000
2281,3369,Rajendra Maruti Kate,MAVAL,IND,0,Graduate,402000,0,402000
2282,2889,Rajendra Purty,SINGHBHUM,Jharkhand Party,0,12th Pass,551520,15000,536520
2283,1016,Rajendra Singh,NAWADA,AAP,0,Graduate Professional,1455858,858745,597113
2284,2878,Rajendra Singh Munda,RANCHI,CPI(M),0,10th Pass,8243730,3000,8240730
2285,1452,Rajendrakumar Punjabrao Kanphade,NAGPUR,IND,0,Graduate,1841093,0,1841093
2286,744,Rajes Nandini Singh - Dalvir,SHAHDOL,INC,0,Graduate,41389440,645000,40744440
2287,2088,Rajesh,GURGAON,IND,0,10th Pass,36429409,880000,35549409
2288,1357,Rajesh,EAST DELHI,Ambedkar National Congress,0,Graduate,83220,0,83220
2289,1617,Rajesh Devi Urf Radhika,MUZAFFARNAGAR,AITC,0,Graduate Professional,7370060,0,7370060
2290,3919,Rajesh Keer,BHOPAL,Bahujan Mukti Party,0,Graduate Professional,2215850,15000,2200850
2291,1318,Rajesh Kumar,NORTH WEST DELHI,Rashtriya Bahujan Hitay Party,0,10th Pass,1141000,0,1141000
2292,2038,Rajesh Kumar,KARNAL,IND,0,Graduate,18210000,225000,17985000
2293,2410,Rajesh Kumar,KOTA,Jai Maha Bharath Party,0,10th Pass,364000,0,364000
2294,2981,Rajesh Kushwah,MORENA,SP,0,Graduate Professional,491500,0,491500
2295,1890,Rajesh S,PALAKKAD,SHS,0,10th Pass,0,255390,0
2296,1453,Rajesh Suresh Sadhankar,NAGPUR,IND,0,Not Given,0,0,0
2297,2061,Rajiv,BHIWANI-MAHENDRAGARH,Bahujan Mukti Party,0,12th Pass,161000,0,161000
2298,2697,Rajiv Ranjan Singh Alias Lalan Singh,MUNGER,JD(U),1,Graduate,55757926,3512083,52245843
2299,1525,Rajkumar,SATNA,Bhartiya Shakti Chetna Party,0,10th Pass,790000,600000,190000
2300,3562,Rajkumar Bhimrao Chandanshive,LATUR,IND,0,8th Pass,108500,120000,0
2301,510,Rajkumar Dowarah,JORHAT,IND,0,Graduate,487600,0,487600
2302,1237,Rajkumar Pahan,CHATRA,Rashtriya Deshaj Party,0,Graduate,8851813,0,8851813
2303,3479,Rajkumar Ranjan Singh,INNER MANIPUR,BJP,0,Doctorate,13350861,0,13350861
2304,90,Rajkumar Saini,KURUKSHETRA,BJP,0,Graduate,132880476,23262108,109618368
2305,2103,Rajmahendra Sakharam Gaonkar,BELGAUM,IND,0,Post Graduate,3620123,0,3620123
2306,494,Rajmohan Gandhi,EAST DELHI,AAP,0,Post Graduate,48208736,0,48208736
2307,3036,Rajpal,AMROHA,Adarsh Rashtriya Vikas Party,0,10th Pass,2901400,30000,2871400
2308,2321,Rajpal,CHURU,IND,0,Post Graduate,25500,0,25500
2309,3304,Rajratna Ambedkar,NANDED,Bahujan Mukti Party,0,Post Graduate,4040148,450000,3590148
2310,1561,Raju Baiga,SHAHDOL,IND,1,10th Pass,5177500,120000,5057500
2311,1985,Raju Dsouza,NORTH GOA,Samajwadi Janata Party (Rashtriya),0,10th Pass,9352368,5050000,4302368
2312,2377,Raju Lal Bairwa,JAIPUR,Ambedkarite Party of India,0,10th Pass,4327500,96000,4231500
2313,1111,Raju Mahadeorao Sonone,AMRAVATI,IND,0,Graduate,674000,0,674000
2314,1522,Raju Or Bharatraje Uddhaorao Patil,YAVATMAL-WASHIM,MNS,6,Graduate,25700000,1400000,24300000
2315,1838,Raju Padaganur,BIJAPUR,IND,0,10th Pass,680000,10000,670000
2316,48,Raju S. Mankar,AMRAVATI,IND,0,Literate,13736000,150000,13586000
2317,3501,Raju Shetty,HATKANANGLE,Swabhimani Paksha,12,10th Pass,16152914,1504152,14648762
2318,2642,Raju Yadav,ARRAH,CPI(ML)L,1,Post Graduate,491000,0,491000
2319,2360,Rajyavardhan Singh Rathore,JAIPUR RURAL,BJP,0,Graduate,83734044,117065,83616979
2320,3049,Rakesh,AMROHA,Peace Party,1,8th Pass,4005000,40000,3965000
2321,1714,Rakesh,GAUTAM BUDHHA NAGAR,IND,0,12th Pass,19913600,0,19913600
2322,1628,Rakesh,MUZAFFARNAGAR,IND,0,12th Pass,1818316,28990,1789326
2323,3216,Rakesh,SHAHJAHANPUR,IND,0,Not Given,90000,0,90000
2324,2308,Rakesh Chandra Rawat,ALIGARH,Rashtriya Sawarn Dal,0,Post Graduate,23000000,0,23000000
2325,2070,Rakesh Kumar,BHIWANI-MAHENDRAGARH,IND,0,Graduate Professional,8693411,1050000,7643411
2326,1292,Rakesh Kumar,SOUTH DELHI,IND,0,10th Pass,660800,0,660800
2327,1305,Rakesh Kumar,WEST DELHI,Bhartiya Janta Dal (Integrated),0,10th Pass,40000,0,40000
2328,2022,Rakesh Kumar (Rinku Bhai),HISAR,IND,0,12th Pass,451122,28102,423020
2329,2719,Rakesh Ranjan Sinha,NALANDA,RPI(A),0,Graduate,3748727,16599,3732128
2330,373,Rakesh Sharma,AURANGABAD,IND,0,Doctorate,12693861,828288,11865573
2331,750,Rakesh Singh Urf Ghanshyam Singh,JABALPUR,BJP,1,Graduate,27823610,0,27823610
2332,3035,Rakesh Tikait,AMROHA,RLD,3,Graduate,42518038,1095120,41422918
2333,166,Rakhal Raj Datta,TRIPURA WEST,Amra Bangalee,0,Post Graduate,6549960,0,6549960
2334,496,Rakhi Birla,NORTH WEST DELHI,AAP,0,Post Graduate,163467,230000,0
2335,3163,Ram Autar,PILIBHIT,CPI(ML)L,0,12th Pass,2345938,0,2345938
2336,2703,Ram Badan Rai,MUNGER,SP,0,Post Graduate,23860981,1000000,22860981
2337,1706,Ram Bilash,GAUTAM BUDHHA NAGAR,Bahujan Mukti Party,0,5th Pass,6470000,0,6470000
2338,1363,Ram Briksh Mall,EAST DELHI,Hindusthan Nirman Dal,0,Post Graduate,18234000,956912,17277088
2339,3015,Ram Charan Ahirwar,TIKAMGARH,Poorvanchal Rashtriya Congress,0,12th Pass,4650000,0,4650000
2340,3448,Ram Dayal,JODHPUR,IND,0,12th Pass,1231000,0,1231000
2341,561,Ram Dayal Singh,KARAKAT,IND,0,Graduate,3256600,0,3256600
2342,3106,Ram Gopal Mishra,KHERI,IND,0,8th Pass,27258000,5000,27253000
2343,1557,Ram Gopal Singh,SHAHDOL,Bhartiya Shakti Chetna Party,0,8th Pass,1475529,0,1475529
2344,1025,Ram Jawari,AMBALA,Rashtriya Karmyog Party,0,Graduate,245500,0,245500
2345,1319,Ram Karan Sauran,NORTH WEST DELHI,IND,0,Graduate,11854000,1257000,10597000
2346,1995,Ram Kishan,KURUKSHETRA,Lok Parivartan Party(DC),0,10th Pass,1785984,0,1785984
2347,1544,Ram Kishan Nirat (Saket),REWA,RPI(A),1,Post Graduate,897056,100000,797056
2348,2750,Ram Kripal Yadav,PATALIPUTRA,BJP,1,Graduate,13989431,2100000,11889431
2349,2964,Ram Lakhan Singh,KHAJURAHO,BSP,1,Post Graduate,8657688,497625,8160063
2350,4011,Ram Lal Mahto,RANCHI,SUCI(C),0,Graduate,521590,0,521590
2351,3213,Ram Lal Verma,SHAHJAHANPUR,Bahujan Mukti Party,0,Graduate,2029000,28000,2001000
2352,3212,Ram Murti,SHAHJAHANPUR,Bhartiya Krishak Dal,0,Not Given,534000,0,534000
2353,2987,Ram Naresh,MORENA,IND,0,Literate,220000,0,220000
2354,2968,Ram Nath,KHAJURAHO,IND,0,8th Pass,420000,330000,90000
2355,1162,Ram Nayak,KANDHAMAL,BSP,0,5th Pass,1774911,713000,1061911
2356,2956,Ram Pathwar Kori (Ramsebak),GWALIOR,IND,0,12th Pass,53200,0,53200
2357,80,Ram Prasad Sharma,TEZPUR,BJP,0,Graduate Professional,6655300,0,6655300
2358,2302,Ram Ratan,BIKANER,Bahujan Mukti Party,0,8th Pass,477590,0,477590
2359,2383,Ram Singh,JAIPUR,IND,0,Graduate,730306,0,730306
2360,1559,Ram Singh,SHAHDOL,Chhattisgarh Swabhiman Manch,0,8th Pass,186000,0,186000
2361,3228,Rama Chandra Hansdah,MAYURBHANJ,BJD,0,Graduate,3630888,0,3630888
2362,99,Rama Chandra Panda,BERHAMPUR,BJP,0,Post Graduate,5552220,0,5552220
2363,2485,Rama Ram,BARMER,IND,0,5th Pass,365485,36000,329485
2364,2673,Ramadhar Chaudhary,JAHANABAD,CPI(ML)L,3,10th Pass,577037,0,577037
2365,1554,Ramakant Pandey Malaihna,SIDHI,IND,0,Post Graduate,515000,0,515000
2366,1128,Raman Motiram Bansod,BHANDARA-GONDIYA,Ambedkarite Party of India,0,Post Graduate,58800,50000,8800
2367,2155,Ramanna,BIDAR,Hindustan Janta Party,0,5th Pass,435000,0,435000
2368,1344,Ramanuj Patel,NEW DELHI,Samyak Parivartan Party,0,12th Pass,100,0,100
2369,3727,Ramanuj Singh,BANGALORE CENTRAL,IND,0,Graduate Professional,84383,56000,28383
2370,1826,Ramappa Mareppa Chalawadi,BELGAUM,IND,1,10th Pass,1620326,50000,1570326
2371,743,Ramashankar Shahwal,SIDHI,BSP,0,Post Graduate,9743656,1092000,8651656
2372,2845,Ramavtar Mahto,HAZARIBAGH,IND,0,12th Pass,1863000,0,1863000
2373,1264,Rambadan Ram,PALAMAU,SP,0,Post Graduate,2450000,800000,1650000
2374,3322,Ramchandra Gangaram Bharande,NANDED,IND,0,Post Graduate,100000,0,100000
2375,3305,Ramchandra Gyanoba Sawant,NANDED,Bharipa Bahujan Mahasangh,0,10th Pass,176000,0,176000
2376,2371,Ramcharan Bohara,JAIPUR,BJP,0,12th Pass,135809546,23871000,111938546
2377,944,Ramdas Chandrabhanji Tadas,WARDHA,BJP,5,10th Pass,33628998,1749314,31879684
2378,1592,Ramesh,CHHINDWARA,Ambedkarite Party of India,0,8th Pass,0,0,0
2379,2053,Ramesh,SONIPAT,IND,0,Graduate Professional,42376491,425241,41951250
2380,2136,Ramesh,BIDAR,Ambedkar National Congress,1,10th Pass,1957000,0,1957000
2381,1823,Ramesh Alias Suresh Guruling Kadalaskar,BELGAUM,BSP,0,12th Pass,479000,0,479000
2382,71,Ramesh Bidhuri,SOUTH DELHI,BJP,4,Graduate Professional,147493056,0,147493056
2383,1023,Ramesh Chand,AMBALA,IND,0,10th Pass,1110000,0,1110000
2384,677,Ramesh Chand Tomar,GAUTAM BUDHHA NAGAR,INC,4,Doctorate,61617189,0,61617189
2385,3014,Ramesh Chand Verma,TIKAMGARH,AAP,0,Graduate Professional,1698238,325000,1373238
2386,891,Ramesh Chander,CHANDIGARH,IND,0,Graduate,3324,0,3324
2387,2640,Ramesh Chandra Badal,ARRAH,BSP,1,Literate,726000,0,726000
2388,2346,Ramesh Chandra Sharma,SIKAR,Bhartiya Party,0,Graduate Professional,9353600,0,9353600
2389,3248,Ramesh Jena,BHADRAK,CPI,0,Graduate,346987,0,346987
2390,840,Ramesh Jigajinagi,BIJAPUR,BJP,2,Graduate,89429828,5305043,84124785
2391,91,Ramesh Kaushik,SONIPAT,BJP,0,Graduate Professional,142840716,0,142840716
2392,3800,Ramesh Koti,KOPPAL,RPI(A),0,Graduate Professional,491000,0,491000
2393,1018,Ramesh Kumar,SOUTH DELHI,INC,0,10th Pass,172314296,0,172314296
2394,2787,Ramesh Kumar Gawde,KANKER,CPI,1,8th Pass,65000,100000,0
2395,1368,Ramesh Singh Siral,NORTH EAST DELHI,Naya Daur Party,0,8th Pass,2490000,0,2490000
2396,1041,Ramesh Vishwanath Katti,CHIKKODI,BJP,0,12th Pass,89216294,598000,88618294
2397,3912,Ramesh Yadav,RAJNANDGAON,IND,0,12th Pass,1930155,0,1930155
2398,1028,Rameshwar Kumar,KURUKSHETRA,Bhartiya Shakti Chetna Party,0,10th Pass,7416637,0,7416637
2399,479,Rameshwar Oraon,LOHARDAGA,INC,0,Doctorate,262697987,0,262697987
2400,2745,Rameshwar Prasad,PATALIPUTRA,CPI(ML)L,6,8th Pass,2386000,0,2386000
2401,645,Rameshwar Prasad Yadav,KODARMA,IND,0,Post Graduate,1488300,45000,1443300
2402,2833,Rameshwar Ram Kushwaha,HAZARIBAGH,AIFB,1,Graduate,946596,0,946596
2403,81,Rameshwar Teli,DIBRUGARH,BJP,0,10th Pass,977943,0,977943
2404,3116,Rameshwari,KHERI,IND,0,Literate,202000,0,202000
2405,32,Ramji Manjhi,GAYA,RJD,0,Graduate,11115000,0,11115000
2406,377,Ramji Singh,AURANGABAD,IND,0,Post Graduate,1310000,50000,1260000
2407,1611,Ramkaran,KAIRANA,Bhartiya Vanchitsamaj Party,0,Post Graduate,2659619,0,2659619
2408,172,Ramla Mampad,WAYANAD,Welfare Party of India,0,12th Pass,2401057,0,2401057
2409,3475,Ramlal,PALI,IND,0,Doctorate,11493000,600000,10893000
2410,3415,Ramlal,AJMER,Akhil Bhartiya Aamjan Party,0,8th Pass,110000,0,110000
2411,2526,Rammurti Keshvrao Chimote,NAGPUR,GGP,0,12th Pass,2792000,0,2792000
2412,476,Ramnaresh Singh,CHATRA,CPI(ML)L,4,10th Pass,1255000,0,1255000
2413,486,Rampati Ranjan,PALAMAU,BSP,0,Graduate,4445000,0,4445000
2414,203,Ramphal,HISAR,IND,0,12th Pass,26200,0,26200
2415,1697,Ramphal Shakya,GHAZIABAD,IND,0,Not Given,3200000,1077,3198923
2416,2039,Ramphal Sharma,KARNAL,IND,0,10th Pass,4537000,0,4537000
2417,4023,Rampodo Mahto,RANCHI,IND,6,8th Pass,7296004,300000,6996004
2418,3345,Ramrao Dhansing Rathod Sir Nirankari,PARBHANI,IND,0,Post Graduate,9330000,0,9330000
2419,1477,Ramrao Govinda Nannaware,GADCHIROLI-CHIMUR,BSP,0,Graduate,2671687,1030335,1641352
2420,3515,Ramrao Harising Rathod,HINGOLI,Bharipa Bahujan Mahasangh,1,10th Pass,8884209,0,8884209
2421,1558,Ramratan Singh Pawley,SHAHDOL,GGP,0,Post Graduate,227724,0,227724
2422,2788,Ramsay Korram,KANKER,BSP,0,12th Pass,1070000,9594,1060406
2423,2875,Ramtahal Choudhary,RANCHI,BJP,0,10th Pass,10743950,0,10743950
2424,1442,Ramteke Jivan Namdeorao,NAGPUR,IND,0,10th Pass,390000,0,390000
2425,1395,Ramteke Ramesh Devidasrao,AMRAVATI,Republican Party of India (Khobragade),0,12th Pass,5770500,300000,5470500
2426,2113,Ramu Chatru,GULBARGA,IND,0,Graduate,1100000,0,1100000
2427,3739,Ramu S,BANGALORE NORTH,IND,0,12th Pass,807570,0,807570
2428,2159,Ramudu,BELLARY,BSP,0,5th Pass,0,0,0
2429,3427,Ran Singh Rajpurohit,JALORE,Jago Party,0,10th Pass,1675000,0,1675000
2430,808,Rana Nag,BOLANGIR,BSP,0,Graduate,13940000,1700000,12240000
2431,415,Ranbir Singh Sharma,KURUKSHETRA,IND,0,Graduate Professional,14604045,300000,14304045
2432,235,Ranee Narah,LAKHIMPUR,INC,0,Graduate,88519819,1118242,87401577
2433,3818,Ranganayak,RAICHUR,Pyramid Party of India,0,10th Pass,555000,16000,539000
2434,2737,Ranjan Prasad Yadav,PATALIPUTRA,JD(U),0,Doctorate,55327154,1766678,53560476
2435,1135,Ranjeet Amardas Sukhdeve,BHANDARA-GONDIYA,Ambedkar samaj Party,0,12th Pass,1854500,225000,1629500
2436,2881,Ranjit Mahto,RANCHI,Bahujan Mukti Party,0,Post Graduate,254840,0,254840
2437,3262,Ranjit Malik,JAJPUR,Bahujan Mukti Party,1,Graduate,1316991,270889,1046102
2438,1255,Ranjit Oraon,LOHARDAGA,IND,0,12th Pass,2024021,0,2024021
2439,86,Ranjit Singh Gorh,LAKHIMPUR,IND,0,Graduate,4611700,0,4611700
2440,2005,Ranvir Khobra,SIRSA,IND,0,Graduate,7896000,1450000,6446000
2441,2266,Rashid Ahmed Laskar,SILCHAR,SP,0,12th Pass,785000,0,785000
2442,3204,Rashid Hussain,SAMBHAL,IND,5,Literate,5907000,1000000,4907000
2443,1374,Rashmi Kashyap,CHANDNI CHOWK,Bhartiya Pragatisheel Congress,0,10th Pass,3123000,0,3123000
2444,167,Ratan Chakraborti,TRIPURA WEST,AITC,0,Graduate,3314729,0,3314729
2445,2424,Ratan Lal Dhobi,BHILWARA,IND,0,Literate,1000,0,1000
2446,1742,Ratan Singh,SAHARANPUR,Bahujan Mukti Party,0,Others,46134617,0,46134617
2447,1348,Ratheesh,NEW DELHI,IND,0,Graduate,45200,0,45200
2448,1949,Ratheesh Perumal,KOTTAYAM,IND,0,10th Pass,1000,0,1000
2449,3815,Rathi Poovaiah,MYSORE,Karunaadu Party,0,Graduate,410000,0,410000
2450,1510,Rathod Baliram Parashram,YAVATMAL-WASHIM,BSP,0,Graduate Professional,26249301,2106000,24143301
2451,1500,Rathod Induwar Kashiram,YAVATMAL-WASHIM,Bahujan Mukti Party,0,12th Pass,5950000,210000,5740000
2452,1515,Rathod Mohan Mallu,YAVATMAL-WASHIM,Bharipa Bahujan Mahasangh,0,Post Graduate,34013105,1750000,32263105
2453,1517,Rathod Naresh Fulsing,YAVATMAL-WASHIM,AAP,0,Graduate Professional,2030000,0,2030000
2454,89,Rattan Lal Kataria,AMBALA,BJP,0,Post Graduate,42150634,843229,41307405
2455,322,Raut Jaganath Nilkanth,WARDHA,IND,0,Graduate Professional,5940000,0,5940000
2456,1396,Ravi Alias Shailesh Ganeshrao Yelne,WARDHA,IND,0,Graduate,1671754,0,1671754
2457,3442,Ravi Garg,JODHPUR,Bharat Nav Nirman Party,0,12th Pass,1382000,0,1382000
2458,858,Ravi Krishna Reddy,BANGALORE RURAL,AAP,0,Post Graduate,54433258,0,54433258
2459,1346,Ravi Kumar Gupta,NEW DELHI,IND,0,12th Pass,17057930,15000,17042930
2460,1071,Ravi Menasinakai,HAVERI,JD(S),0,Graduate Professional,21964323,2395704,19568619
2461,1980,Ravi Naik,NORTH GOA,INC,0,Post Graduate,81066000,3126000,77940000
2462,3105,Ravi Prakash Verma,KHERI,SP,1,Graduate Professional,8213389,18800,8194589
2463,363,Ravikant Chaudhary,SASARAM,IND,0,10th Pass,225500,0,225500
2464,3745,Ravikumara T,BANGALORE SOUTH,SP,0,Graduate Professional,25140,28000,0
2465,1277,Ravinder,FARIDABAD,Akhil Bharat Hindu Mahasabha,0,12th Pass,327600,0,327600
2466,1271,Ravinder Kumar,ROHTAK,Indian Bahujan Sandesh Party (Kanshiram),0,12th Pass,1245000,0,1245000
2467,1709,Ravinder Sharma,GAUTAM BUDHHA NAGAR,Rashtriya Kranti Party,0,8th Pass,5992835,0,5992835
2468,3387,Ravindra Bhimrao Takale,BARAMATI,Bahujan Mukti Party,2,Graduate,294748,0,294748
2469,3368,Ravindra Kashinath Patil,MAVAL,IND,1,Graduate Professional,10563000,0,10563000
2470,2676,Ravindra Kumar,JAHANABAD,BSP,1,Graduate,1252000,0,1252000
2471,3158,Ravindra Kumar Devnath,PILIBHIT,IND,0,Graduate,2495450,0,2495450
2472,2814,Ravindra Kumar Pandey,GIRIDIH,BJP,0,Graduate,73376970,1970628,71406342
2473,1266,Ravindra Kumar Ravi,PALAMAU,IND,0,12th Pass,200000,0,200000
2474,47,Ravindra Kumar Ray,KODARMA,BJP,0,Doctorate,10564046,200000,10364046
2475,1378,Ravindrasing Ramsing Pawar,BULDHANA,Lok Bharati,0,12th Pass,160000,0,160000
2476,607,Reddy G K C,CHIKKBALLAPUR,JD(U),0,Doctorate,6302974,0,6302974
2477,3076,Reena,BADAUN,Rashtriya Samanta Dal,0,Post Graduate,93856,0,93856
2478,3214,Reeta Singh Urf Reeta Bharti,SHAHJAHANPUR,AAP,0,Graduate,591671,154000,437671
2479,2256,Rejamond Ali Barbhuiya,SILCHAR,CPI(M),0,Graduate Professional,1164212,0,1164212
2480,3195,Rekha Devi Yadav,SAMBHAL,Sanyukt Samajwadi Dal,0,Not Given,202000,0,202000
2481,1766,Renuka Sinha,COOCHBEHAR,AITC,0,Graduate Professional,13017282,0,13017282
2482,2443,Resham Malviya,BANSWARA,INC,0,12th Pass,25370874,6079932,19290942
2483,1063,Revasing Loku,GULBARGA,BJP,0,5th Pass,33293923,3500000,29793923
2484,403,Ribulaya Gogoi,JORHAT,AITC,0,10th Pass,1383171,0,1383171
2485,539,Richard D. Shabong,SHILLONG,CPI,0,12th Pass,1328273,0,1328273
2486,1674,Rinku Kumar Tyagi,GHAZIABAD,IND,0,Others,31501000,4000000,27501000
2487,2241,Rinku Malakar,KARIMGANJ,SP,0,8th Pass,533500,13000,520500
2488,381,Rita Devi,AURANGABAD,SP,0,10th Pass,5136715,800000,4336715
2489,3255,Rita Tarai,JAJPUR,BJD,0,12th Pass,1622003,0,1622003
2490,741,Riti Pathak,SIDHI,BJP,0,Post Graduate,33416561,0,33416561
2491,609,Rizwan Arshad,BANGALORE CENTRAL,INC,2,Graduate,31400000,0,31400000
2492,1179,Robert Romawia Royte,MIZORAM,IND,0,Post Graduate,346499910,0,346499910
2493,1099,Robin Mathews Narekattu,CHIKKBALLAPUR,SP,0,Post Graduate,251460907,97836250,153624657
2494,1241,Robin Singh,CHATRA,IND,0,10th Pass,6430000,0,6430000
2495,2998,Rod Ji,RAJGARH,IND,0,Literate,676000,0,676000
2496,2993,Rodmal Nagar,RAJGARH,BJP,0,Graduate,28569974,3586473,24983501
2497,3591,Rohan Subhash Deshmukh,OSMANABAD,IND,0,Graduate,7275515,7510376,0
2498,3584,Rohit Ramrushna More,MADHA,IND,0,Graduate Professional,342105,842166,0
2499,3607,Rokade Milind Somnath,OSMANABAD,Bharipa Bahujan Mahasangh,0,Post Graduate,1112500,226000,886500
2500,3126,Roopa Chandra Singh,MORADABAD,IND,0,10th Pass,7677881,21833,7656048
2501,1002,Roshan Ali,NORTH EAST DELHI,National Loktantrik Party,0,Not Given,3351382,0,3351382
2502,3217,Roshan Lal Urf Roshan Kanaujia,SHAHJAHANPUR,IND,0,Graduate Professional,991198,0,991198
2503,3850,Rothod Digambar Ramrao,BEED,BSP,0,Graduate,11325000,1060000,10265000
2504,307,Roy Arackal,KOTTAYAM,SDPI,0,10th Pass,513300,0,513300
2505,1345,Rubina Khan,NEW DELHI,IND,0,Graduate,602439,0,602439
2506,1282,Ruby Yadav,SOUTH DELHI,IND,0,Post Graduate,10797222,0,10797222
2507,3265,Rudranarayan Pany,DHENKANAL,BJP,5,Graduate,267145,0,267145
2508,3778,Rudregowda,HASSAN,Jai Vijaya Bharathi Party,0,Graduate Professional,3640000,1450000,2190000
2509,1842,Rudresh Dayappa Dodamani,BIJAPUR,IND,0,Post Graduate,2090000,400000,1690000
2510,2178,Rudresh Ramanna Hadagali,HAVERI,IND,0,Graduate,4006360,176924,3829436
2511,3449,Rugha Ram Choudhary Advocate,JODHPUR,IND,0,Graduate Professional,4180402,0,4180402
2512,1663,Ruksana,BAGHPAT,IND,0,Illiterate,562000,0,562000
2513,3635,Rupali Tamboli,PUNE,IND,0,Graduate,14136754,1950000,12186754
2514,3906,Rupanand Soi,MAHASAMUND,IND,0,12th Pass,185433,0,185433
2515,2892,Rupsingh Hembrom,SINGHBHUM,IND,0,10th Pass,4305000,0,4305000
2516,3742,Ruth Manorama,BANGALORE SOUTH,JD(S),0,Post Graduate,14950943,1189000,13761943
2517,1703,Ruvez Alam Rahi,GAUTAM BUDHHA NAGAR,National Loktantrik Party,0,12th Pass,337000,0,337000
2518,2164,S Bheemappa,BELLARY,CPI(ML) Red star,0,8th Pass,18900,0,18900
2519,2548,S P Mahadevappa,MYSORE,JD(U),0,10th Pass,925000,150000,775000
2520,1969,S Radhakrishnan,PATHANAMTHITTA,IND,0,12th Pass,1875000,0,1875000
2521,1959,S Radhamani,PATHANAMTHITTA,SUCI(C),0,Graduate,16880,0,16880
2522,601,S S Mallikarjun,DAVANAGERE,INC,6,Graduate,645637999,66208771,579429228
2523,3432,S. Buta Singh,JALORE,IND,0,Doctorate,59509479,1132860,58376619
2524,3760,S. Govinda Nayaka,CHAMARAJANAGAR,IND,0,10th Pass,2151000,100000,2051000
2525,2589,S. Meetyanaik,CHITRADURGA,SP,0,Graduate,890000,100000,790000
2526,2221,S. Satish Salian,SHIMOGA,IND,0,12th Pass,617300,80750,536550
2527,3782,S.B. Rajegowda,HASSAN,IND,0,Others,25000,0,25000
2528,1952,S.B.Basheer,ALAPPUZHA,IND,0,5th Pass,50000,0,50000
2529,2577,S.B.Hanumantharayappa,TUMKUR,IND,0,12th Pass,787507,0,787507
2530,3781,S.N. Mallappa,HASSAN,IND,0,12th Pass,3765750,255000,3510750
2531,605,S.P.Muddahanumegowda,TUMKUR,INC,0,Graduate Professional,30273812,0,30273812
2532,3993,S.S. Subhan Khan,DAVANAGERE,IND,0,Post Graduate,76000,0,76000
2533,2523,S.Siddaramaiah Heggade,BANGALORE RURAL,IND,1,12th Pass,477000,0,477000
2534,2816,Saba Ahmad,GIRIDIH,JVM,1,Graduate Professional,5820782,0,5820782
2535,1681,Sabir,GHAZIABAD,IND,0,Others,1836155,16555,1819600
2536,708,Sabu Varghese,IDUKKI,BJP,0,Graduate Professional,9755000,386540,9368460
2537,2242,Sabuj Das,KARIMGANJ,IND,0,10th Pass,332000,0,332000
2538,1960,Sabukutty Joy (Sabu Puthuchera),PATHANAMTHITTA,Social Action Party,1,Post Graduate,21739967,2025000,19714967
2539,3277,Sabyasachi Mahapatra,CUTTACK,CPI(ML) Red star,0,Graduate,600,0,600
2540,3336,Sabyasachi Mohapatra,PURI,Kalinga Sena,0,Graduate Professional,484637,21840,462797
2541,1401,Sachin Pandurangji Raut Alias Gurubhau,WARDHA,IND,0,12th Pass,600000,0,600000
2542,3411,Sachin Pilot,AJMER,INC,0,Post Graduate,53934000,0,53934000
2543,2500,Sachintra Debbarma,TRIPURA EAST,INC,0,Graduate Professional,28560336,0,28560336
2544,2197,Sadanand Deshbhandari,UTTARA KANNADA,IND,0,Graduate,3348114,598550,2749564
2545,3886,Sadulla Asdulla Inamdar,BEED,IND,0,10th Pass,200000,0,200000
2546,151,Safdar Ismail,NAWADA,IND,0,Graduate Professional,8605000,25000,8580000
2547,1712,Safruddin,GAUTAM BUDHHA NAGAR,IND,0,10th Pass,17029000,0,17029000
2548,1229,Sagar Ram,CHATRA,Akhil Bharat Hindu Mahasabha,0,Literate,700000,0,700000
2549,802,Sagar Singh Manaki,SUNDARGARH,Kosal Kranti Dal,0,Graduate,5069000,0,5069000
2550,532,Sahaba Ahmed,KALIABOR,IND,0,Graduate Professional,10104000,0,10104000
2551,1156,Sahadev Jal,KALAHANDI,Bahujan Mukti Party,0,Graduate,1199800,0,1199800
2552,749,Sahdev Singh Paraste,SHAHDOL,National Peoples Party,0,Post Graduate,1586000,150000,1436000
2553,3914,Sahukar Bhaskar,RAJNANDGAON,IND,0,8th Pass,2335477,150000,2185477
2554,3380,Saiyyad Afser Ibrahim,PUNE,SP,0,8th Pass,80991201,619000,80372201
2555,2243,Sajalendu Malakar,KARIMGANJ,IND,0,10th Pass,417000,0,417000
2556,1925,Saji Thuruthikunnel,CHALAKUDY,SHS,3,12th Pass,3017995,1206000,1811995
2557,4024,Sajiya Haidar,RANCHI,IND,0,12th Pass,22851217,6348982,16502235
2558,2825,Sajjadur Rab Hasami,GIRIDIH,IND,0,12th Pass,550000,0,550000
2559,453,Sajjan Singh,ROHTAK,IND,0,Illiterate,2761000,250000,2511000
2560,3860,Saksamudre Bhagwan Kachruba,BEED,Bahujan Mukti Party,0,Others,2407094,535000,1872094
2561,3220,Sakuntala Laguri,KEONJHAR,BJD,0,10th Pass,101531625,0,101531625
2562,2171,Saleem Azeez Ahmed,HAVERI,INC,0,Post Graduate,59573517,0,59573517
2563,3057,Saleem Iqbal Shervani,AONLA,INC,7,Graduate,353932000,0,353932000
2564,1682,Saleem Malik,GHAZIABAD,IND,0,8th Pass,10000,0,10000
2565,525,Salil Saha,TRIPURA WEST,AAP,0,Post Graduate,41153192,1973987,39179205
2566,2322,Salim Gujar,CHURU,IND,0,Literate,201000,0,201000
2567,2888,Salkhan Murmu,SINGHBHUM,Jharkhand Disom Party,3,Post Graduate,6252094,500000,5752094
2568,3333,Salma Shriniwas Kulkarni,PARBHANI,AAP,0,Post Graduate,1956452,470000,1486452
2569,170,Sam P Mathew,WAYANAD,CPI(ML) Red star,4,12th Pass,1934280,0,1934280
2570,1789,Saman Pathak,DARJEELING,CPI(M),4,Graduate,1959732,2142,1957590
2571,1379,Sambare Dinkar Tukaram,BULDHANA,IND,0,10th Pass,10000,0,10000
2572,3280,Samir Dey,CUTTACK,BJP,1,Graduate Professional,19960747,6719742,13241005
2573,1267,Sampat Singh,HISAR,INC,0,Post Graduate,62661560,14371778,48289782
2574,1205,Sampath Kumar,CHAMARAJANAGAR,AAP,0,Graduate Professional,20951240,2190000,18761240
2575,1089,Sampathu N,MYSORE,IND,0,Graduate Professional,16127000,1200000,14927000
2576,3537,Sampatrao Shamrao Pawar Patil,KOLHAPUR,Peasants And Workers Party of India,2,Graduate,11600046,2192330,9407716
2577,2062,Samser,BHIWANI-MAHENDRAGARH,National Loktantrik Party,0,Literate,161000,0,161000
2578,529,Samsul Alam,KALIABOR,AITC,0,Graduate,605000,0,605000
2579,1549,Sanat Kumar Tripathi,SIDHI,Bhartiya Shakti Chetna Party,1,12th Pass,1615000,0,1615000
2580,2696,Sandeep,MUNGER,AAP,0,Graduate Professional,5790000,750000,5040000
2581,493,Sandeep Dikshit,EAST DELHI,INC,0,Post Graduate,73671067,8872174,64798893
2582,3545,Sandeep Gundopant Sankpal,KOLHAPUR,IND,0,10th Pass,419925,8410,411515
2583,3124,Sandeep Kumar,MORADABAD,Sarva Samaj Kalyan Party,0,Graduate,1160000,0,1160000
2584,1387,Sandesh Ashok Ambedkar,BULDHANA,Bahujan Mukti Party,0,Post Graduate,1280500,0,1280500
2585,941,Sandesh Bhivram Bhalekar,RAMTEK,AIFB,0,Graduate Professional,1003000,0,1003000
2586,3672,Sandip Amrutrao Mozar,SATARA,IND,10,Graduate Professional,6204277,1745000,4459277
2587,1108,Sandip Kisanrao Wankhede,AKOLA,IND,0,Graduate,50000,0,50000
2588,1186,Sanganna A. Karadi,KOPPAL,BJP,1,10th Pass,12127000,6848000,5279000
2589,806,Sangeeta Kumari Singh Deo,BOLANGIR,BJP,3,Graduate,62357000,3817340,58539660
2590,3249,Sangram Keshari Jena,BHADRAK,INC,5,Post Graduate,10108428,23025000,0
2591,2054,Sanjay,SONIPAT,IND,0,10th Pass,15800000,0,15800000
2592,790,Sanjay Bhoi,BARGARH,INC,0,Graduate,25786368,3000000,22786368
2593,2462,Sanjay Choudhary,RAJSAMAND,IND,0,Graduate,9990000,420000,9570000
2594,985,Sanjay Gandhi,CHANDNI CHOWK,Braj Vikas Party,0,12th Pass,151747504,0,151747504
2595,3159,Sanjay Kapoor,PILIBHIT,INC,0,Graduate Professional,76385000,3330000,73055000
2596,35,Sanjay Kewat,KARAKAT,BSP,0,Graduate,1997000,0,1997000
2597,596,Sanjay Kothari,DHARWAD,IND,0,Graduate,2958023,0,2958023
2598,2713,Sanjay Kumar,NALANDA,BSP,0,10th Pass,920000,25000,895000
2599,2433,Sanjay Kumar,CHITTORGARH,BSP,0,10th Pass,5560400,700000,4860400
2600,2311,Sanjay Kumar,ALIGARH,IND,0,5th Pass,1000,0,1000
2601,3162,Sanjay Kumar,PILIBHIT,Naitik Party,0,Literate,47000,32000,15000
2602,502,Sanjay Kumar Rai,SOUTH DELHI,BSP,1,12th Pass,5839937,0,5839937
2603,3279,Sanjay Kumar Sahoo,CUTTACK,IND,0,Others,1050960,0,1050960
2604,3382,Sanjay Laxman Padwal,PUNE,Bhartiya Navjawan Sena (Paksha),0,10th Pass,95000,0,95000
2605,1388,Sanjay Mahadev Wankhade,BULDHANA,IND,0,Graduate,2037000,260000,1777000
2606,17,Sanjay Maurya,FARIDABAD,IND,0,8th Pass,143541,0,143541
2607,469,Sanjay Meshack,ANDAMAN & NICOBAR ISLANDS,AAP,0,10th Pass,57497526,633088,56864438
2608,1493,Sanjay Nilkanth Gawande,CHANDRAPUR,IND,0,12th Pass,2170000,0,2170000
2609,3533,Sanjay Sadashiv Mandalik,KOLHAPUR,SHS,0,Post Graduate,11672709,920570,10752139
2610,1399,Sanjaybhau Narayanrao Chidam,WARDHA,IND,0,12th Pass,5610091,50000,5560091
2611,3655,Sanjaykaka Patil,SANGLI,BJP,0,10th Pass,108791027,19198050,89592977
2612,1679,Sanjeev Kumar,GHAZIABAD,IND,0,Post Graduate,5671309,0,5671309
2613,2822,Sanjeev Kumar Mahato,GIRIDIH,IND,0,12th Pass,813000,0,813000
2614,2974,Sanjeev Kumar Mishra,KHAJURAHO,AIFB,0,12th Pass,401000,0,401000
2615,2249,Sanjit Kumar Das,KARIMGANJ,IND,0,10th Pass,640607,0,640607
2616,2000,Sanjiv Bhojraj,SIRSA,VANCHITSAMAJ INSAAF PARTY,1,10th Pass,106000,0,106000
2617,2819,Sanjiv Kumar Sinha,GIRIDIH,AIFB,0,Graduate,646296,120000,526296
2618,45,Sankar Prasad Datta,TRIPURA WEST,CPI(M),1,Post Graduate,1320900,0,1320900
2619,824,Sankar Sahu,ASKA,CPI(ML) Red star,0,Post Graduate,1294992,0,1294992
2620,444,Sant Dharamvir Chotiwala,SONIPAT,IND,0,Graduate Professional,30110000,50000,30060000
2621,1966,Santhosh Kumar,PATHANAMTHITTA,IND,3,Graduate Professional,1081000,0,1081000
2622,1202,Santhoshmohan,HASSAN,AAP,0,Graduate Professional,23700200,100000,23600200
2623,2332,Santosh Ahlawat,JHUNJHUNU,BJP,0,Post Graduate,35897048,5704000,30193048
2624,2923,Santosh Bharti,DAMOH,AAP,3,Others,15854961,5569039,10285922
2625,2810,Santosh Chandrakar,RAJNANDGAON,GGP,0,10th Pass,4656512,325188,4331324
2626,3084,Santosh Gangwar,BAREILLY,BJP,0,Graduate Professional,38602862,1777215,36825647
2627,3068,Santosh Kumar,BADAUN,RPI(A),0,Not Given,857849,0,857849
2628,378,Santosh Kumar,AURANGABAD,BSP,2,Graduate,130000,0,130000
2629,2791,Santosh Kumar Dhruw,KANKER,AAP,0,Graduate,195543,0,195543
2630,3678,Santosh Madhukar Roham,SHIRDI,Bahujan Mukti Party,0,Graduate,3430530,901903,2528627
2631,2109,Santosh Manjunath Shet(Raikar),BELGAUM,IND,0,10th Pass,3592220,0,3592220
2632,2102,Santosh Manohar Bavadekar,BELGAUM,IND,1,Graduate,115082,0,115082
2633,3868,Santosh Namdeorao Sagne,HINGOLI,Awami Vikas Party,0,Others,1671000,1035000,636000
2634,3640,Santosh Pawar,PUNE,IND,0,Graduate,3229500,0,3229500
2635,3413,Sanwar Lal,AJMER,NCP,0,5th Pass,1092020,0,1092020
2636,3412,Sanwar Lal Jat,AJMER,BJP,0,Doctorate,18064656,0,18064656
2637,1911,Sarah Joseph,THRISSUR,AAP,0,Post Graduate,4122398,0,4122398
2638,3480,Sarangthem Manaobi,INNER MANIPUR,AITC,0,Post Graduate,920000,0,920000
2639,1147,Saraswati Nanda,BOLANGIR,AAP,0,Post Graduate,279095,0,279095
2640,3250,Sarat Das,BHADRAK,BJP,0,Post Graduate,1241350,309933,931417
2641,222,Sarat Pattnayak,BOLANGIR,INC,0,Graduate Professional,43999656,818572,43181084
2642,583,Saravanan,ANDAMAN & NICOBAR ISLANDS,IND,0,Graduate,236000,0,236000
2643,517,Sarbananda Sonowal,LAKHIMPUR,BJP,0,Graduate Professional,14497515,0,14497515
2644,3147,Sarika,NAGINA,AAP,2,Graduate,400000,0,400000
2645,3409,Sarode Popat Rambhau,SHIRDI,Lok Bharati,0,12th Pass,272400,250000,22400
2646,3003,Saroj Katiyar Kurmi,SAGAR,BSP,0,Post Graduate,24415594,1590878,22824716
2647,1157,Saroj Kumar Naik,KALAHANDI,BSP,0,Graduate,5880000,120000,5760000
2648,3238,Saroj Kumar Panda,BALASORE,IND,0,Graduate,570000,0,570000
2649,365,Saroj Ram,SASARAM,Bahujan Mukti Party,0,Graduate Professional,2255786,80350,2175436
2650,4085,Sarvesh Kumar Saini,AMROHA,SHS,2,10th Pass,12800000,800000,12000000
2651,1845,Saseendran,VADAKARA,BSP,0,5th Pass,3271000,250000,3021000
2652,1810,Sasidharan K V,KANNUR,AAP,0,Post Graduate,2730285,360000,2370285
2653,12,Sasikala K S,MAVELIKKARA,SUCI(C),0,12th Pass,2700,0,2700
2654,705,Sasikkuttan Vakathanam,KOTTAYAM,CPI(ML) Red star,0,10th Pass,361750,0,361750
2655,2985,Satandra Singh (Tony Tomar),MORENA,IND,0,Literate,238000,0,238000
2656,3527,Satav Atmaram Raghoji,HINGOLI,IND,0,8th Pass,500,500,0
2657,3528,Satav Raju Shankar,HINGOLI,IND,1,Literate,139000,0,139000
2658,431,Satbir,HISAR,IND,0,5th Pass,4959708,0,4959708
2659,1851,Satheesh Chandran,WAYANAD,AITC,0,Literate,112000,0,112000
2660,3579,Sathi Bashir Ahmed Bashamiyan Shaikh,MADHA,IND,0,Literate,2054596,16968,2037628
2661,265,Sathyan Mokeri,WAYANAD,CPI,2,Graduate,3697322,502699,3194623
2662,1857,Sathyan Puthanveettil,WAYANAD,IND,0,8th Pass,226000,0,226000
2663,1859,Sathyan Thazhemangad,WAYANAD,IND,0,Literate,47000,0,47000
2664,1834,Satish Asangihal,BIJAPUR,IND,0,Graduate Professional,20500,0,20500
2665,3928,Satish Babu Naidu,BHOPAL,IND,0,10th Pass,142015,0,142015
2666,3129,Satish Chandra Sharma,MORADABAD,Naitik Party,0,8th Pass,937285,711000,226285
2667,932,Satish Gokuldas Pendam,GADCHIROLI-CHIMUR,AITC,0,Graduate Professional,16000,0,16000
2668,676,Satish Kumar,GAUTAM BUDHHA NAGAR,BSP,1,12th Pass,599501967,201428322,398073645
2669,682,Satish Kumar,ALIGARH,BJP,1,10th Pass,52180006,754800,51425206
2670,619,Satish Kumar,NAWADA,IND,0,10th Pass,11610000,0,11610000
2671,1139,Satish Kumar Minz,SUNDARGARH,IND,0,Post Graduate,3008000,0,3008000
2672,2341,Satish Kumar Sharma,SIKAR,Jago Party,0,Post Graduate,903500,5000,898500
2673,1029,Satish Kumar Singal,KURUKSHETRA,IND,0,Post Graduate,8105000,0,8105000
2674,886,Satish Poonchi,JAMMU,IND,0,10th Pass,2513000,0,2513000
2675,452,Satpal,ROHTAK,IND,0,10th Pass,3998000,0,3998000
2676,2073,Satpal S/O Lokram,BHIWANI-MAHENDRAGARH,IND,0,12th Pass,1754500,1945000,0
2677,2074,Satpal S/O Sube,BHIWANI-MAHENDRAGARH,IND,0,12th Pass,2766000,1700000,1066000
2678,2718,Satya Nand Sharma,NALANDA,LJP,0,Literate,12818500,0,12818500
2679,2055,Satya Narayan,SONIPAT,IND,0,10th Pass,14173000,0,14173000
2680,811,Satya Narayan Mahar,KALAHANDI,AAP,1,Graduate,32332,0,32332
2681,41,Satya Narayan Singh,KARAKAT,IND,0,Graduate,19450824,2396194,17054630
2682,3189,Satya Pal Singh,SAMBHAL,BJP,0,Post Graduate,19904379,0,19904379
2683,2426,Satya Prakash Sharma,BHILWARA,IND,0,12th Pass,536875,0,536875
2684,1786,Satyalal Sarkar,JALPAIGURI,BJP,0,Graduate,12290350,1267598,11022752
2685,2836,Saurabh Narain Singh,HAZARIBAGH,INC,2,Post Graduate,415506982,0,415506982
2686,3131,Saurabh Pratap Singh,MORADABAD,AITC,0,Post Graduate,729238,0,729238
2687,3023,Savio Oliver Rodrigues,SOUTH GOA,Goa Su-Raj Party,0,Graduate Professional,1892000,0,1892000
2688,2041,Savitri,KARNAL,IND,0,Illiterate,3700000,200000,3500000
2689,1708,Savitri,GAUTAM BUDHHA NAGAR,IND,0,10th Pass,20577047,0,20577047
2690,1521,Sawake Ramkrushna Pundlikrao,YAVATMAL-WASHIM,CPI(ML) Red star,0,10th Pass,612264,0,612264
2691,3083,Sayad Rashid Ali,BAREILLY,IND,0,Post Graduate,6894000,0,6894000
2692,3684,Sayaji Shankar Kharat,SHIRDI,IND,0,Post Graduate,4602900,1222000,3380900
2693,3332,Sayed Abdul Rahim,PARBHANI,Welfare Party Of India,0,Graduate,259400,0,259400
2694,1460,Sayyad Afjalali Alias Chhanubhai,BHANDARA-GONDIYA,Minorities democratic party,0,5th Pass,1093000,0,1093000
2695,3609,Sayyad Mohamd Sayyad Ibrahim,OSMANABAD,Bahujan Mukti Party,0,Post Graduate,402248,0,402248
2696,3308,Sayyad Tanvir Sayyad Hamja,NANDED,Majlis Bachao Tahreek,0,8th Pass,50000,0,50000
2697,3888,Sayyed Minhaj Ali Sayyad Wajed Ali (Pendkhajurwale),BEED,IND,0,12th Pass,1125000,235000,890000
2698,3889,Sayyed Mubin Rahimtulla,BEED,IND,0,10th Pass,871000,2300000,0
2699,3887,Sayyed Navidujjamma,BEED,IND,1,Graduate,2539615,0,2539615
2700,3890,Sayyed Salim Fattu,BEED,IND,1,Illiterate,60000,275000,0
2701,610,Seetharaman.E,BANGALORE CENTRAL,IND,0,10th Pass,1283611,0,1283611
2702,2850,Sekh Akhiruddin,JAMSHEDPUR,Jharkhand Party (Naren),0,8th Pass,1535000,0,1535000
2703,965,Seleena Prakkanam,PATHANAMTHITTA,BSP,2,12th Pass,25500,0,25500
2704,1444,Senapati Uttam Sapan,NAGPUR,IND,1,5th Pass,398038,0,398038
2705,1738,Seshraj,SAHARANPUR,IND,0,Others,106068354,0,106068354
2706,3012,Sewak Ram Ahirwar,TIKAMGARH,BSP,1,12th Pass,1982450,29199,1953251
2707,909,Seyyed Mohammed Khasim.K,LAKSHADWEEP,SP,2,12th Pass,5236685,0,5236685
2708,1629,Shabnam,MUZAFFARNAGAR,IND,0,Literate,805000,0,805000
2709,1918,Shafeer Muhammed,CHALAKUDY,SDPI,3,10th Pass,1435046,170695,1264351
2710,3725,Shafi Ahmed,BANGALORE CENTRAL,IND,0,5th Pass,1025000,0,1025000
2711,1737,Shahanavaj,SAHARANPUR,Rashtriya Janmorcha,0,12th Pass,919230,0,919230
2712,1281,Shahid,SOUTH DELHI,IND,0,10th Pass,5305000,0,5305000
2713,1635,Shahid Manzoor,MEERUT,SP,0,Post Graduate,34814614,231000,34583614
2714,2530,Shahid Sharif,NAGPUR,JD(U),0,Graduate,1450325,0,1450325
2715,54,Shahjan Masood Urf Shahdan,SAHARANPUR,SP,2,Graduate,11192498,0,11192498
2716,57,Shahnawaj Rana,BIJNOR,SP,11,Graduate Professional,145562257,54311908,91250349
2717,3307,Shaikh Afajaloddin Azimoddin,NANDED,Lok Bharati,0,Not Given,1650000,0,1650000
2718,3883,Shaikh Chand Shiakh Miya,BEED,IND,0,Literate,50000,0,50000
2719,3859,Shaikh Iptekhar Zakeebaba,BEED,Welfare Party Of India,0,12th Pass,35000,0,35000
2720,1499,Shaikh Jabbar Shaikh Usuf,YAVATMAL-WASHIM,IND,0,8th Pass,500,0,500
2721,3610,Shaikh Mubarak Mainoddin,OSMANABAD,IND,0,5th Pass,80000,0,80000
2722,3518,Shaikh Nayeem Shaikhlal,HINGOLI,SP,0,12th Pass,9355936,270817,9085119
2723,3371,Shaikh Nurjaha Yasin,MAVAL,IND,0,8th Pass,18451152,0,18451152
2724,3500,Shaikh Shabbir Nabi,HATKANANGLE,Maharashtra Parivartan Sena (T),0,Literate,150000,150000,0
2725,3884,Shaikh Shafiq Shabbir,BEED,IND,1,10th Pass,109000,0,109000
2726,3586,Shaikh Shahajan Paigambar,MADHA,IND,0,5th Pass,145000,0,145000
2727,1314,Shailender Kumar,NORTH WEST DELHI,IND,0,Graduate,620000,10000,610000
2728,2909,Shailendra Kumar Shaili,BHOPAL,CPI,0,Post Graduate,8582000,0,8582000
2729,2937,Shailendra Singh Kushwah,GUNA,AAP,0,Graduate,3626314,2075000,1551314
2730,846,Shailendrakumar Patil,DHARWAD,IND,1,Graduate,35000,0,35000
2731,2716,Shailesh Kumar,NALANDA,Ati Picchara party,0,Graduate Professional,4445777,0,4445777
2732,15,Shajar Khan,THIRUVANANTHAPURAM,SUCI(C),0,Post Graduate,26800,0,26800
2733,957,Shajumon Vattekad,ALATHUR,BJP,0,10th Pass,1772801,32653,1740148
2734,1366,Shakeel Ahmed,EAST DELHI,Jai Maha Bharath Party,0,12th Pass,882000,0,882000
2735,2190,Shakil Dodawad,DHARWAD,IND,0,5th Pass,97000,0,97000
2736,2539,Shakil Wasi Ahamad,NAGPUR,IND,0,Not Given,0,0,0
2737,2991,Shakti Singh Tomar,MORENA,Rashtriya Ahinsa Manch,0,12th Pass,607700,0,607700
2738,3024,Shalom Mathew Francisco Sardinha,SOUTH GOA,IND,0,Graduate Professional,32828000,2340017,30487983
2739,2782,Sham Lal,UDHAMPUR,All J & K Kisan Majdoor Party,0,8th Pass,817000,0,817000
2740,2133,Shamala,BIDAR,IND,0,Not Given,9178000,1000000,8178000
2741,1400,Shambaba Alias Shamsundar Panjabrao Nichit,WARDHA,IND,0,Post Graduate,4155000,700000,3455000
2742,1402,Shambharkar Rajendra Gulabrao,WARDHA,IND,3,Doctorate,174963,0,174963
2743,2639,Shambhu Prasad Sharma,ARRAH,Hindustan Vikas Dal,0,Graduate Professional,300000,0,300000
2744,855,Shambulingegowda,BANGALORE SOUTH,IND,0,8th Pass,1222243,0,1222243
2745,3152,Shamsher,NAGINA,IND,0,8th Pass,101000,0,101000
2746,209,Shamsher Singh Kharkara,ROHTAK,INLD,0,Post Graduate,242943888,0,242943888
2747,758,Shanbhulal,MANDLA,BSP,0,10th Pass,1275000,0,1275000
2748,20,Shandar Gufran,MUZAFFARNAGAR,IND,0,Post Graduate,7268197,661855,6606342
2749,2645,Shankar Dayal Paswan,ARRAH,IND,4,Others,1525000,2500,1522500
2750,175,Shankar Jadhav,GULBARGA,Bharatiya Peoples Party,0,Graduate,3400000,0,3400000
2751,1587,Shankar Kansre,BALAGHAT,IND,0,Graduate Professional,5925841,1500000,4425841
2752,1150,Shankar Kumar Patra,BOLANGIR,Aama Odisha Party,0,Post Graduate,10380000,0,10380000
2753,3437,Shankar Lal Darji,JALORE,IND,0,5th Pass,543500,0,543500
2754,2704,Shankar Prasad,MUNGER,Bahujan Mukti Party,2,Graduate,40253000,0,40253000
2755,595,Shankar Ram Thakur,BASTAR,SP,0,Graduate,12430000,8000,12422000
2756,1184,Shankar Rathod,BELGAUM,IND,0,10th Pass,4650000,0,4650000
2757,2522,Shankarappa,BANGALORE RURAL,Jai Vijaya Bharathi Party,0,10th Pass,45000,0,45000
2758,1146,Shankarlal Agrawala,SAMBALPUR,"Proutist Bloc, India",0,12th Pass,16466020,0,16466020
2759,2137,Shanker Bhayya,BIDAR,BSP,0,Others,7520141,0,7520141
2760,2434,Shanti Lal Trivedi,CHITTORGARH,CPI(ML)L,0,10th Pass,2289690,96000,2193690
2761,3692,Sharad Bansode,SOLAPUR,BJP,1,Graduate Professional,60152887,7604375,52548512
2762,263,Sharafudheen,VADAKARA,IND,0,12th Pass,1119368,0,1119368
2763,567,Sharanabasappa Malakajappa,GULBARGA,SUCI(C),0,Graduate,12500,0,12500
2764,3151,Sharishtha Kumar Singh,NAGINA,Jai Maha Bharath Party,0,Graduate,5632000,0,5632000
2765,3864,Sharmila Baba Wakshe,SANGLI,IND,0,Graduate,723500,0,723500
2766,2698,Sharwan Kumar Anand,MUNGER,IND,0,Post Graduate,5750,0,5750
2767,2040,Shashi Saini,KARNAL,IND,0,Post Graduate,73585000,0,73585000
2768,2734,Shashi Yadav,NALANDA,CPI(ML)L,1,Graduate,14000,0,14000
2769,3637,Shashikant Bhikaji Owhal,PUNE,IND,0,Graduate,1318000,0,1318000
2770,3716,Shatrudhan Shah,PATALIPUTRA,Bharatiya Ekta Dal,0,10th Pass,2030000,50000,1980000
2771,88,Shatrughan Sinha,PATNA SAHIB,BJP,1,Graduate,1317405961,168760929,1148645032
2772,2357,Shayam Singh Rathore,JAIPUR RURAL,Lok Shakti,0,Others,20778000,3400,20774600
2773,674,Shazia Ilmi Malik,GHAZIABAD,AAP,1,Post Graduate,303342609,41846167,261496442
2774,962,Sheeba K A,ALATHUR,INC,0,Post Graduate,2903410,1310606,1592804
2775,2905,Sheeba Malik,BHOPAL,SP,3,12th Pass,5775435,0,5775435
2776,3021,Sheel Chandra Ahirwar,TIKAMGARH,IND,0,10th Pass,373600,34000,339600
2777,3149,Sheesh Ram Singh Ravi,NAGINA,Peace Party,0,Graduate,21393387,3830925,17562462
2778,3286,Shekh Faruk,KENDRAPARA,BSP,1,10th Pass,1346000,0,1346000
2779,1110,Shekh Hamid Imam,AKOLA,Bahujan Mukti Party,0,Graduate,3736459,483872,3252587
2780,3683,Shende Ravindra Vitthal,SHIRDI,IND,0,8th Pass,6316274,2363899,3952375
2781,2660,Sheo Gopal Chaudhry,BUXAR,IND,0,Graduate,1010000,0,1010000
2782,3476,Sher Singh,PALI,IND,0,8th Pass,6271914,752000,5519914
2783,2072,Sher Singh,BHIWANI-MAHENDRAGARH,IND,0,10th Pass,1200000,500000,700000
2784,3544,Sheregar Chetan Venkatesh,KOLHAPUR,IND,0,12th Pass,825000,173475,651525
2785,651,Shibun Lyngdoh,SHILLONG,BJP,0,Graduate,75894099,7061466,68832633
2786,2173,Shiddappa Kallappa Pujar,HAVERI,IND,0,10th Pass,50500,0,50500
2787,1968,Shilvin Kottackakathu,PATHANAMTHITTA,IND,0,Others,33956316,1491421,32464895
2788,2284,Shimla Devi Nayak,GANGANAGAR,National Unionist Zamindara Party,0,Post Graduate,3466420,784068,2682352
2789,3306,Shinde Balaji Vishwanathrao,NANDED,SP,0,Graduate Professional,18406800,3237539,15169261
2790,3612,Shinde Rajendra Bhairavnath,OSMANABAD,Maharashtra Parivartan Sena (T),0,Graduate,500000,0,500000
2791,3704,Shinde Rajkumar Laxmanrao,SOLAPUR,IND,0,12th Pass,879456,0,879456
2792,3563,Shinde Sudhir Shripatrao,LATUR,IND,0,Graduate Professional,330626,300000,30626
2793,3693,Shinde Sushilkumar Sambhajirao,SOLAPUR,INC,0,Graduate Professional,234700792,150000,234550792
2794,3007,Shitin Kesherwani,SAGAR,IND,0,12th Pass,331000,0,331000
2795,1745,Shiv Kumar,SAHARANPUR,Ambedkar Samaj Party,0,8th Pass,220619,0,220619
2796,2027,Shiv Kumar,HISAR,IND,0,10th Pass,305500,0,305500
2797,388,Shiv Kumar Kant,GAYA,BSP,0,Graduate,5232500,200000,5032500
2798,384,Shiv Shankar Kumar,GAYA,Bharat Bhrashtachar Mitao Party,0,Graduate,1067800,0,1067800
2799,2960,Shiv Singh Kushawah,GWALIOR,Mahanwadi Party,0,8th Pass,5469000,0,5469000
2800,2831,Shiva Mahto,GIRIDIH,IND,0,8th Pass,2050000,0,2050000
2801,563,Shivagoudappa Balappa Khanagoudar,BELGAUM,IND,0,Graduate Professional,1828000,0,1828000
2802,3638,Shivaji Pandurang Adhav,PUNE,IND,0,Graduate Professional,2459700,715000,1744700
2803,3293,Shivakumar,TUMKUR,IND,0,10th Pass,1850000,0,1850000
2804,180,Shivakumar Chakari Urf Talawar,HAVERI,IND,0,Post Graduate,1180000,0,1180000
2805,3799,Shivakumar Navalisiddappa Tontapur,KOPPAL,AAP,0,Graduate,2725000,460000,2265000
2806,1215,Shivalingaiah,MANDYA,BJP,0,Doctorate,130363533,16531000,113832533
2807,3758,Shivamallu,CHAMARAJANAGAR,BSP,0,Post Graduate,1471630,266375,1205255
2808,1199,Shivashankar. G. R.,BANGALORE SOUTH,AIFB,0,Post Graduate,32522829,7800000,24722829
2809,3552,Shivkhandeshwar Narayan Dahge,LATUR,Bharatiya Jawala Shakti Paksha,0,10th Pass,1032000,30000,1002000
2810,1248,Shivnath Sav,KODARMA,IND,0,8th Pass,911000,121000,790000
2811,182,Shobha Karandlaje,UDUPI CHIKMAGALUR,BJP,0,Post Graduate,72089452,38119792,33969660
2812,3470,Shobharam Mali,PALI,Jai Maha Bharath Party,0,10th Pass,2690500,0,2690500
2813,1941,Shoby Joseph,IDUKKI,IND,1,Others,10500,151600,0
2814,2151,Shravan,BIDAR,Rashtriya Samaj Paksha,0,12th Pass,503900,50000,453900
2815,2028,Shravan Kumar Asija,HISAR,IND,0,12th Pass,2380000,0,2380000
2816,2774,Shree Kant Labh,PATNA SAHIB,Samajwadi Janata Party (Rashtriya),2,Post Graduate,57881,0,57881
2817,1077,Shreekant Kabadi,DHARWAD,IND,0,Graduate,9950010,427000,9523010
2818,501,Shri Chand Tanwar,SOUTH DELHI,CPI,0,8th Pass,7002415,0,7002415
2819,3590,Shri Chavan Ashokrao Shankarrao,NANDED,INC,0,Post Graduate,388758910,30513286,358245624
2820,2975,Shri Dhar Khare,KHAJURAHO,IND,0,8th Pass,5271817,0,5271817
2821,2505,Shri Parikshit Debbarma,TRIPURA EAST,BJP,0,10th Pass,1382000,30900,1351100
2822,1532,Shri Ram,SATNA,IND,0,Post Graduate,5309000,0,5309000
2823,765,Shri Subhash Shukla,CHHINDWARA,SP,0,12th Pass,380000,0,380000
2824,3485,Shridhar Jakhuji Darekar,AHMEDNAGAR,IND,0,Graduate Professional,15269913,864552,14405361
2825,1833,Shridhar Narayankar,BIJAPUR,AAP,0,Others,9261841,2133500,7128341
2826,2540,Shridhar Salve,NAGPUR,IND,0,12th Pass,300000,0,300000
2827,3885,Shrikant Vishnu Gadale,BEED,IND,0,10th Pass,45071,0,45071
2828,3240,Shrikanta Kumar Jena,BALASORE,INC,0,Graduate,11729649,5454370,6275279
2829,2219,Shrilatha Shetty,SHIMOGA,IND,0,10th Pass,1268000,337000,931000
2830,1813,Shrimant Balasaheb Patil,CHIKKODI,JD(S),5,Graduate,223524192,136392288,87131904
2831,562,Shrinik Annasaheb Jangate,CHIKKODI,IND,0,12th Pass,500500,0,500500
2832,1979,Shripad Yesso Naik,NORTH GOA,BJP,0,Graduate,37019154,837843,36181311
2833,3865,Shrirang Baburao Pakhare,SANGLI,IND,0,5th Pass,550000,0,550000
2834,867,Shruti Choudhry,BHIWANI-MAHENDRAGARH,INC,0,Graduate Professional,1083115000,106873000,976242000
2835,2101,Shushila,FARIDABAD,IND,0,10th Pass,40072745,0,40072745
2836,2269,Shuvadip Datta,SILCHAR,IND,0,12th Pass,6123000,365707,5757293
2837,2651,Shweta Pathak,BUXAR,AAP,0,Graduate,6953992,0,6953992
2838,1262,Shyam Lal Ram,PALAMAU,IND,0,Graduate,31205,0,31205
2839,2422,Shyam Lal Salvi,BHILWARA,IND,0,Post Graduate,999000,55000,944000
2840,2652,Shyam Lal Singh Kushwaha,BUXAR,JD(U),0,10th Pass,81811000,1932000,79879000
2841,2773,Shyam Nandan Prasad,PATNA SAHIB,IND,1,Doctorate,36572000,943000,35629000
2842,3713,Shyam Sundar Hansdah,MAYURBHANJ,INC,0,Graduate,32158487,9116999,23041488
2843,2401,Shyam Sunder Sharma,KOTA,IND,0,Graduate,1078797,0,1078797
2844,2599,Shyamkumar Bapurao Lokhande,YAVATMAL-WASHIM,IND,0,Graduate,3564000,0,3564000
2845,1527,Shyamlal Kushwaha,SATNA,GGP,0,Post Graduate,2689000,0,2689000
2846,1882,Shylock P.V.,PONNANI,AAP,1,Graduate,3748638,3000000,748638
2847,1158,Siba Hati,KALAHANDI,SP,0,8th Pass,1474000,100000,1374000
2848,1173,Sibasankar Ulaka,KORAPUT,BJP,1,Others,16500000,1750000,14750000
2849,359,Siddappa Ganji,BIJAPUR,IND,0,12th Pass,128000,0,128000
2850,2152,Siddaramappa,BIDAR,IND,0,10th Pass,102000,0,102000
2851,3775,Siddesh,DAVANAGERE,IND,0,12th Pass,19035000,400000,18635000
2852,3866,Siddha Shivappa Bhosale,SANGLI,IND,0,5th Pass,126813,0,126813
2853,2967,Siddharth Kushwaha,KHAJURAHO,SP,1,Graduate,16254183,3200000,13054183
2854,1481,Siddharth Raut,CHANDRAPUR,Prabuddha Republican Party,0,Post Graduate,3927422,1000000,2927422
2855,3613,Siddik Ibrahim Boudiwali,OSMANABAD,IND,0,10th Pass,690000,50000,640000
2856,118,Sidhant Mohapatra,BERHAMPUR,BJD,0,Post Graduate,16462430,1183828,15278602
2857,3705,Sidram Krishna Dhobale,SOLAPUR,IND,0,5th Pass,66447,0,66447
2858,714,Silvi Sunil,IDUKKI,AAP,0,Others,3080470,45000,3035470
2859,1239,Sima Chandravansi,CHATRA,AAP,0,Graduate Professional,1535000,120000,1415000
2860,3361,Sima Dharmanna Manikadi,MAVAL,Prabuddha Republican Party,0,5th Pass,0,0,0
2861,1112,Sirsat Haridas Ankush,AMRAVATI,IND,0,5th Pass,686000,70000,616000
2862,2029,Sita Ram,HISAR,IND,0,Graduate,1200500,400000,800500
2863,1599,Sita Ram Sareyam,CHHINDWARA,IND,0,10th Pass,180000,0,180000
2864,2857,Sita Ram Tudu,JAMSHEDPUR,SUCI(C),0,12th Pass,373970,0,373970
2865,2056,Sitender Singh,SONIPAT,IND,0,Post Graduate,50000,0,50000
2866,2982,Siyaram Singh Choudri,MORENA,IND,0,10th Pass,162500,0,162500
2867,3334,Sk. Saleem,PARBHANI,Majlis Bachao Tahreek,0,5th Pass,60000,0,60000
2868,2779,Smt. Amrit Barsha,UDHAMPUR,SP,0,12th Pass,1500000,0,1500000
2869,3614,Smt. Jadhav Ujvala Eknath,OSMANABAD,IND,0,Graduate,1508000,600000,908000
2870,72,Smt. Kirron Kher,CHANDIGARH,BJP,0,Post Graduate,335343871,1886187,333457684
2871,68,Smt. Meenakshi Lekhi,NEW DELHI,BJP,0,Graduate Professional,349916470,3275562,346640908
2872,776,Smt. Prabhatai Madhukar Parlewar,BULDHANA,Narayani Sena,0,Post Graduate,11619000,0,11619000
2873,344,Smt. Priya K S,ATTINGAL,Welfare Party Of India,0,Post Graduate,4530512,0,4530512
2874,1702,Smt. Seema,GAUTAM BUDHHA NAGAR,Rashtriya Naujawan Dal,0,12th Pass,12201000,0,12201000
2875,956,Smt. Shobha Surendran,PALAKKAD,BJP,4,12th Pass,2027210,0,2027210
2876,230,Smt. Sumeeti,GAUTAM BUDHHA NAGAR,IND,0,8th Pass,1201712,675000,526712
2877,2890,Snehlata Jojo,SINGHBHUM,IND,0,Graduate Professional,2444000,0,2444000
2878,153,Sohail Anwer,NAWADA,BSP,0,Literate,415000,85000,330000
2879,3450,Sohan Lal Goyal,JODHPUR,IND,0,Graduate,13682000,277000,13405000
2880,2830,Sohrab Shah,GIRIDIH,Bahujan Mukti Party,0,Literate,50000,0,50000
2881,3892,Solanke Parmeshwar Kalyanrao,BEED,IND,0,Not Given,1683000,70000,1613000
2882,3893,Solanke Prkash Bhagwanrao,BEED,IND,0,5th Pass,1593500,0,1593500
2883,1324,Solomon George,NEW DELHI,BSP,0,Post Graduate,1501750,0,1501750
2884,2444,Soma Lal Koted,BANSWARA,Bahujan Mukti Party,0,12th Pass,12080300,0,12080300
2885,1913,Soman Pillai,THRISSUR,Indian Gandhiyan Party,0,Not Given,0,0,0
2886,382,Somaru Paswan,AURANGABAD,IND,0,Literate,3269500,0,3269500
2887,1938,Somini Prabhakaran,IDUKKI,IND,0,10th Pass,67800,10000,57800
2888,354,Somkuvar Vijay Sitaram,NAGPUR,IND,0,Not Given,104000,0,104000
2889,3691,Sonali Chandrashekhar Thorat,SHIRUR,IND,0,8th Pass,630000,0,630000
2890,3707,Sonawane Shivaji Chandrakant,SOLAPUR,IND,1,10th Pass,1289714,0,1289714
2891,888,Soni Soree,BASTAR,AAP,2,12th Pass,195000,250000,0
2892,1705,Sonia Sharma,GAUTAM BUDHHA NAGAR,Akhil Bharatiya Samajwadi Congress,0,Graduate,3327000,160000,3167000
2893,3697,Sonkamble Gautam Vijaykumar,SOLAPUR,Bharipa Bahujan Mahasangh,0,Graduate Professional,1729000,200000,1529000
2894,3324,Sontakke Laxman Kishan,NANDED,IND,0,12th Pass,10000,0,10000
2895,535,Soso Lorho,OUTER MANIPUR,NPF,0,Graduate,13445800,0,13445800
2896,1878,Sreedharan,MALAPPURAM,IND,0,5th Pass,409000,0,409000
2897,1893,Sreejith,PALAKKAD,IND,0,Post Graduate,304185,158610,145575
2898,309,Sreeni Jacob,KOTTAYAM,BSP,0,12th Pass,4000,0,4000
2899,1293,Sreerupa Mitra Chaudhury,SOUTH DELHI,AITC,0,Post Graduate,11823944,3788624,8035320
2900,3287,Sri Baijayant Panda,KENDRAPARA,BJD,0,Graduate Professional,312432726,300000,312132726
2901,2593,Sri Basavanagideva Sharanaru,CHITRADURGA,IND,0,Post Graduate,489561,0,489561
2902,2644,Sri Bhagwan Singh Kushwaha,ARRAH,RJD,1,10th Pass,7973528,2039416,5934112
2903,2502,Sri Bikash Debbarma,TRIPURA EAST,Jai Maha Bharath Party,0,10th Pass,350000,1900000,0
2904,2504,Sri Karna Bijoy Jamatia,TRIPURA EAST,AAP,0,10th Pass,8410000,0,8410000
2905,2506,Sri. Hariharan K S,ATTINGAL,IND,0,Graduate Professional,2401400,0,2401400
2906,1972,Sri. Vakkom G Ajith,ATTINGAL,SHS,0,12th Pass,1120000,0,1120000
2907,342,Sri.Manoj Kumar,ATTINGAL,SDPI,2,Others,284000,199789,84211
2908,1971,Sri.Sambath Anilkumar,ATTINGAL,IND,0,8th Pass,3262,17000,0
2909,833,Srihari Patanaik,BERHAMPUR,IND,0,12th Pass,976119,723600,252519
2910,1062,Srikant Arakeri,BIJAPUR,Karunaadu Party,0,Graduate,875500,390000,485500
2911,825,Srilokanath Ratha,ASKA,INC,0,Post Graduate,39978228,0,39978228
2912,2236,Srinivasa,UDUPI CHIKMAGALUR,IND,0,5th Pass,2452000,2060000,392000
2913,669,Ssomendar Dhaka,BAGHPAT,AAP,0,Graduate Professional,6488116,250000,6238116
2914,163,Subal Bhowmik,TRIPURA WEST,IND,1,Graduate Professional,4620411,0,4620411
2915,3390,Subarnamala Deb Barma,TRIPURA EAST,Amra Bangalee,0,8th Pass,7485,0,7485
2916,3254,Subas Chandra Mallick,JAJPUR,SUCI(C),0,Graduate,6000,0,6000
2917,3031,Subash Biswas,JALPAIGURI,IND,0,5th Pass,2117232,0,2117232
2918,576,Subash Chander,JAMMU,All J & K Kisan Majdoor Party,0,8th Pass,606100,0,606100
2919,788,Subash Chouhan,BARGARH,BJP,0,Graduate,455867,0,455867
2920,512,Subhas Sen,DIBRUGARH,CPI(ML)L,0,12th Pass,7032268,0,7032268
2921,2131,Subhash Bhimsha Sindankera,BIDAR,IND,0,5th Pass,306000,0,306000
2922,1656,Subhash Chand Kashyap,BAGHPAT,IND,0,Post Graduate,2539312,200000,2339312
2923,2415,Subhash Chandra Baheria,BHILWARA,BJP,0,Graduate,142870042,8665902,134204140
2924,1776,Subhash Chikbaraik,ALIPURDUARS,SUCI(C),0,10th Pass,1344,0,1344
2925,3372,Subhash Gopalrao Bodhe,MAVAL,IND,0,8th Pass,5030000,500000,4530000
2926,4425,Subhash Maharia,SIKAR,IND,0,Graduate,74415150,3285722,71129428
2927,3673,Subhash Nivrutti Shilewant,SATARA,IND,0,12th Pass,34500,15000,19500
2928,627,Subhash Paswan,JAMUI,IND,0,Not Given,163000,0,163000
2929,2877,Subodh Kant Sahai,RANCHI,INC,1,Graduate Professional,258895068,3355000,255540068
2930,2866,Subodh Purty,KHUNTI,BSP,0,8th Pass,1060018,125000,935018
2931,2608,Subramanya Gowda K.,DAKSHINA KANNADA,IND,0,10th Pass,3695467,940000,2755467
2932,953,Subu Kechi,ARUNACHAL WEST,IND,1,Graduate Professional,785000,0,785000
2933,3337,Sucharita Mohanty,PURI,INC,0,Post Graduate,36546329,59551,36486778
2934,481,Sudarshan Bhagat,LOHARDAGA,BJP,0,Graduate,9031009,178967,8852042
2935,1084,Sudatta,DAKSHINA KANNADA,IND,0,10th Pass,326800,50000,276800
2936,2690,Suday Yadav,JAHANABAD,IND,0,10th Pass,4495000,0,4495000
2937,2876,Sudesh Kumar Mahto,RANCHI,AJSUP,0,Post Graduate,72986000,28544000,44442000
2938,1836,Sudhakar Kanamadi,BIJAPUR,BSP,0,Graduate,13314500,527933,12786567
2939,2596,Sudhakar Namdeorao Ghayawan,YAVATMAL-WASHIM,Republican Party of India (Khobragade),0,12th Pass,4025000,400000,3625000
2940,673,Sudhan Kumar,GHAZIABAD,SP,0,Graduate,180682500,0,180682500
2941,1235,Sudhanshu Suman,CHATRA,IND,0,Post Graduate,41861206,2258169,39603037
2942,63,Sudhansu Shekhar Bhaskar,JAMUI,RJD,0,Doctorate,13950638,1206926,12743712
2943,2237,Sudheer Kanchan,UDUPI CHIKMAGALUR,IND,0,Post Graduate,6657000,0,6657000
2944,164,Sudhindra Chandra Dasgupta,TRIPURA WEST,BJP,0,Graduate,2385517,0,2385517
2945,541,Sudhir Baban Surve,BULDHANA,AAP,0,Graduate,62153,0,62153
2946,2076,Sudhir Chandwas,BHIWANI-MAHENDRAGARH,IND,0,Graduate Professional,460000,0,460000
2947,3266,Sudhir Kumar Samal,DHENKANAL,INC,3,8th Pass,85901162,17484885,68416277
2948,1912,Sufeera K. P.,THRISSUR,SDPI,1,8th Pass,104500,36000,68500
2949,1978,Suhas Naik,NORTH GOA,CPI,1,Graduate Professional,4483000,15000,4468000
2950,3674,Suhas Vishwasrao Deshmukh,SATARA,IND,0,Graduate,214884,0,214884
2951,1792,Sujay Ghatak,DARJEELING,INC,0,Graduate,4787759,730303,4057456
2952,1338,Sujeet Jha,NEW DELHI,Bhartiya Janta Dal (Integrated),0,12th Pass,220000,40000,180000
2953,3222,Sujit Kumar Lugun,KEONJHAR,IND,0,12th Pass,5389000,64000,5325000
2954,2247,Sujit Mallick,KARIMGANJ,IND,0,10th Pass,200042,0,200042
2955,2262,Sukamal Das,SILCHAR,IND,0,8th Pass,25000,0,25000
2956,97,Sukanta Kumar Panigrahi,KANDHAMAL,BJP,2,Post Graduate,580000,120000,460000
2957,3428,Sukh Dev,JALORE,Awami Aamjan Party,0,5th Pass,2579600,80000,2499600
2958,1588,Sukharam Astkar Lanji,BALAGHAT,IND,0,Post Graduate,2102000,0,2102000
2959,1783,Sukhbilas Barma,JALPAIGURI,INC,0,Doctorate,26547600,0,26547600
2960,445,Sukhbir Singh,SONIPAT,IND,0,Post Graduate,35860077,2625000,33235077
2961,2075,Sukhbir Singh,BHIWANI-MAHENDRAGARH,IND,0,10th Pass,234171,0,234171
2962,3904,Sukhnandan Deshkar,MAHASAMUND,IND,0,8th Pass,7750000,465000,7285000
2963,1273,Sukhveer,FARIDABAD,Rashtriya Bahujan Congress Party,0,5th Pass,1303736,0,1303736
2964,3285,Sukumar Mallick,KENDRAPARA,IND,0,12th Pass,297207,0,297207
2965,2395,Suleman,JHALAWAR-BARAN,IND,0,8th Pass,150000,0,150000
2966,1014,Sulochana Devi,NAWADA,IND,0,Literate,7275000,800000,6475000
2967,450,Suman Singh,SONIPAT,BSP,0,10th Pass,21283460,450000,20833460
2968,1285,Sumant Kumar,SOUTH DELHI,IND,1,Graduate,26172006,250729,25921277
2969,2345,Sumedha Nand Saraswati,SIKAR,BJP,0,Others,34311,0,34311
2970,3891,Sumitrabai Dashrath Pawar,BEED,IND,0,Illiterate,0,0,0
2971,2030,Sunder,HISAR,IND,0,Literate,10170500,300000,9870500
2972,735,Sunder Lal Tiwari,REWA,INC,0,Graduate Professional,45035366,349790,44685576
2973,3150,Sunil,NAGINA,IND,0,10th Pass,942300,0,942300
2974,3461,Sunil,NAGAUR,IND,0,8th Pass,254232,0,254232
2975,2417,Sunil Agiwal,BHILWARA,AAP,0,Graduate Professional,43218483,11297000,31921483
2976,3648,Sunil Alias Yashwant Vasant Pednekar,RATNAGIRI SINDHUDURG,IND,0,10th Pass,1697200,125000,1572200
2977,2290,Sunil Bhadrawal,GANGANAGAR,Lok Dal,0,Graduate,1193000,0,1193000
2978,2906,Sunil Borse,BHOPAL,BSP,0,10th Pass,5058000,800000,4258000
2979,812,Sunil Chandra Naik,KALAHANDI,Odisha Jan Morcha,0,Graduate Professional,2900000,0,2900000
2980,1317,Sunil Chhikara,NORTH WEST DELHI,IND,3,Graduate Professional,32150000,0,32150000
2981,1448,Sunil Dattu Pendor,NAGPUR,Bahujan Mukti Party,0,Post Graduate,1218560,0,1218560
2982,1120,Sunil David Amravati,AMRAVATI,Bahujan Mukti Party,0,Graduate Professional,21139,0,21139
2983,1631,Sunil Dutt,MEERUT,IND,0,12th Pass,10218400,0,10218400
2984,1719,Sunil Gautam,GAUTAM BUDHHA NAGAR,IND,2,8th Pass,37800,0,37800
2985,2945,Sunil Gopal,GWALIOR,SUCI(C),0,Graduate Professional,119963,0,119963
2986,3088,Sunil Kumar,BAREILLY,AAP,0,Graduate,1919000,0,1919000
2987,1269,Sunil Kumar,ROHTAK,AITC,0,Graduate,339277,0,339277
2988,2758,Sunil Kumar,PATALIPUTRA,Samajwadi Janata Party (Rashtriya),0,12th Pass,800000,150000,650000
2989,1295,Sunil Kumar,SOUTH DELHI,IND,0,10th Pass,3125000,0,3125000
2990,657,Sunil Kumar Kasana,KAIRANA,AAP,0,12th Pass,20795589,1250000,19545589
2991,2753,Sunil Kumar Singh,PATALIPUTRA,IND,0,Post Graduate,123369500,61000,123308500
2992,1230,Sunil Kumar Singh,CHATRA,BJP,0,Post Graduate,174744806,950052,173794754
2993,3030,Sunil Pandit,DARJEELING,Rashtriya Janasachetan Party,0,8th Pass,848600,0,848600
2994,1307,Sunil Sourabh,WEST DELHI,IND,0,Post Graduate,4963000,0,4963000
2995,2628,Sunil.V.J,BANGALORE NORTH,IND,0,10th Pass,3845084,641000,3204084
2996,339,Sunilkrishnan,ATTINGAL,IND,2,Post Graduate,5310000,0,5310000
2997,656,Sunita,KAIRANA,JD(U),0,Graduate,120000,0,120000
2998,1342,Sunita Chaudhary,NEW DELHI,JKNPP,0,10th Pass,2129016,3180,2125836
2999,3056,Sunita Shakya,AONLA,BSP,0,12th Pass,46011233,0,46011233
3000,3215,Sunita Sujata Nagpal,SHAHJAHANPUR,Peace Party,0,Graduate,77086,0,77086
3001,3706,Sunita Vijaykumar Ughade,SOLAPUR,IND,0,Literate,133900,225000,0
3002,3348,Sunjoy Hans,BHUBANESWAR,Aama Odisha Party,0,10th Pass,659112136,143674099,515438037
3003,3272,Suparno Satpathy,DHENKANAL,Aama Odisha Party,0,Graduate,48872009,702378,48169631
3004,2606,Supreeth Kumar Poojary,DAKSHINA KANNADA,Hindustan Janta Party,0,10th Pass,1388000,142250,1245750
3005,3386,Supriya Sule,BARAMATI,NCP,0,Graduate,1139090851,0,1139090851
3006,3723,Suraiya Zaithoon,BANGALORE CENTRAL,IND,1,Others,85000,0,85000
3007,3530,Suraj Vishwanath Kondarwad,HINGOLI,IND,0,Graduate Professional,0,0,0
3008,3651,Surekha Alias Suraiyya Shahin Shaikh,SANGLI,Maharashtra Vikas Aghadi,0,Graduate,300000,0,300000
3009,200,Surender Kumar,SIRSA,IND,0,12th Pass,131500,0,131500
3010,893,Surender Kumar,CHANDIGARH,Bahujan Mukti Party,0,Graduate,304607,151340,153267
3011,979,Surender Singh,CHANDNI CHOWK,IND,0,Graduate,7902603,0,7902603
3012,3762,Surendra B. P.,CHAMARAJANAGAR,Sarva Janata Party,0,Graduate,272500,0,272500
3013,3421,Surendra Kumar Jain,AJMER,IND,0,Graduate,1242221,0,1242221
3014,2342,Surendra Kumar Phulwariya,SIKAR,IND,4,Post Graduate,70250,0,70250
3015,2347,Surendra Kumar Punia,SIKAR,AAP,0,Graduate Professional,15949561,3984000,11965561
3016,2670,Surendra Prasad Yadav,JAHANABAD,RJD,3,Not Given,49462901,1022720,48440181
3017,152,Surendra Rajvanshi,NAWADA,SP,0,Graduate,3385189,0,3385189
3018,146,Surendra Ram,SASARAM,IND,0,5th Pass,9289000,200000,9089000
3019,3044,Surendra Singh,AMROHA,IND,0,Post Graduate,36813206,0,36813206
3020,1797,Surendrajeet Singh Ahluwalia,DARJEELING,BJP,0,Graduate Professional,23377223,443035,22934188
3021,1731,Suresh,BULANDSHAHR,Jai Maha Bharath Party,0,8th Pass,126500,0,126500
3022,1974,Suresh,ATTINGAL,IND,0,8th Pass,2360000,0,2360000
3023,3846,Suresh,KOPPAL,IND,0,5th Pass,1600000,70000,1530000
3024,1977,Suresh,ATTINGAL,IND,0,10th Pass,56000,0,56000
3025,1181,Suresh Angadi,BELGAUM,BJP,1,Graduate Professional,417003065,366283849,50719216
3026,3494,Suresh Baburao Veer,BARAMATI,IND,0,10th Pass,3425000,15000,3410000
3027,3385,Suresh Khopade,BARAMATI,AAP,0,Graduate Professional,31870466,0,31870466
3028,2172,Suresh Maharudrappa Mundargi,HAVERI,Rani Chennamma Party,0,10th Pass,1162000,0,1162000
3029,1672,Suresh Pal,GHAZIABAD,Bharatiya Sarvodaya Kranti Party,0,12th Pass,63170,0,63170
3030,3867,Suresh Parth Mane (Nana),SANGLI,IND,0,12th Pass,154500,0,154500
3031,1143,Suresh Pujari,SAMBALPUR,BJP,0,Post Graduate,8684372,0,8684372
3032,1504,Suresh Rajaram Mukhmale,YAVATMAL-WASHIM,Maharashtra Vikas Aghadi,0,12th Pass,3280000,0,3280000
3033,3570,Suresh Shamrao Ghadge,MADHA,AITC,0,Literate,3000000,0,3000000
3034,2882,Suresh Toppo,RANCHI,Jharkhand Disom Party,0,Graduate,427491,0,427491
3035,2541,Suresh Udhavrao Shinde,NAGPUR,IND,0,Graduate Professional,2545000,0,2545000
3036,3507,Sureshdada Patil,HATKANANGLE,IND,0,Graduate,47349446,12294173,35055273
3037,898,Surinder Bhardwaj,CHANDIGARH,JD(U),0,Graduate,419506,0,419506
3038,2089,Surinder Kumar Khullar,GURGAON,IND,0,Graduate,15164593,3641000,11523593
3039,409,Surinder Pal Singh,AMBALA,AAP,0,Post Graduate,15369639,2104283,13265356
3040,2455,Surya Bhavani Singh Chawada,RAJSAMAND,IND,0,Graduate Professional,3121717,225545,2896172
3041,3529,Suryawanshi Ashok Bhagwanrao,HINGOLI,IND,0,Graduate Professional,10055500,175000,9880500
3042,3309,Suryawanshi Dattaram Balaji,NANDED,IND,0,8th Pass,7263132,841037,6422095
3043,3553,Suryawansi Sidharth Tukaram,LATUR,Bahujan Mukti Party,0,Doctorate,3537300,627000,2910300
3044,2707,Suryoday Paswan,MUNGER,Sankhyanupati Bhagidari Party,0,Graduate,627000,0,627000
3045,3252,Susanta Kumar Jena,BHADRAK,IND,0,10th Pass,15000,0,15000
3046,3639,Sushama Pandurang Gaikwad,PUNE,IND,0,10th Pass,30300,0,30300
3047,3508,Sushant Santosh Dige,HATKANANGLE,IND,0,12th Pass,2135600,610000,1525600
3048,427,Sushil Kaushik,HISAR,IND,0,Post Graduate,51500,0,51500
3049,371,Sushil Kumar Singh,AURANGABAD,BJP,5,Post Graduate,127845854,7321626,120524228
3050,430,Sushil Nidhi,HISAR,IND,0,12th Pass,2306220,800000,1506220
3051,3615,Sushilkumar Vinayak Padule,OSMANABAD,IND,0,10th Pass,25500,0,25500
3052,489,Sushma Mehta,PALAMAU,CPI(ML)L,6,12th Pass,2305547,651713,1653834
3053,1124,Sushma Vitthal Nagpure,BHANDARA-GONDIYA,IND,0,12th Pass,1060000,0,1060000
3054,2255,Sushmita Dev,SILCHAR,INC,1,Post Graduate,87495844,12008613,75487231
3055,61,Swadesh Ohri,NEW DELHI,Atulya Bharat Party,0,12th Pass,25102378,0,25102378
3056,1992,Swati Kerkar,SOUTH GOA,AAP,0,12th Pass,693648,0,693648
3057,2509,Syamalakumari,THIRUVANANTHAPURAM,IND,0,5th Pass,0,0,0
3058,3798,Syed Arif,KOPPAL,BSP,1,12th Pass,10000,5000,5000
3059,854,Syed Asif Bukhaari,BANGALORE CENTRAL,IND,0,12th Pass,325897,0,325897
3060,3041,Syed Kalbe Rushaid Rizvi,AMROHA,AAP,0,Others,5709549,25000,5684549
3061,3746,Syed Mehaboob,BANGALORE SOUTH,JD(U),0,12th Pass,5572310,0,5572310
3062,3753,Syed Rafiq Ahmed,BANGALORE SOUTH,IND,0,5th Pass,1981000,0,1981000
3063,3183,Syed Salman Ali,RAMPUR,AAP,0,Graduate,2118955,0,2118955
3064,2140,Syed Waheed,BIDAR,Bahujan Mukti Party,1,10th Pass,1425000,0,1425000
3065,2318,Syopat Ram,CHURU,Bharatiya Sant Mat Party,0,10th Pass,202400,0,202400
3066,1922,T D Baburajan,CHALAKUDY,IND,0,12th Pass,5278500,180000,5098500
3067,1953,T S Balakrishnan,ALAPPUZHA,IND,0,12th Pass,50,0,50
3068,3771,T V Manjunatha Gowda,CHIKKBALLAPUR,IND,0,10th Pass,7718000,300000,7418000
3069,2583,T. Dayananda,CHITRADURGA,IND,0,5th Pass,3483000,30000,3453000
3070,3751,T. E. Moses,BANGALORE SOUTH,IND,0,Not Given,7963850,0,7963850
3071,296,T. L. Santhosh,THRISSUR,IND,6,Not Given,7597000,530000,7067000
3072,278,T.Ayyappan,PONNANI,BSP,0,Post Graduate,3324000,0,3324000
3073,3292,T.Bhavana,CHITRADURGA,IND,0,10th Pass,100000,0,100000
3074,3779,T.D. Jagadeesha,HASSAN,IND,0,10th Pass,20000,0,20000
3075,1937,T.K.Tomy,IDUKKI,CPI(ML) Red star,0,Others,404000,0,404000
3076,2635,T.S.Chaitanya,BANGALORE NORTH,IND,0,Others,1203291,0,1203291
3077,954,T.Siddique,KASARAGOD,INC,7,Graduate Professional,6779637,1849149,4930488
3078,2580,T.Somesh,CHITRADURGA,IND,0,5th Pass,5488000,0,5488000
3079,952,Taba Taku,ARUNACHAL WEST,Lok Bharati,0,Graduate,6200000,0,6200000
3080,1415,Tadas Vilas Krushnaji,WARDHA,IND,0,Graduate,3118896,0,3118896
3081,405,Takam Sanjoy,ARUNACHAL WEST,INC,0,Graduate,105915042,0,105915042
3082,3653,Tanajirao Jagannath Jadhav(Chinchanikar),SANGLI,IND,0,Graduate,203614,76363,127251
3083,143,Tanish Orang,LAKHIMPUR,CPI(ML)L,0,8th Pass,295642,0,295642
3084,2661,Taphir Husain,BUXAR,Hindustan Vikas Dal,0,5th Pass,310000,0,310000
3085,247,Tapir Gao,ARUNACHAL EAST,BJP,0,Post Graduate,82370000,300000,82070000
3086,1144,Tarani Bhoi,SAMBALPUR,Paschimanchal Vikas Party,0,10th Pass,2587176,547876,2039300
3087,989,Tariq Mirza,CHANDNI CHOWK,RPI(A),0,8th Pass,110000,0,110000
3088,3616,Tarkase Pushpa,OSMANABAD,Hindusthan Nirman Dal,0,10th Pass,75000,0,75000
3089,3429,Tarun Kumar,JALORE,IND,0,10th Pass,255000,0,255000
3090,2248,Tarun Kumar Das,KARIMGANJ,AAP,0,10th Pass,391000,0,391000
3091,3853,Tate Ashok Santram,BEED,Ambedkarist Republican Party,0,12th Pass,25000,0,25000
3092,3263,Tathagata Satpathy,DHENKANAL,BJD,7,Others,35434099,0,35434099
3093,3388,Tatyaso Sitaram Tele,BARAMATI,JD(S),1,Literate,1366907,500000,866907
3094,3133,Teaj Singh Saini,MORADABAD,Rashtriya Samanta Dal,0,Illiterate,480000,0,480000
3095,1286,Tej Pal Singh,SOUTH DELHI,IND,0,10th Pass,2755320,0,2755320
3096,3144,Tej Singh,NAGINA,Ambedkar Samaj Party,0,Graduate,38907469,0,38907469
3097,3879,Tejas Ankush Ghumare,BEED,IND,1,Literate,20000,0,20000
3098,2404,Tejpal,KOTA,IND,0,Graduate,2112136,0,2112136
3099,232,Tejpal Singh,RAMPUR,IND,0,12th Pass,477625,0,477625
3100,2364,Tek Chand Sonwal,JAIPUR RURAL,Ambedkarite Party of India,0,12th Pass,3396640,0,3396640
3101,2491,Tek Nath Dhakal,SIKKIM,Sikkim Krantikari Morcha,0,Post Graduate,37669202,0,37669202
3102,364,Tetari Devi,SASARAM,CPI(ML)L,0,Literate,2138858,0,2138858
3103,2841,Tetri Urf Sheela Devi,HAZARIBAGH,BSP,0,10th Pass,5412000,3000,5409000
3104,4020,Thaddeus Lakra,RANCHI,IND,0,Graduate,5210000,0,5210000
3105,52,Thakare Rameshwar (Rameshwar) Sundarlal,BHANDARA-GONDIYA,SP,0,10th Pass,3700102,74000,3626102
3106,534,Thangso Baite,OUTER MANIPUR,INC,0,Post Graduate,5947000,880000,5067000
3107,1887,Thennilapuram Radhakrishnan,PALAKKAD,Welfare Party Of India,0,10th Pass,2994408,270000,2724408
3108,3807,Thimmappa Uppar,KOPPAL,Bharatiya Dr. B.R.Ambedkar Janta Party,0,10th Pass,1000423,0,1000423
3109,3813,Thimme Gowda,MYSORE,Sarva Janata Party,0,Literate,1272000,0,1272000
3110,2510,Thomas Joseph,THIRUVANANTHAPURAM,RPI(A),0,10th Pass,7850000,872906,6977094
3111,2518,Thopaiah C,BANGALORE RURAL,BSP,0,5th Pass,1315000,200000,1115000
3112,3504,Thorat Anandrao Tukaram,HATKANANGLE,IND,0,Graduate,1740000,0,1740000
3113,3854,Thorat Dhanraj Vitthal,BEED,Maharashtra Parivartan Sena (T),0,10th Pass,700000,0,700000
3114,3748,Thulasappa Dasar,BANGALORE SOUTH,IND,0,Post Graduate,1280000,0,1280000
3115,1954,Thulaseedharan Pallickal,ALAPPUZHA,SDPI,2,12th Pass,118200,0,118200
3116,478,Tilakdhari Prasad Singh,KODARMA,INC,0,Graduate,4666034,0,4666034
3117,2294,Titar Singh,GANGANAGAR,IND,0,Literate,41500,0,41500
3118,2317,Toruram Meghwal,CHURU,Bahujan Mukti Party,1,Literate,881700,70000,811700
3119,270,Trichur Nazeer,KOZHIKODE,IND,0,10th Pass,362347,0,362347
3120,3617,Tukaram Dasu Gangawane,OSMANABAD,IND,0,10th Pass,2580700,90000,2490700
3121,1434,Tumane Gopal Ajabrao,RAMTEK,IND,0,12th Pass,17500,0,17500
3122,3618,Tupsundare Balaji Bapurao,OSMANABAD,IND,0,8th Pass,198000,0,198000
3123,760,U K Choudhary (Munna Bhaiya),BALAGHAT,AAP,0,Post Graduate,54742608,1000000,53742608
3124,1417,Ubale Shrikrushna Champatrao,WARDHA,Ambedkarwadi Republican Party,1,Graduate Professional,919000,110000,809000
3125,2701,Uchit Kumar,MUNGER,IND,1,12th Pass,176574,0,176574
3126,3471,Udaram,PALI,IND,0,8th Pass,6512500,0,6512500
3127,3554,Udare Minakshi Mahadev,LATUR,IND,0,Graduate,525000,20000,505000
3128,1070,Udasi Shivakumar Channabasappa,HAVERI,BJP,0,Graduate Professional,576693538,54423645,522269893
3129,1761,Uday Alies Udayveer,BIJNOR,Bharatiya Momin Front,1,Not Given,1610000,0,1610000
3130,1299,Uday Kumar Singh,WEST DELHI,Bahujan Mukti Party,0,12th Pass,5144079,900000,4244079
3131,62,Uday Narain Choudhary,JAMUI,JD(U),0,Graduate,9827813,0,9827813
3132,134,Uday Pratap Singh,HOSHANGABAD,BJP,1,Graduate,133375092,3775714,129599378
3133,1602,Uday Pratap Singh,HOSHANGABAD,IND,0,Graduate,40000,0,40000
3134,1701,Udayveer,GAUTAM BUDHHA NAGAR,Rashtriya Janta Party,0,Illiterate,7271300,124123,7147177
3135,3679,Uddhavrao Balwant Gaikwad,SHIRDI,IND,0,5th Pass,200900,0,200900
3136,3335,Udhav Rangrao Pawar (Patil),PARBHANI,IND,0,Graduate,2411162,675000,1736162
3137,69,Udit Raj,NORTH WEST DELHI,BJP,1,Doctorate,44902363,0,44902363
3138,1505,Ulhas Vasramji Jadhao,YAVATMAL-WASHIM,IND,0,Graduate Professional,5394200,850000,4544200
3139,190,Umadevi. M,BANGALORE SOUTH,SUCI(C),1,Post Graduate,469430,0,469430
3140,154,Umakant Rahi,NAWADA,Shoshit Samaj Dal,0,Post Graduate,2610034,0,2610034
3141,2079,Umed Singh,GURGAON,RASHTRIYA MORCHA PARTY,0,Others,30500,0,30500
3142,2009,Umed Singh,HISAR,IND,0,5th Pass,25250500,300000,24950500
3143,3205,Umed Singh,SHAHJAHANPUR,BSP,0,12th Pass,101502333,1404515,100097818
3144,1760,Umesh Alies Pani,BIJNOR,IND,0,8th Pass,545918,0,545918
3145,3686,Umesh Arjun Kanchan,SHIRUR,IND,0,8th Pass,91000,0,91000
3146,3625,Umesh Bhujang Masankhamb,PUNE,IND,0,12th Pass,2850400,1250000,1600400
3147,2821,Umesh Chandra Mehta,GIRIDIH,AJSUP,1,Doctorate,9368674,764290,8604384
3148,233,Umesh Gautam,BAREILLY,BSP,1,Doctorate,103318000,39530000,63788000
3149,2772,Umesh Kumar,PATNA SAHIB,SP,0,Graduate,1415000,0,1415000
3150,3675,Umesh Mukund Waghmare,SATARA,IND,0,8th Pass,30000,0,30000
3151,2258,Upendra Chandra Das,SILCHAR,IND,0,8th Pass,695001,0,695001
3152,2848,Upendra Karmakar,JAMSHEDPUR,IND,0,5th Pass,330000,0,330000
3153,554,Upendra Kushwaha,KARAKAT,Rashtriya Lok Samta Party,4,Post Graduate,24829741,823834,24005907
3154,376,Upendra Nath,AURANGABAD,Bahujan Mukti Party,1,Post Graduate,9228000,0,9228000
3155,626,Upendra Ravidas,JAMUI,JMM,0,10th Pass,421280000,0,421280000
3156,2327,Urmila,JHUNJHUNU,Megh Desham Party,0,Graduate,353000,0,353000
3157,2082,Usha Rani Verma,GURGAON,IND,0,Post Graduate,5821000,917021,4903979
3158,375,Usha Sharan,AURANGABAD,Shoshit Samaj Dal,1,Literate,3900000,1000,3899000
3159,3519,Uttam Rathod,HINGOLI,IND,0,12th Pass,2500000,1180000,1320000
3160,3513,Uttamrao Pandurang Rathod,HINGOLI,Bahujan Mukti Party,0,Graduate Professional,8148200,458000,7690200
3161,569,V Govind,KOPPAL,IND,0,5th Pass,162000,0,162000
3162,1865,V M Raghavan,KOZHIKODE,IND,0,10th Pass,13000,0,13000
3163,1101,V Muniswamy,KOLAR,SP,0,Illiterate,403964,0,403964
3164,349,V S Jayakumar,THIRUVANANTHAPURAM,IND,0,Graduate,2040500,1675000,365500
3165,1886,V S Shanavas,PALAKKAD,IND,4,10th Pass,1401101,333500,1067601
3166,471,V V Khalid,ANDAMAN & NICOBAR ISLANDS,IND,0,8th Pass,235000,0,235000
3167,1195,V. Bala Krishnan,BANGALORE CENTRAL,AAP,0,Graduate Professional,1894253519,320000,1893933519
3168,604,V. Dhananjaya Kumar,UDUPI CHIKMAGALUR,JD(S),0,Graduate Professional,99477175,0,99477175
3169,955,V.K. Sajeeva,VADAKARA,BJP,2,Graduate Professional,2534579,1125903,1408676
3170,181,V.Manjunath Bhandary,SHIMOGA,INC,0,Doctorate,194691247,89667657,105023590
3171,1106,V.Srinivasa,KOLAR,IND,0,12th Pass,112000,0,112000
3172,1879,V.T.Ikramul Haque,PONNANI,SDPI,0,10th Pass,15185342,0,15185342
3173,3069,Vagish Pathak,BADAUN,BJP,0,Post Graduate,138995758,42644117,96351641
3174,3589,Vaidy Hansraj Dadarao,NANDED,BSP,0,Graduate Professional,24105918,1000000,23105918
3175,3370,Vaishali Surendra Borde,MAVAL,IND,0,Graduate Professional,78806,0,78806
3176,1852,Vappan,WAYANAD,BSP,0,Graduate Professional,3725000,888817,2836183
3177,1457,Varsha Govind Tidke,BHANDARA-GONDIYA,IND,0,10th Pass,294378,0,294378
3178,3720,Vasanagouda Bhandi,BAGALKOT,IND,0,12th Pass,875000,0,875000
3179,1389,Vasantrao Sukhdev Dandage,BULDHANA,SP,0,Graduate,233640000,0,233640000
3180,869,Ved Pal,BHIWANI-MAHENDRAGARH,BSP,6,8th Pass,70084365,4037541,66046824
3181,1347,Ved Prakash,NEW DELHI,IND,0,10th Pass,10478697,0,10478697
3182,2071,Vedparkash Bhartiya,BHIWANI-MAHENDRAGARH,IND,0,10th Pass,3378000,160000,3218000
3183,383,Veejit Kumar,AURANGABAD,IND,0,Graduate,400000,0,400000
3184,558,Veena Bharti,KARAKAT,JPS,0,8th Pass,729000,0,729000
3185,2695,Veena Devi,MUNGER,LJP,0,8th Pass,31162836,0,31162836
3186,3882,Veer Shesherao Chokhoba,BEED,IND,0,Graduate,0,0,0
3187,1074,Veerabhadrappa Kabbinad,HAVERI,IND,0,5th Pass,2500,0,2500
3188,1899,Veerendrakumar,PALAKKAD,IND,0,5th Pass,835000,66000,769000
3189,2453,Velaram,UDAIPUR,AAP,1,Doctorate,10272231,0,10272231
3190,1860,Velayudhan K. P.,KOZHIKODE,BSP,0,10th Pass,3539300,500000,3039300
3191,2634,Velu V,BANGALORE NORTH,BSP,1,8th Pass,2100000,0,2100000
3192,3773,Venkatesh D T,CHIKKBALLAPUR,IND,0,Post Graduate,2500000,150000,2350000
3193,3323,Venugopal Shastri Tumuluri,NANDED,IND,0,Graduate Professional,5810377,180068,5630309
3194,1987,Venus Habib,SOUTH GOA,IND,0,Graduate,4733543,0,4733543
3195,3443,Vigyan Modi,JODHPUR,AAP,0,Others,13265789,409622,12856167
3196,120,Vijay Kumar,JAMMU,IND,0,8th Pass,520000,50000,470000
3197,1316,Vijay Kumar,NORTH WEST DELHI,RPI(A),0,Graduate,5880000,0,5880000
3198,1246,Vijay Kumar Chourasiya,KODARMA,AAP,1,Graduate,3704548,620968,3083580
3199,3905,Vijay Kumar Patel,MAHASAMUND,IND,0,Post Graduate,3249000,0,3249000
3200,2767,Vijay Kumar Sahni,PATNA SAHIB,IND,0,Graduate,7528500,0,7528500
3201,2913,Vijay Kumar Sen,BHOPAL,CPI(ML) Red Star,1,Graduate,34000,0,34000
3202,2026,Vijay Kumar Sharma,HISAR,IND,0,Post Graduate,2730250,0,2730250
3203,1667,Vijay Kumar Singh,GHAZIABAD,BJP,2,Doctorate,41137044,2026774,39110270
3204,3636,Vijay Laxman Sarode,PUNE,IND,0,12th Pass,71000,0,71000
3205,1723,Vijay Pal,BULANDSHAHR,Rashtriya Janpriya Party,0,8th Pass,159000,0,159000
3206,2100,Vijay Raj,FARIDABAD,IND,0,Post Graduate,2035329,0,2035329
3207,395,Vijay Ram,NAWADA,Moolniwasi Samaj Party,1,10th Pass,221500,0,221500
3208,981,Vijay Shankar Chaubey,CHANDNI CHOWK,IND,0,12th Pass,2105641,0,2105641
3209,2899,Vijay Singh Kori,BHIND,AIFB,0,10th Pass,403800,0,403800
3210,1192,Vijaya Kumar,UDUPI CHIKMAGALUR,CPI,0,Others,3085000,215000,2870000
3211,2439,Vijaya Ray,CHITTORGARH,Rajasthan Vikas Party,0,Graduate,318693,0,318693
3212,1908,Vijayan Ambalakkad,ALATHUR,IND,2,10th Pass,825077,0,825077
3213,1871,Vijayaraghavan .K,KOZHIKODE,IND,0,8th Pass,2006500,0,2006500
3214,2446,Vijaypal,BANSWARA,BSP,0,Post Graduate,740000,0,740000
3215,3187,Vijendra Singh,RAMPUR,Rashtriya Congress (Babu Jagjivanram),0,Literate,33048000,0,33048000
3216,432,Vikas,HISAR,IND,3,Graduate,473900,0,473900
3217,2192,Vikas Basavantappa Soppin,DHARWAD,IND,0,Graduate Professional,6039592,1379613,4659979
3218,4013,Vikas Chandra Sharma,RANCHI,CPI(ML) Red Star,0,Post Graduate,126000,0,126000
3219,2955,Vikas Sharma,GWALIOR,Bharatiya Navyuvak Party,0,10th Pass,5100000,0,5100000
3220,3397,Vikas Sudam Kusekar,SHIRUR,AIFB,0,Graduate Professional,4055000,125000,3930000
3221,3619,Vikram Ashok Sawale,OSMANABAD,AAP,0,Graduate,50891116,141639,50749477
3222,112,Vikram Usendi,KANKER,BJP,0,10th Pass,23376000,869000,22507000
3223,3703,Vikram Uttam Kasabe,SOLAPUR,IND,0,Post Graduate,99228,0,99228
3224,1570,Vikrant,JABALPUR,IND,0,10th Pass,323500,0,323500
3225,2353,Vimal,SIKAR,Jai Maha Bharath Party,0,Graduate Professional,88000,0,88000
3226,3125,Vimal Kumar,MORADABAD,AAP,0,Graduate,2456083,731000,1725083
3227,887,Vimla Shoree,BASTAR,CPI,0,Graduate Professional,1520000,200000,1320000
3228,1372,Vinay,NORTH EAST DELHI,Bharatiya Sarvodaya Kranti Party,0,12th Pass,4274100,0,4274100
3229,2183,Vinay Kulkarni,DHARWAD,INC,2,12th Pass,111890685,6539376,105351309
3230,3004,Vinay Kumar,SAGAR,Bhartiya Shakti Chetna Party,0,12th Pass,913873,44000,869873
3231,1571,Vinay Kumar Jain,JABALPUR,IND,0,10th Pass,32198461,1637760,30560701
3232,3642,Vinayak Bhaurao Raut,RATNAGIRI SINDHUDURG,SHS,5,Post Graduate,44568629,2370842,42197787
3233,3789,Vinayaka Prasad.H.N,KOLAR,IND,0,12th Pass,110000,0,110000
3234,1926,Vincent,CHALAKUDY,IND,0,10th Pass,4618200,1200000,3418200
3235,538,Vincent H. Pala,SHILLONG,INC,0,Graduate Professional,497108058,0,497108058
3236,929,Vinod Ankush Nannaware,GADCHIROLI-CHIMUR,SP,0,10th Pass,1969000,520000,1449000
3237,1492,Vinod Dinanath Meshram,CHANDRAPUR,IND,0,Not Given,0,0,0
3238,3645,Vinod Hanumantrao Sawant,RATNAGIRI SINDHUDURG,Akhil Bharat Hindu Mahasabha,0,10th Pass,28610000,0,28610000
3239,1526,Vinod Kumar,SATNA,Bhartiya Shramik Dal Socialist,0,10th Pass,260000,0,260000
3240,2309,Vinod Kumar Baghel,ALIGARH,Rashtriya Samaj Paksha,0,12th Pass,30000,0,30000
3241,3141,Vinod Kumar Tejyan,NAGINA,Bahujan Mukti Party,2,Post Graduate,21180272,3200000,17980272
3242,1693,Vinod Kumar Tyagi,GHAZIABAD,IND,1,Post Graduate,41416138,0,41416138
3243,1263,Vinod Ram,PALAMAU,IND,0,12th Pass,1526001,0,1526001
3244,3104,Vipnesh,KHERI,CPI,0,Graduate Professional,207911,0,207911
3245,1302,Virender Mohan Vats,WEST DELHI,IND,0,Graduate,910714,300000,610714
3246,1572,Virendra Kumar Sharma,JABALPUR,IND,0,Graduate,380000,0,380000
3247,1361,Virendra Mayer,EAST DELHI,Samajwadi Janata Party (Rashtriya),0,Graduate,231000,0,231000
3248,3074,Virendra Pal Gupta,BADAUN,Rashtravadi Janata Party,0,8th Pass,785000,350000,435000
3249,1618,Virendra Singh,MUZAFFARNAGAR,SP,2,Post Graduate,293622871,466848,293156023
3250,1473,Vishal Arvind Bhoyar,BHANDARA-GONDIYA,IND,0,Post Graduate,124600,0,124600
3251,1322,Vishal Khosla,NEW DELHI,IND,0,12th Pass,489000,0,489000
3252,477,Visheshwar Prasad,KODARMA,BSP,0,8th Pass,4850000,1800000,3050000
3253,416,Vishnu Bhagwan,KURUKSHETRA,IND,1,Graduate Professional,1946070,379840,1566230
3254,488,Vishnu Dayal Ram,PALAMAU,BJP,0,Graduate,24753886,0,24753886
3255,455,Vishnu Dutt,ROHTAK,IND,0,10th Pass,1166047,80000,1086047
3256,428,Vishnu Kumar,HISAR,IND,0,Graduate Professional,31000,0,31000
3257,160,Vishun Chaudhary,JAMUI,SHS,0,8th Pass,190000,0,190000
3258,1539,Vishv Nath Dwivedi,REWA,IND,0,12th Pass,156000,0,156000
3259,2714,Vishwajit Kumar,NALANDA,IND,0,12th Pass,3409263,0,3409263
3260,1115,Vishwanath Gotuji Jamnekar,AMRAVATI,IND,0,Graduate Professional,620000,0,620000
3261,2992,Visnu Sharma,MORENA,AITC,0,10th Pass,800000,0,800000
3262,1584,Vivek Mishra (Lalu Bhaiya),BALAGHAT,Jai Maha Bharath Party,0,Graduate,245500,0,245500
3263,1973,Vivekanandan,ATTINGAL,IND,0,8th Pass,4652,0,4652
3264,753,Vivekkrishna Tankha,JABALPUR,INC,0,Graduate Professional,423720471,2277000,421443471
3265,1470,Wadhave Damodhar Natthu,BHANDARA-GONDIYA,IND,0,10th Pass,5790000,40000,5750000
3266,3587,Wadje Panjab Shrihari,NANDED,IND,7,Graduate,65425728,17401655,48024073
3267,3682,Wagh Gangadhar Radhaji,SHIRDI,IND,0,10th Pass,1986175,0,1986175
3268,3696,Waghmare Pundalik Onkari,SOLAPUR,Bahujan Mukti Party,0,10th Pass,1016000,0,1016000
3269,3394,Waghmare Sarjerao Bhika,SHIRUR,BSP,0,12th Pass,1671548,0,1671548
3270,3585,Walke Vikram Vasudeo,MADHA,IND,1,5th Pass,911000,0,911000
3271,3913,Wamanrao Bagde,RAJNANDGAON,IND,0,10th Pass,16495585,0,16495585
3272,876,Wangman Lowangcha,ARUNACHAL EAST,PPA,0,Graduate,46162501,0,46162501
3273,3526,Wankhede Subhash,HINGOLI,IND,0,5th Pass,1030500,0,1030500
3274,3512,Wankhede Subhash Bapurao,HINGOLI,SHS,1,10th Pass,11343000,3541000,7802000
3275,3516,Wankhede Subhash Nagorao,HINGOLI,JD(U),1,5th Pass,1776500,100000,1676500
3276,3378,Ware Subhash Shankarrao,PUNE,AAP,2,Graduate Professional,4586646,0,4586646
3277,2257,Wazid Reja Osmani,SILCHAR,AITC,0,Doctorate,7384788,0,7384788
3278,3634,Yadav Gangadhar Nathu,PUNE,IND,0,Post Graduate,358000,0,358000
3279,2623,Yakub Shariff,CHIKKBALLAPUR,Bahujan Mukti Party,0,Post Graduate,1173400,200000,973400
3280,1060,Yamanur Kamble,BAGALKOT,BSP,1,Post Graduate,5034259,0,5034259
3281,573,Yashpal Sharma,JAMMU,JKPDP,0,Graduate Professional,7743691,0,7743691
3282,2837,Yashpal Yadav,HAZARIBAGH,IND,0,5th Pass,7731500,0,7731500
3283,3541,Yashwant Balkrushna Joshi,KOLHAPUR,IND,0,10th Pass,2638600,229000,2409600
3284,2428,Yashwant Puri,CHITTORGARH,IND,0,Graduate Professional,1906246,0,1906246
3285,3139,Yashwant Singh,NAGINA,BJP,0,Post Graduate,34806740,0,34806740
3286,2154,Yeshwanthrao,BIDAR,Bharatiya Peoples Party,0,Post Graduate,3236000,120000,3116000
3287,647,Yogender Ram,KODARMA,Akhil Bharatiya Jan Sangh,0,10th Pass,4765000,500000,4265000
3288,3055,Yogendra Kumar,AONLA,Akhil Bharat Hindu Mahasabha,1,10th Pass,234800,0,234800
3289,2717,Yogendra Prasad,NALANDA,Bharatiya Inqalab Party,0,12th Pass,5874500,25000,5849500
3290,459,Yogendra Singh Yadav,GURGAON,AAP,0,Post Graduate,29709151,1387505,28321646
3291,856,Yogesh,BANGALORE SOUTH,IND,0,10th Pass,25000,0,25000
3292,224,Yogesh Kumar,SAHARANPUR,AAP,4,Graduate,55998531,183016,55815515
3293,1556,Yogesh Kumar Singh Ad.,SHAHDOL,SP,0,Graduate Professional,1251141,1820,1249321
3294,762,Yogesh Nanaji Samrite,BALAGHAT,BSP,1,Post Graduate,5250000,0,5250000
3295,2021,Yudhvir,HISAR,IND,0,10th Pass,675000,0,675000
3296,4010,Yugeshwar Marar Deen,RANCHI,Manav Mukti Morcha,1,Graduate Professional,7735000,0,7735000
3297,1655,Yunush,BAGHPAT,Navbharat Nirman Party,0,Literate,4810000,0,4810000
3298,3498,Yuvraj Shivaji Kamble,HATKANANGLE,IND,0,8th Pass,975000,0,975000
3299,679,Zafar Alam,ALIGARH,SP,0,Graduate Professional,331958000,2362000,329596000
3300,3110,Zafar Ali Naqvi,KHERI,INC,0,Graduate Professional,4699334,0,4699334
3301,188,Zaheeda Shereen,BANGALORE CENTRAL,SUCI(C),0,Graduate Professional,587593,0,587593
3302,2228,Zakir Hussain,UDUPI CHIKMAGALUR,BSP,0,5th Pass,1309472,45000,1264472
3303,461,Zakir Hussain,GURGAON,INLD,0,Graduate Professional,81039887,789903,80249984
3304,2544,Zanzad Shalikram Shankarrao,BHANDARA-GONDIYA,IND,0,8th Pass,1140019,0,1140019
3305,720,Zulfikal Ali A A,ERNAKULAM,SDPI,4,Others,557800,0,557800
