Sno,ID,Candidate,Constituency,Party,Criminal Cases,Education,Total Assets,Total Liabilities,Net Assets
1,148,Kaushal Yadav,NAWADA,JD(U),8,Post Graduate,154566136,2604969,151961167
2,6912,(Kuppal)G.Devadoss,CHENNAI SOUTH,IND,0,8th Pass,3630000,850000,2780000
3,1906,A Biju,ALATHUR,IND,0,8th Pass,564425,175000,389425
4,8,A N Radhakrishnan,ERNAKULAM,BJP,0,Graduate,7813475,0,7813475
5,4337,A Nelson,SIVAGANGA,IND,0,12th Pass,37322,0,37322
6,4536,A P Jithender Reddy,MAHBUBNAGAR,TRS,4,Graduate,140831576,1386969,139444607
7,901,A Pandian,ANDAMAN & NICOBAR ISLANDS,AIFB,0,12th Pass,859410,350000,509410
8,1105,A Prasad,KOLAR,IND,0,10th Pass,840000,0,840000
9,340,A Sampath,ATTINGAL,CPI(M),1,Doctorate,17791149,1421392,16369757
10,7501,A Thavamani,MADURAI,BSP,0,Illiterate,51000,0,51000
11,173,A Vijayaraghavan,KOZHIKODE,CPI(M),0,Graduate Professional,5757792,152305,5605487
12,397,A. Devadas,BELLARY,SUCI(C),0,10th Pass,1154658,0,1154658
13,6929,A. Irudayadass,CHENNAI SOUTH,IND,0,Graduate,551640,0,551640
14,6913,A. Jaiganesh,CHENNAI SOUTH,Lok Satta Party,0,Graduate,5855905,0,5855905
15,336,A. Josekutty,KOLLAM,IND,0,10th Pass,545117,224328,320789
16,6943,A. Magesh,CHENNAI SOUTH,IND,0,Graduate,6894841,66500,6828341
17,1850,A. P. Shamseer,VADAKARA,IND,0,Literate,55620,0,55620
18,117,A. Raghunath Varma,BERHAMPUR,IND,0,Post Graduate,270800,0,270800
19,4341,A. Shadhick Batcha,TIRUCHIRAPPALLI,IND,0,Post Graduate,752760,700000,52760
20,3955,A.Arunmozhithevan,CUDDALORE,AIADMK,9,Graduate Professional,15765250,0,15765250
21,4048,A.Baskar,CUDDALORE,IND,0,10th Pass,1100000,0,1100000
22,6284,A.Ganesan,ARANI,BSP,0,8th Pass,2110000,0,2110000
23,6356,A.Govindasamy,KALLAKURICHI,IND,0,8th Pass,1891000,300000,1591000
24,5202,A.Hamid Sh. Habib,DHULE,IND,3,8th Pass,63500,0,63500
25,993,A.K. Aggarwal,NORTH EAST DELHI,Agar Jan Party,1,10th Pass,14058166,0,14058166
26,5381,A.K. Mohan,DURG,AITC,0,10th Pass,290000,0,290000
27,6292,A.K.Moorthy,ARANI,Pattali Makkal Katchi,0,Post Graduate,55271210,17008423,38262787
28,2206,A.K.Parashurama Kotemallur,DAVANAGERE,BSP,0,12th Pass,215000,0,215000
29,6357,A.K.Perumal,KALLAKURICHI,JMM,0,Post Graduate,5302255,0,5302255
30,700,A.K.Salahudeen,KOLLAM,SDPI,1,12th Pass,6562365,0,6562365
31,4041,A.K.Sheikdavood,TIRUPPUR,IND,0,Graduate,0,0,0
32,7496,A.Kannan,MADURAI,IND,0,8th Pass,262590,0,262590
33,183,A.Krishnappa,TUMKUR,JD(S),0,Graduate,701833242,175031509,526801733
34,5583,A.M.H. Nazeem,PONDICHERRY,DMK,3,12th Pass,5930000,60000,5870000
35,1847,A.M.Smitha,VADAKARA,CPI(ML) Red star,0,Graduate,22000,0,22000
36,6300,A.Mahadevan,ARANI,IND,0,12th Pass,577000,0,577000
37,7434,A.Mogheeth Khan,TIRUPPUR,IND,0,Graduate,3253500,1475000,1778500
38,2612,A.P. Ahamad,HASSAN,BSP,0,Illiterate,1100000,500000,600000
39,7432,A.Ponnusamy,TIRUPPUR,IND,0,Literate,1581000,0,1581000
40,1222,A.R. Krishna Murthy,CHAMARAJANAGAR,BJP,0,Post Graduate,41281286,2886427,38394859
41,5470,A.Ramesh,VILUPPURAM,IND,0,10th Pass,350000,0,350000
42,2571,A.S.Dsilva,TUMKUR,AAP,0,Graduate,33229897,0,33229897
43,6358,A.Shajahan,KALLAKURICHI,IND,0,Graduate Professional,4402000,325000,4077000
44,1081,A.T. Dadakhalandar,DAVANAGERE,IND,0,10th Pass,36042,19623,16419
45,1951,A.V.Thamarakshan,ALAPPUZHA,Revolutionary Socialist Party of Kerala (B),1,Post Graduate,10641399,0,10641399
46,7503,"Aaron Rashid, J.M.",THENI,INC,0,12th Pass,649632943,8318576,641314367
47,2818,Aasutosh Verma,GIRIDIH,AITC,0,Graduate Professional,384828136,46546450,338281686
48,7267,Aayar Muljibhai Khanabhai,AHMEDABAD WEST,IND,0,10th Pass,430286,0,430286
49,5949,Abbas Hussain Shaikh,MUMBAI SOUTH CENTRAL,SP,3,10th Pass,7967355,258960,7708395
50,250,Abbas Mothalappara,KASARAGOD,AITC,0,10th Pass,102000,0,102000
51,4693,Abdul Ahad Mir,ANANTNAG,IND,0,12th Pass,17950000,0,17950000
52,983,Abdul Amir Amiro,CHANDNI CHOWK,IND,0,5th Pass,4122551,0,4122551
53,2630,Abdul Azeem,BANGALORE NORTH,JD(S),0,Post Graduate,158909760,0,158909760
54,3451,Abdul Aziz,NAGAUR,BSP,0,Graduate,2400000,0,2400000
55,2386,Abdul Aziz Bhartiya,JAIPUR,Rashtriya Ulama Council,0,Graduate,67000,0,67000
56,6238,Abdul Bari Siddiqui,MADHUBANI,RJD,3,12th Pass,16343817,2718221,13625596
57,5929,Abdul Basit Ibrahim Faith,MUMBAI SOUTH,IND,0,Graduate,888656,0,888656
58,6471,Abdul Gani,NIZAMABAD,B. C. United Front,2,Graduate,3633263,705948,2927315
59,212,Abdul Hafeez Abdul Aziz,BULDHANA,BSP,0,12th Pass,425000,225000,200000
60,360,Abdul Hameed,BIDAR,Welfare Party of India,0,Post Graduate,15287118,0,15287118
61,258,Abdul Jabbar K K,KANNUR,SDPI,4,10th Pass,3403545,0,3403545
62,171,Abdul Jaleel,WAYANAD,SDPI,0,Graduate,8813205,0,8813205
63,1923,Abdul Kareem,CHALAKUDY,IND,0,10th Pass,2746000,0,2746000
64,6483,Abdul Kareem Khan,NIZAMABAD,IND,0,8th Pass,6850000,800000,6050000
65,4847,Abdul Khaleque,MALDAHA UTTAR,AIUDF,0,Graduate,4367584,980000,3387584
66,460,Abdul Latif,GURGAON,IND,0,5th Pass,50000,0,50000
67,5916,Abdul Latif Abdul Kadir Shaikh,MUMBAI SOUTH,IND,3,8th Pass,3393500,0,3393500
68,880,Abdul Majid Chouhan,JAMMU,IND,0,10th Pass,2600000,0,2600000
69,6055,Abdul Mannan,SREERAMPUR,INC,1,Graduate,2206559,0,2206559
70,2265,Abdul Mannan Barbhuiya,SILCHAR,AAP,0,Graduate,1042000,900000,142000
71,3827,Abdul Mannan Hossain,MURSHIDABAD,INC,1,Graduate,13846286,0,13846286
72,908,Abdul Muneer,LAKSHADWEEP,CPI(M),0,Post Graduate,1395365,0,1395365
73,3997,Abdul Rahim,HAZARIBAGH,Bahujan Mukti Party,0,Graduate,1800000,0,1800000
74,5236,Abdul Rahman,ARARIA,BSP,0,Literate,813848,0,813848
75,7403,"Abdul Rahman, B.",VELLORE,IND,0,10th Pass,1036500,0,1036500
76,7396,"Abdul Rahman, M.",VELLORE,IUML,0,Post Graduate,46864136,9836275,37027861
77,7402,"Abdul Rahman, N.",VELLORE,IND,0,10th Pass,530000,0,530000
78,7120,"Abdul Rahman, R.",PERAMBALUR,IND,0,10th Pass,8165500,340000,7825500
79,6811,Abdul Rashid Tantray,SRINAGAR,IND,0,10th Pass,410000,0,410000
80,4141,Abdul Safiq Khan,RAIPUR,IND,0,10th Pass,582300,0,582300
81,1212,Abdul Salam N U,KASARAGOD,SDPI,1,Post Graduate,3620329,1182188,2438141
82,6973,"Abdul Salam, A.",COIMBATORE,IND,0,5th Pass,1768600,700000,1068600
83,990,Abdul Sami Salmani,NORTH EAST DELHI,BSP,0,Others,4331561,160000,4171561
84,3921,Abdul Tahir (Bablu - Advocate),BHOPAL,IND,0,Graduate Professional,2573572,1600,2571972
85,1540,Abdul Wafati Ansari Urf Yuvraj Tailors,REWA,Samata Party,0,10th Pass,1131000,1200000,0
86,4290,Abdul Wahid I,SALEM,IND,0,Post Graduate,1800,0,1800
87,4110,Abdur Rahaman,KATIHAR,Bharatiya Momin Front,0,12th Pass,627100,35000,592100
88,1883,Abdurahiman Vadakkathinakath,PONNANI,IND,0,8th Pass,5488050,0,5488050
89,1885,Abdurahiman Varikottil,PONNANI,IND,0,Literate,13110077,0,13110077
90,1884,Abdurahiman Vayarakath,PONNANI,IND,0,Literate,3037410,375000,2662410
91,4355,Abdus Sadek Sarkar,BALURGHAT,AIUDF,2,Graduate Professional,10907085,3064329,7842756
92,6414,Abdus Sattar Mujahed,SECUNDERABAD,Akhil Bharatiya Muslim League (Secular),1,Graduate,1785000,0,1785000
93,3823,Abdus Sayeed,JANGIPUR,SUCI(C),0,12th Pass,1204412,0,1204412
94,2800,Abha Pandey,MAHASAMUND,Chhattisgarh Swabhiman Manch,0,8th Pass,5708000,150000,5558000
95,5628,Abhay Subrao Kulkarni,THANE,IND,0,8th Pass,2000,0,2000
96,3362,Abhijit Anil Apte,MAVAL,IND,0,12th Pass,462306,0,462306
97,4831,Abhijit Mukherjee,JANGIPUR,INC,0,Graduate Professional,63014502,15160000,47854502
98,5629,Abhijit Ramesh Panse,THANE,MNS,1,Graduate,6995050,5800000,1195050
99,4834,Abhijit Sarkar,JANGIPUR,IND,0,5th Pass,92600,0,92600
100,3643,Abhijit Shriram Hegshetye,RATNAGIRI SINDHUDURG,AAP,0,Post Graduate,20692366,4273594,16418772
101,6644,Abhilakh Rawat,BARABANKI,IND,0,10th Pass,427900,0,427900
102,3,Abhimod,PALAKKAD,IND,0,Post Graduate,2908779,370000,2538779
103,2316,Abhinesh Maharshi,CHURU,BSP,0,Post Graduate,38238575,4130000,34108575
104,6688,Abhishek Mishra,LUCKNOW,SP,0,Doctorate,15197365,700000,14497365
105,107,Abhishek Singh,RAJNANDGAON,BJP,0,Graduate Professional,44093207,0,44093207
106,253,Aboobacker Siddique,KASARAGOD,IND,0,8th Pass,38000,0,38000
107,1896,Aboobakker Sidique,PALAKKAD,AITC,0,Illiterate,47004,0,47004
108,1855,Abraham Benhur,WAYANAD,IND,0,Post Graduate,9999242,1421961,8577281
109,1507,Abrar Ahmad Mahmud Khan,YAVATMAL-WASHIM,Welfare Party of India,0,Others,6299991,700000,5599991
110,5836,Abrar Beg Sarvar Beg Mirza,JALGAON,Republican Party of India,0,8th Pass,85000,0,85000
111,7218,Abu Farhan Azmi,MUMBAI NORTH CENTRAL,SP,0,12th Pass,637688791,15872212,621816579
112,4363,Abu Hasem Kahn Chowdhury,MALDAHA DAKSHIN,INC,0,Doctorate,11560825,654320,10906505
113,5046,Abu Naseem Khan,MAINPURI,Peace Party,0,12th Pass,5225000,160000,5065000
114,4475,Abu Qaiser,BHAGALPUR,JD(U),1,Graduate,45138014,1700000,43438014
115,4427,Abul Awal,BARPETA,SP,0,12th Pass,1224844,379980,844864
116,4015,Abul Hasan,RANCHI,IND,0,Post Graduate,165500,0,165500
117,4360,Abul Hasnat Khan,MALDAHA DAKSHIN,CPI(M),0,Post Graduate,10785663,0,10785663
118,6063,Abul Qasem,ULUBERIA,Indian Unity Centre,0,Post Graduate,4613889,0,4613889
119,277,Abullais.T.P,PONNANI,IND,0,12th Pass,6692346,0,6692346
120,3194,Acharya Pramod Krishnam,SAMBHAL,INC,0,Post Graduate,49900443,0,49900443
121,1151,Achutananda Nag,BOLANGIR,Ambedkarite Party of India,0,Graduate Professional,208500,0,208500
122,5190,Ad. Dr. Kolekar Anita Balasaheb,BHIWANDI,Prabuddha Republican Party,0,Doctorate,450000,0,450000
123,7622,Ad. Mahesh Vitthalrao Kharat,JALNA,IND,0,Post Graduate,123000,0,123000
124,5957,Ad. Tanaji Sukdeo Jaibhave,NASHIK,CPI(M),0,Graduate Professional,7279479,2369620,4909859
125,616,Adagooru H Vishwanath,MYSORE,INC,0,Graduate Professional,30187177,0,30187177
126,6696,Adarsh Shashtri,LUCKNOW,IND,0,Post Graduate,18879925,6107118,12772807
127,3391,Adhalrao Shivaji Dattatrey,SHIRUR,SHS,10,Post Graduate,253598315,61810866,191787449
128,5287,Aditya Kiritkumar Raval,AHMEDABAD EAST,Vishva Hindustani Sangathan,1,12th Pass,642000,50000,592000
129,1015,Aditya Narayan,NAWADA,IND,0,Graduate,15770000,0,15770000
130,5931,Aditya Rajan Shirodkar,MUMBAI SOUTH CENTRAL,MNS,6,Graduate,22850061,5811022,17039039
131,315,Adsul Anandrao Vithoba,AMRAVATI,SHS,1,Graduate,32596257,1587104,31009153
132,3649,Adv Dipak Dattaram Nevgi,RATNAGIRI SINDHUDURG,Socialist Party (India),0,Post Graduate,13431575,92000,13339575
133,1909,Adv. A. Jayaram,THRISSUR,BSP,0,Graduate Professional,24702613,628000,24074613
134,3328,Adv. Ajay Sitaram Karande Patil,PARBHANI,SP,0,Post Graduate,9510000,330000,9180000
135,780,Adv. Bandya Sane Alias Bandu Sampatrao Sane,AMRAVATI,IND,0,Post Graduate,31300,0,31300
136,1213,Adv. Basheer Alady,KASARAGOD,BSP,0,Post Graduate,785138,0,785138
137,1976,Adv. Chirayinkeezhu Gopinathan,ATTINGAL,RPI(A),0,Graduate Professional,920662,100000,820662
138,3310,Adv. Deelip Kulkarni,NANDED,IND,0,Graduate Professional,2990000,50000,2940000
139,3022,Adv. Jawahar Leonardo Dias,SOUTH GOA,Goemcarancho Otrec Astro,1,Post Graduate,564223740,484000,563739740
140,3658,Adv. K. D. Shinde,SANGLI,JD(S),0,Post Graduate,4387851,600000,3787851
141,1975,Adv. M. R. Sarin,ATTINGAL,JD(U),0,Graduate Professional,790325,87000,703325
142,3404,Adv. Mahendra Dadasaheb Shinde,SHIRDI,BSP,0,Doctorate,52137,90000,0
143,286,Adv. N.Sreeprakash,MALAPPURAM,BJP,0,Graduate Professional,6781097,317500,6463597
144,1989,Adv. Narendra Keshav Sawaikar,SOUTH GOA,BJP,0,Graduate Professional,6260382,0,6260382
145,1858,Adv. P. P. A. Sageer,WAYANAD,AAP,0,Graduate Professional,4539401,57788,4481613
146,2487,Adv. Peelipose Thomas,PATHANAMTHITTA,IND,1,Graduate Professional,5648161,928336,4719825
147,2508,Adv. Perurkada Harikumar,THIRUVANANTHAPURAM,SHS,4,Graduate Professional,2511500,0,2511500
148,931,Adv. Prabhakar Mahaguji Dadmal,GADCHIROLI-CHIMUR,RPI,0,Post Graduate,560000,0,560000
149,1986,Adv. Raju Mangeshkar,SOUTH GOA,CPI,1,Graduate Professional,4904426,0,4904426
150,1381,Adv. Ravindra Dnyandeo Bhojane,BULDHANA,Aambedakarite Party of India,0,Graduate Professional,119757,0,119757
151,3694,Adv. Sanjeev Sidram Sadafule,SOLAPUR,BSP,0,Graduate Professional,2397559,625000,1772559
152,3568,Adv. Savita Balkrishna Shinde,MADHA,AAP,0,Graduate Professional,2737166,0,2737166
153,3593,Adv. Shailendra Rameshwar Yavalkar,OSMANABAD,SP,0,Graduate Professional,22243300,1125000,21118300
154,3664,Adv. Varsha Madgulkar,SATARA,IND,0,Graduate Professional,13052635,8706000,4346635
155,169,Adv.A.N.Shamseer,VADAKARA,CPI(M),0,Graduate Professional,1330825,0,1330825
156,694,Adv.Bindhu Krishna,ATTINGAL,INC,2,Post Graduate,3764729,853967,2910762
157,1464,Adv.Dadasaheb Alias Dhanu Bhikaji Walthare,BHANDARA-GONDIYA,IND,0,Graduate Professional,5395083,0,5395083
158,706,Adv.Dean Kuriakose,IDUKKI,INC,1,Not Given,314050,411719,0
159,712,Adv.Joice George,IDUKKI,IND,4,Graduate Professional,17396207,9417720,7978487
160,323,Adv.M.A.Bindu,ALAPPUZHA,SUCI(C),0,Graduate Professional,3543000,0,3543000
161,703,Adv.P.K.Jayakrishnan,MAVELIKKARA,BSP,0,Post Graduate,15410000,400000,15010000
162,959,Adv.P.Sudheer,MAVELIKKARA,BJP,8,Graduate Professional,329804,0,329804
163,699,Adv.S.Prahladan,KOLLAM,BSP,0,Graduate Professional,21645000,0,21645000
164,5843,Adv.Shinde Ashok Dagdu,JALGAON,Prabuddha Republican Party,0,Post Graduate,50000,0,50000
165,2578,Adv.Shivajirao Shivaramji Moghe,YAVATMAL-WASHIM,INC,2,Graduate Professional,42689718,11315807,31373911
166,7256,Adv.Sobji Devalya Gavit,NANDURBAR,IND,0,Graduate Professional,10100000,80000,10020000
167,3569,Adv.Subhash Balasaheb Patil (Anna),MADHA,Bahujan Mukti Party,1,Post Graduate,8581681,1502262,7079419
168,5519,Afzal Siddiqui,FATEHPUR,BSP,0,12th Pass,60732397,0,60732397
169,6819,Aga Syed Mohsin,SRINAGAR,IND,0,Others,6550000,0,6550000
170,6792,Agasty Pradip,BARDHAMAN-DURGAPUR,INC,2,Graduate Professional,36099151,8784830,27314321
171,3873,Aghav Jayprakash Sitaram,BEED,IND,3,10th Pass,151000,0,151000
172,7078,Agoram. K,MAYILADUTHURAI,Pattali Makkal Katchi,8,Graduate,6097180,3045000,3052180
173,5867,Agrawal Kunjbihari Jugalkishor,JALNA,SP,4,Graduate,50158221,272883,49885338
174,5147,Ahamad Aziz Ahamad Mateen,AURANGABAD,IND,0,8th Pass,240000,0,240000
175,2093,Aherwan Dharmender Rawat,FARIDABAD,IND,0,12th Pass,6109500,335000,5774500
176,926,Ahir Hansraj Gangaram,CHANDRAPUR,BJP,11,10th Pass,15548000,99500,15448500
177,4714,Ahmad Hussain Ansari,DHANBAD,Jharkhand Disom Party,0,Graduate Professional,11286622,0,11286622
178,1508,Ahmad Parvez Iqbal Ahmad Nur Mohammad,YAVATMAL-WASHIM,SP,1,Graduate,3957500,0,3957500
179,2081,Ahshan Ali,GURGAON,IND,0,Graduate,2090000,0,2090000
180,5939,Aiyyar Ganesh Rangayya,MUMBAI SOUTH CENTRAL,BSP,0,Graduate Professional,34200185,2650000,31550185
181,4434,Ajad Ali,GAUHATI,IND,0,Others,1271997,536237,735760
182,150,Ajad Geeta Prasad Sharma,NAWADA,IND,0,12th Pass,7080000,0,7080000
183,2531,Ajaj Julmoin Khan (Ajaj Khan),NAGPUR,IND,1,12th Pass,137000,0,137000
184,5791,Ajay Agrawal,RAE BARELI,BJP,0,Graduate Professional,17365819,0,17365819
185,729,Ajay Arjun Singh,SATNA,INC,2,Post Graduate,254876883,13845072,241031811
186,2847,Ajay Kumar,JAMSHEDPUR,JVM(P),7,Graduate Professional,124349901,6979341,117370560
187,2320,Ajay Kumar,CHURU,IND,0,Post Graduate,4926438,0,4926438
188,3107,Ajay Kumar,KHERI,BJP,2,Graduate Professional,26505977,10000000,16505977
189,3312,Ajay Kumar Behera,JAGATSINGHPUR,CPI,0,Post Graduate,5137088,0,5137088
190,7708,Ajay Kumar Bhagat,JALANDHAR,IND,0,12th Pass,76000,0,76000
191,4695,Ajay Kumar Dubey,DHANBAD,INC,0,12th Pass,7484762,0,7484762
192,969,Ajay Kumar Khemka,CHANDNI CHOWK,Kalyankari Jantantrik Party,0,Graduate,4724526,625000,4099526
193,1109,Ajay Kumar Panjabrao Hingankar,AKOLA,AAP,0,Graduate,8035000,700000,7335000
194,2361,Ajay Kumar Sharma,JAIPUR RURAL,Jago Party,0,Graduate,4550119,0,4550119
195,495,Ajay Maken,NEW DELHI,INC,1,Post Graduate,61098675,500000,60598675
196,4281,Ajay Pal Singh,ETAWAH,BSP,1,Post Graduate,150110000,0,150110000
197,5367,Ajay Pali,BILASPUR,IND,0,Literate,480000,179344,300656
198,1528,Ajay Pratap Singh,SATNA,IND,0,12th Pass,900000,0,900000
199,5224,Ajay Rawat,DHAR,BSP,0,12th Pass,64000,0,64000
200,6082,Ajay Shah Makrai,BETUL,INC,0,Post Graduate,47558071,1246200,46311871
201,591,Ajay Singla,CHANDIGARH,IND,2,10th Pass,9877806,0,9877806
202,3623,Ajay Vasant Paithankar,PUNE,IND,0,Graduate,14080500,237000,13843500
203,5501,Ajay Verma,DHAURAHRA,Bharatiya Jan Kranti Dal (Democratic),0,Graduate,1281743,185000,1096743
204,4135,Ajay Verma,RAIPUR,Chhattisgarh Swabhiman Manch,0,Others,38835962,0,38835962
205,1831,Ajaykumar Sarnaik,BAGALKOT,INC,0,Graduate,501321313,100587230,400734083
206,2344,Ajaypal,SIKAR,IND,0,10th Pass,3295920,100000,3195920
207,1650,Ajaypal,BAGHPAT,IND,0,8th Pass,5790000,0,5790000
208,3646,Ajinkya Dhondu Gawade,RATNAGIRI SINDHUDURG,IND,0,Graduate,2058757,243784,1814973
209,5829,Ajit Bhika Pawar,DINDORI,IND,0,Graduate,95500,0,95500
210,637,Ajit Joy,THIRUVANANTHAPURAM,AAP,0,Post Graduate,37145768,3500000,33645768
211,4185,Ajit Kumar Jain (Patwa) Dharti Pakad,INDORE,IND,0,8th Pass,0,0,0
212,3996,Ajit Kumar Singh,HAZARIBAGH,AITC,0,12th Pass,6000000,912823,5087177
213,3079,Ajit Pal Singh,BADAUN,Peace Party,0,Graduate,8900000,0,8900000
214,2797,Ajit Pramod Kumar Jogi,MAHASAMUND,INC,1,Graduate Professional,61583410,1500000,60083410
215,671,Ajit Singh,BAGHPAT,RLD,0,Post Graduate,169254660,0,169254660
216,1964,Ajith Kumar K K,PATHANAMTHITTA,IND,1,Graduate,663000,342000,321000
217,2411,Ajmat Ali,KOTA,Bharatiya Yuva Shakti,0,8th Pass,193438,0,193438
218,2493,Akar Dhoj Limbu,SIKKIM,INC,0,Graduate Professional,5504900,0,5504900
219,4084,Akash Gupta,MORENA,IND,0,Graduate,505042,0,505042
220,3181,Akbar Husain,RAMPUR,BSP,0,10th Pass,62120983,3790727,58330256
221,2077,Akbar Kasmi,GURGAON,Rashtriya Ulama Council,0,Others,1592000,0,1592000
222,3182,Akbar Masood,RAMPUR,IND,0,Post Graduate,2513782,0,2513782
223,1012,Akhei Achumi,NAGALAND,Socialist Party (India),0,Graduate,3122000,0,3122000
224,5240,Akhil Bhartiya Sharma,BANKA,IND,0,Graduate Professional,50000,0,50000
225,2954,Akhilesh,GWALIOR,CPI(M),1,Graduate,184700,0,184700
226,6744,Akhilesh Kumar,UNNAO,CPI(ML) Red Star,0,Literate,236000,0,236000
227,4112,Akhtarul Iman,KISHANGANJ,JD(U),1,Post Graduate,4907533,820788,4086745
228,4696,Aklu Ram Mahto,DHANBAD,SP,0,Post Graduate,1747750,0,1747750
229,3064,Akmal Khan Urf Chaman,BADAUN,BSP,0,Literate,14679858,1510000,13169858
230,4389,Akshay Yadav,FIROZABAD,SP,0,Graduate,100883304,59377,100823927
231,7752,Akshaybar Nath Mishra,LUDHIANA,JD(U),1,Post Graduate,255200,0,255200
232,6769,Akthaar Ali,JHANJHARPUR,Jai Prakash Janata Dal,0,Graduate,116600,0,116600
233,4339,Al Sivagnanam,SIVAGANGA,IND,0,5th Pass,69480,0,69480
234,6310,Alagiri.S,CUDDALORE,INC,0,Graduate,17918014,51740512,0
235,7574,Alagumalai.V.,TENKASI,IND,0,12th Pass,470000,0,470000
236,7507,"Alagusundaram, K.",THENI,MDMK,1,Graduate Professional,3085000,254000,2831000
237,1901,Albin M U,ALATHUR,IND,0,12th Pass,900,0,900
238,1988,Aleixo Reginaldo Lourenco,SOUTH GOA,INC,0,12th Pass,31453008,905729,30547279
239,967,Aleyamma Varghese,PATHANAMTHITTA,AITC,0,10th Pass,22800000,4200000,18600000
240,5382,Alfraid Vikas Luis,DURG,IND,0,Graduate,136000,0,136000
241,1846,Ali Akbar,VADAKARA,AAP,0,12th Pass,4448946,2674831,1774115
242,995,Ali Husan,NORTH EAST DELHI,IND,0,5th Pass,1047500,0,1047500
243,4875,Ali Hussain,DHUBRI,IND,0,Graduate,114136,0,114136
244,832,Ali Kishor Patnaik,BERHAMPUR,CPI(M),1,Graduate,7450333,0,7450333
245,5241,Alimuddin Ansari,BANKA,IND,0,Others,352000,0,352000
246,4489,Alimuddin Ansari,KISHANGANJ,AAP,0,10th Pass,5210680,0,5210680
247,7163,Allapichai .E,RAMANATHAPURAM,IND,0,Graduate,13660000,0,13660000
248,4196,Alok Agarwal,KHANDWA,AAP,2,Graduate Professional,12871,0,12871
249,4417,Alok Nandan,MAINPURI,IND,0,Post Graduate,8647900,0,8647900
250,2907,Alok Sanjar,BHOPAL,BJP,0,Graduate Professional,14594066,300000,14294066
251,2950,Alok Sharma,GWALIOR,BSP,0,8th Pass,20454704,0,20454704
252,6974,"Alphonesraj, M.",COIMBATORE,IND,0,5th Pass,261500,0,261500
253,3661,Altaf Abdulgani Shikalgar,SATARA,Bahujan Mukti Party,0,8th Pass,5727145,227144,5500001
254,3302,Altaf Ahamad Iqbal Ahmad,NANDED,IUML,0,Graduate,4462742,571000,3891742
255,968,Altaf Husain,CHANDNI CHOWK,Bhartiya Janta Dal (Integrated),0,12th Pass,4790000,0,4790000
256,3594,Altaf Husain Yenegure,OSMANABAD,IND,0,Graduate,1690000,0,1690000
257,851,Alur M.G. Swamy,DAVANAGERE,IND,0,Graduate,36920000,150000,36770000
258,7562,Alwarsamy Karthikeyan.L,THOOTHUKKUDI,IND,0,Post Graduate,480000,0,480000
259,2793,Amal Say Sori,KANKER,IND,0,Graduate,362500,400000,0
260,4500,Aman Kumar Samajsevi,SUPAUL,BSP,0,12th Pass,5728000,0,5728000
261,4007,Amanullah,RANCHI,AAP,0,Post Graduate,2391132,126000,2265132
262,5088,Amar Chand Pohiya,BHARATPUR,Rajasthan Vikas Party,0,10th Pass,2076000,23000,2053000
263,4130,Amar Nath Pandey,KORBA,AAP,2,Graduate Professional,3656000,393000,3263000
264,4988,Amar Singh,FATEHPUR SIKRI,RLD,0,Graduate Professional,966849798,0,966849798
265,4931,Amar Singh,AGRA,IND,0,12th Pass,247000,0,247000
266,4935,Amar Singh,AKBARPUR,Janvadi Party(Socialist),0,10th Pass,1701500,250000,1451500
267,2288,Amar Singh,GANGANAGAR,Bahujan Mukti Party,0,10th Pass,1230000,586706,643294
268,4215,Amar Singh Patel,VIDISHA,BSP,0,12th Pass,311829,27310,284519
269,6626,Amar Singh Rathaur,BANDA,AAP,0,Graduate Professional,7180000,620000,6560000
270,2343,Amara Ram,SIKAR,CPI(M),0,Post Graduate,4681929,774000,3907929
271,7669,Amarinder Singh,AMRITSAR,IND,0,12th Pass,60000,0,60000
272,592,Amarjit Kaur,CHANDIGARH,IND,0,8th Pass,7020000,500000,6520000
273,6100,Amarjit Singh Asal,AMRITSAR,CPI,0,Post Graduate,1866611,0,1866611
274,1142,Amarnath Pradhan,SAMBALPUR,INC,0,Post Graduate,56069048,0,56069048
275,4494,Amarnath Tiwari,PURNIA,INC,1,Graduate,43329826,6731845,36597981
276,1011,Amarson Sankhil,OUTER MANIPUR,IND,0,Post Graduate,857093,0,857093
277,1210,Ambalathara Kunhikrishnan,KASARAGOD,AAP,0,10th Pass,245690,0,245690
278,214,Ambedkar Prakash Yashwant,AKOLA,Bharipa Bahujan Mahasangh,3,Graduate Professional,35716840,1400000,34316840
279,4315,Ambendkari Hasnooram Ambendkari,FATEHPUR SIKRI,IND,0,Literate,262200,120000,142200
280,3013,Ambesh Kumari,TIKAMGARH,SP,1,Doctorate,15710045,3255734,12454311
281,6116,Ambika Soni,ANANDPUR SAHIB,INC,0,Post Graduate,1180035973,27847000,1152188973
282,3734,Ambrose D,BANGALORE CENTRAL,IND,0,Post Graduate,575,0,575
283,7161,Amirthalingam .U,RAMANATHAPURAM,IND,0,8th Pass,1460000,370000,1090000
284,7662,Amit Aggarwal,GURDASPUR,IND,0,12th Pass,1249500,250000,999500
285,2970,Amit Bhatnagar,KHAJURAHO,AAP,0,Post Graduate,2136231,0,2136231
286,7709,Amit Jassi,JALANDHAR,IND,0,Graduate,377801,10000,367801
287,6787,Amit Kumar,SAMASTIPUR,Samajwadi Janata Party (Rashtriya),1,12th Pass,1478998,195000,1283998
288,3137,Amit Kumar,MORADABAD,Bahujan Mukti Party,0,Post Graduate,446061,0,446061
289,1000,Amit Kumar Sharma,NORTH EAST DELHI,IND,0,Graduate,1710000,0,1710000
290,4016,Amit Kumar Singh,RANCHI,IND,0,12th Pass,1169044,9000,1160044
291,5780,Amit Rawat,MOHANLALGANJ,AITC,0,10th Pass,160000,0,160000
292,1798,Amita Singh Jaat,ALIGARH,Sarva Samaj Kalyan Party,0,Post Graduate,3865000,0,3865000
293,2873,Amitabh Choudhary,RANCHI,JVM(P),0,Graduate Professional,17931854,1095618,16836236
294,3261,Amiya Kanta Mallick,JAJPUR,BJP,0,10th Pass,10680000,5130000,5550000
295,7850,Amrik Singh,PATIALA,New All India Congress Party,1,Illiterate,607780,0,607780
296,5206,Amrishbhai Rasiklal Patel,DHULE,INC,21,8th Pass,504197656,142934079,361263577
297,4642,Amrit Tirkey,RAIGARH,IND,0,8th Pass,2711000,0,2711000
298,5500,Anand Bhadauriya,DHAURAHRA,SP,3,Post Graduate,23997933,100000,23897933
299,5502,Anand Kumar,DHAURAHRA,NCP,0,12th Pass,1205500,0,1205500
300,24,Anand Kumar,NORTH EAST DELHI,AAP,0,Doctorate,29255377,72369,29183008
301,5249,Anand Kumar Jain,BHAGALPUR,IND,0,Graduate Professional,6172660,0,6172660
302,4154,Anand Mahato,DHANBAD,Marxist Co-Ordination,1,Graduate,6155932,0,6155932
303,5719,Anand Mehrotra,KANPUR,Nagrik Ekta Party,1,Post Graduate,1083000,0,1083000
304,3981,Anand Mishra,BILASPUR,AAP,0,Post Graduate,4685783,1440000,3245783
305,5879,Anand Prakash Pranjape,KALYAN,NCP,4,Post Graduate,35920212,3379297,32540915
306,3763,Ananda G,CHAMARAJANAGAR,IND,0,Others,130000,0,130000
307,2602,Ananda Gatty,DAKSHINA KANNADA,IND,0,Graduate Professional,5328850,450000,4878850
308,794,Ananda Kumar Samal,SAMBALPUR,AAP,0,Post Graduate,169838,123121,46717
309,7231,Ananda Sakharam Bhalerao,MUMBAI NORTH EAST,IND,0,10th Pass,157386,0,157386
310,6954,"Anandan Alias Kavignar Ananthamaalai, S",CHIDAMBARAM,IND,0,12th Pass,275000,0,275000
311,2180,Anandaraj Dokka,DHARWAD,IND,0,8th Pass,220000,0,220000
312,7561,"Anandharaj, M.",THOOTHUKKUDI,IND,0,Others,40000,0,40000
313,6319,Anandharajan.S,CUDDALORE,IND,0,Post Graduate,64850,17652,47198
314,7316,Anandkumar Sarvarsinh Vasava,BHARUCH,IND,0,Post Graduate,2296015,0,2296015
315,4030,Anandkumar.K,DHARMAPURI,IND,0,Not Given,1039000,0,1039000
316,2808,Anandram Sahu,RAJNANDGAON,BSP,0,8th Pass,6680680,300000,6380680
317,2924,Anant Lal Basor,DAMOH,IND,0,10th Pass,9014000,0,9014000
318,96,Anant Nayak,KEONJHAR,BJP,0,12th Pass,5241777,875448,4366329
319,189,Ananth Kumar,BANGALORE SOUTH,BJP,0,Graduate Professional,45224706,2883233,42341473
320,6421,Ananth Rao Gundepally,SECUNDERABAD,IND,0,Post Graduate,1750000,400000,1350000
321,398,Anantkumar Hegde,UTTARA KANNADA,BJP,0,12th Pass,32367360,15139611,17227749
322,5436,Anbalagan D,TIRUVANNAMALAI,IND,0,Graduate Professional,436200,0,436200
323,7443,Anbalagan.M,TIRUCHIRAPPALLI,IND,0,10th Pass,1276450,190000,1086450
324,6878,Anbazhagan .G,CHENNAI NORTH,IND,0,Post Graduate,1070799,0,1070799
325,7124,"Anbil Thangamani, K.",PERAMBALUR,IND,0,Post Graduate,6300000,0,6300000
326,6995,Anbumani Ramadoss,DHARMAPURI,Pattali Makkal Katchi,8,Graduate Professional,314378451,41941065,272437386
327,6991,Anbumani.G,DHARMAPURI,IND,0,12th Pass,1301000,0,1301000
328,6975,Anbuselvan.,COIMBATORE,IND,0,Graduate Professional,5831644,2900000,2931644
329,4208,Aneeta Hindoliya,UJJAIN,AAP,0,Post Graduate,5760417,1564210,4196207
330,2849,Angad Mahato,JAMSHEDPUR,Amra Bangalee,1,10th Pass,4005014,0,4005014
331,6993,Anguraj.P,DHARMAPURI,IND,0,12th Pass,3257000,241000,3016000
332,4923,Anil,AGRA,Bharatiya Kisan Parivartan Party,0,Literate,305538,0,305538
333,2057,Anil,ROHTAK,Rashtriya Bahujan Hitay Party,0,10th Pass,1520000,0,1520000
334,1996,Anil,KURUKSHETRA,IND,0,5th Pass,18036000,0,18036000
335,1639,Anil,MEERUT,IND,0,12th Pass,1594367,104944,1489423
336,5716,Anil Awasthi,KANPUR,AITC,0,Graduate,969443,0,969443
337,4882,Anil Bhagawati,GAUHATI,IND,2,Doctorate,4619004,229300,4389704
338,3490,Anil Jaysing Ghanvat,AHMEDNAGAR,IND,6,Graduate,33340000,163597,33176403
339,3898,Anil Khajuria,UDHAMPUR,IND,0,Graduate Professional,25000,0,25000
340,2769,Anil Kumar,PATNA SAHIB,IND,0,Post Graduate,199542,0,199542
341,640,Anil Kumar,THIRUVANANTHAPURAM,IND,0,12th Pass,40000,0,40000
342,1651,Anil Kumar,BAGHPAT,Peace Party,4,12th Pass,55427000,7522794,47904206
343,2042,Anil Kumar,SONIPAT,Rashtriya Bahujan Hitay Party,0,10th Pass,10875000,0,10875000
344,1619,Anil Kumar,MUZAFFARNAGAR,Bahujan Mukti Party,0,Graduate Professional,4662600,518000,4144600
345,1928,Anil Kumar,ERNAKULAM,IND,0,8th Pass,72000,0,72000
346,2366,Anil Kumar,JAIPUR RURAL,AAP,0,10th Pass,2992554,201420,2791134
347,6661,Anil Kumar,HAMIRPUR,Ambedkar Samaj Party,0,10th Pass,90000,0,90000
348,6749,Anil Kumar,UNNAO,IND,0,10th Pass,2100000,0,2100000
349,5005,Anil Kumar,FATEHPUR SIKRI,IND,0,Graduate,1412100,0,1412100
350,5814,Anil Kumar Chaudhary,UNNAO,IND,0,12th Pass,680050,0,680050
351,2784,Anil Kumar Gupta,UDHAMPUR,IND,0,Graduate,51621298,1717547,49903751
352,5266,Anil Kumar Mahto,PURNIA,Janvadi Party(Socialist),0,10th Pass,681406,0,681406
353,5812,Anil Kumar Mishra,UNNAO,Socialist Party (India),0,10th Pass,539375,52000,487375
354,695,Anil Kumar N S,ATTINGAL,BSP,1,12th Pass,433000,0,433000
355,1240,Anil Kumar Oraon,CHATRA,IND,0,10th Pass,3490000,25000,3465000
356,3073,Anil Kumar Sharma,BADAUN,Labour Party of India (V.V. Prasad),0,Graduate Professional,4900000,0,4900000
357,2370,Anil Kumar Sharma,JAIPUR,Jago Party,0,Graduate,75100,0,75100
358,2677,Anil Kumar Sharma,JAHANABAD,JD(U),1,Doctorate,8498803720,1095393904,7403409816
359,603,Anil M.R,SHIMOGA,IND,0,Others,774819,1252161,0
360,5884,Anil Motiram More,KALYAN,Bahujan Mukti Party,0,Graduate Professional,2828101,158609,2669492
361,4207,Anil Pale,UJJAIN,Bahujan Sangharshh Dal,0,Graduate Professional,507000,250000,257000
362,3373,Anil Shirole,PUNE,BJP,2,Graduate,227615279,4781007,222834272
363,4932,Anil Shukla Varsi,AKBARPUR,BSP,2,Graduate,32740272,11284827,21455445
364,4191,Anil Trivedi,INDORE,AAP,0,Post Graduate,14718234,0,14718234
365,4618,Anil Umre,RAIPUR,Ambedkarite Party of India,0,12th Pass,11000,0,11000
366,5301,Anilkumar Chhitubhai Bhagat,BHARUCH,JD(U),2,Graduate,28598975,1492925,27106050
367,5289,Anilkumar Kasturchand,AHMEDABAD EAST,IND,0,Graduate Professional,41494101,2400000,39094101
368,305,Anilkumar R,KOTTAYAM,AAP,0,Post Graduate,1686239,360000,1326239
369,6239,Anirud Sahu,MADHUBANI,Samajwadi Janata Party (Rashtriya),0,12th Pass,586000,800,585200
370,6535,Anirudhhsinh Juvansinh Zala,RAJKOT,IND,0,10th Pass,12877882,505939,12371943
371,3156,Anis Ahamad Khan,PILIBHIT,BSP,0,Graduate,32411744,0,32411744
372,1942,Anish Mariyil,IDUKKI,IND,0,12th Pass,8569000,0,8569000
373,4256,Anita,AGRA,Vanchitsamaj Insaaf Party,0,10th Pass,489000,0,489000
374,2893,Anita Hitendra Chaudhary,BHIND,SP,0,Graduate,15514000,10000,15504000
375,3416,Anita Jain,AJMER,IND,0,Graduate Professional,4700000,0,4700000
376,584,Anita Mondal,ANDAMAN & NICOBAR ISLANDS,AITC,1,Graduate,5471073,6000,5465073
377,1440,Anita Nagdigambar Tekam,NAGPUR,IND,0,8th Pass,10500,0,10500
378,719,Anitha Prathap,ERNAKULAM,AAP,0,Graduate Professional,203330000,0,203330000
379,1454,Anjali Anish Damania,NAGPUR,AAP,0,Graduate Professional,193161591,1399670,191761921
380,5105,Anjali Chaudhary,DAUSA,IND,0,Post Graduate,750000,0,750000
381,4512,Anjana Udai Lal,JALORE,INC,0,12th Pass,658610000,202559600,456050400
382,7874,Anjaneyulu.E,MALKAJGIRI,IND,0,Graduate,687000,400000,287000
383,4014,Anjani Pandey,RANCHI,IND,0,Graduate Professional,25000,0,25000
384,4311,Anju,FARRUKHABAD,Bhartiya Shakti Chetna Party,0,Graduate Professional,989068,0,989068
385,5768,Anju Bala,MISRIKH,BJP,0,Graduate,37618214,1200000,36418214
386,4230,Anju Devi Dhanka,DAUSA,IND,0,Graduate,6022739,2800000,3222739
387,5782,Anju Singh,RAE BARELI,AITC,0,Post Graduate,2874863,110000,2764863
388,1729,Anju Urf Muskan,BULANDSHAHR,RLD,0,12th Pass,2995000,1656134,1338866
389,1340,Anjuman Agnihotri,NEW DELHI,IND,0,12th Pass,930631,169975,760656
390,1620,Ankur,MUZAFFARNAGAR,IND,0,12th Pass,7425346,0,7425346
391,6543,Ankur Amrutkumar Dhameliya,RAJKOT,AAP,0,12th Pass,3592268,250000,3342268
392,5150,Ankush Munjaji Tupsamundre,AURANGABAD,IND,0,Literate,5110000,1942,5108058
393,1405,Ankush Vijayrao Nawale,WARDHA,SP,0,Graduate Professional,1551000,72000,1479000
394,5461,Annadurai A,TIRUVANNAMALAI,IND,0,Illiterate,200000,0,200000
395,5460,Annadurai B,TIRUVANNAMALAI,IND,0,Not Given,220000,0,220000
396,5449,Annadurai C N,TIRUVANNAMALAI,DMK,0,Graduate,116791971,48430837,68361134
397,7160,Annamalai .S,RAMANATHAPURAM,IND,0,Post Graduate,7080000,1300000,5780000
398,1924,Annamma Joy,CHALAKUDY,AITC,0,Graduate,6397000,2040000,4357000
399,5815,Annu Tandon,UNNAO,INC,1,Graduate,636029024,30000000,606029024
400,4971,Anokhey,FARRUKHABAD,IND,0,12th Pass,10149863,0,10149863
401,2983,Anoop Mishra,MORENA,BJP,0,12th Pass,110523112,6878160,103644952
402,2988,Anoop Nagar,MORENA,IND,0,Literate,420000,0,420000
403,7725,Anoop Singh,HOSHIARPUR,Bharti Jan Suraksha Party,0,10th Pass,4390000,220000,4170000
404,2862,Anosh Ekka,KHUNTI,Jharkhand Party,3,10th Pass,36766971,4224902,32542069
405,4429,Anowar Hussain,DHUBRI,AGP,0,Graduate,828710,0,828710
406,5186,Ansari Jahid Mukhtar,BHIWANDI,Bahujan Mukti Party,1,12th Pass,3844989,0,3844989
407,5183,Ansari Jalaluddin Moinuddin,BHIWANDI,AAP,0,Others,5896347,0,5896347
408,5184,Ansari Mumtaz Abdul Satar,BHIWANDI,BSP,0,8th Pass,255000,0,255000
409,5196,Ansari Nihal Ah Md Harun,DHULE,AAP,0,10th Pass,36566800,6000000,30566800
410,4974,Anshu Mahan,FARRUKHABAD,IND,0,Literate,1702500,0,1702500
411,4402,Anshul Verma,HARDOI,BJP,0,Post Graduate,30385000,0,30385000
412,3229,Anta Alok Baskey,MAYURBHANJ,AJSUP,0,Graduate,8604192,600000,8004192
413,7021,Anthony Muthu,KANNIYAKUMARI,CPI(ML)L,10,Post Graduate,8468000,0,8468000
414,964,Anto Antony,PATHANAMTHITTA,INC,0,Graduate,5410884,4211050,1199834
415,7733,Anu Kumar,HOSHIARPUR,IND,1,12th Pass,91000,0,91000
416,764,Anubha Munjare,BALAGHAT,SP,5,Post Graduate,36108915,2167687,33941228
417,757,Anuj Ganga Singh Patta,MANDLA,GGP,0,Graduate,4480097,2220000,2260097
418,4420,Anuj Kumar Garg,MATHURA,AAP,0,Post Graduate,71875216,7343000,64532216
419,514,Anup Phukon,DIBRUGARH,AGP,0,Post Graduate,4737100,3549764,1187336
420,2043,Anup Sing Dahiya,SONIPAT,Rashtriya Jatigat Aarakshan Virodhi Party,0,10th Pass,13153500,152500,13001000
421,6031,Anupam Hazra,BOLPUR,AITC,0,Doctorate,4866883,0,4866883
422,3311,Anupama Sethy,JAGATSINGHPUR,AAP,0,Post Graduate,525564,10000,515564
423,5548,Anuradha Sharma,JHANSI,BSP,0,12th Pass,316366402,0,316366402
424,4970,Anurag Rajput,FARRUKHABAD,IND,0,12th Pass,1585000,0,1585000
425,3294,Anwar,TUMKUR,IND,0,Graduate,2886450,0,2886450
426,6200,Anwar Alam,MADHEPURA,AAP,0,Others,770380,0,770380
427,7439,Anwar Deen.S,TIRUCHIRAPPALLI,Samata Party,1,Literate,427101,0,427101
428,2973,Anwar Khan,KHAJURAHO,IND,0,10th Pass,901857,0,901857
429,2944,Anwar Khan,GUNA,IND,0,10th Pass,77000,0,77000
430,1875,Anwar Shakeel Omar,MALAPPURAM,IND,0,Post Graduate,4809396,0,4809396
431,7152,Anwhar Raajhaa.A,RAMANATHAPURAM,AIADMK,0,Graduate,33582876,2700000,30882876
432,3278,Aparajita Mohanty,CUTTACK,INC,0,Graduate,27791663,7903022,19888641
433,5819,Aparupa Poddar (Afrin Ali),ARAMBAG,AITC,0,Post Graduate,3271869,200000,3071869
434,1634,Aphajal,MEERUT,IND,1,8th Pass,425000,0,425000
435,1936,Appanchira Ponnappan,IDUKKI,BSP,0,10th Pass,7611000,0,7611000
436,1819,Appasaheb Kurane,CHIKKODI,Sarva Janata Party,0,12th Pass,348900,0,348900
437,3203,Aqeel Ahmad,SAMBHAL,IND,0,12th Pass,6180000,0,6180000
438,3190,Aqeel Ur Rehman Khan,SAMBHAL,BSP,0,Post Graduate,32724982,2506410,30218572
439,1219,Arakera Shivanagouda Nayak,RAICHUR,BJP,1,Graduate,45433720,7544250,37889470
440,7456,Arangarajan.M,THANJAVUR,BSP,0,12th Pass,10373421,3400000,6973421
441,7158,Arasakumar B.T.,RAMANATHAPURAM,Desiya Forward Bloc,4,Post Graduate,81788578,19687720,62100858
442,3808,Aravind Premanand,MANDYA,IND,0,Graduate Professional,662000,0,662000
443,5549,Archana,JHANSI,AAP,0,Post Graduate,29734417,1000000,28734417
444,6731,Archana Srivastava,RAE BARELI,AAP,0,Post Graduate,2392500,0,2392500
445,7476,Arimazham Thiyagi Subramanian Muthuraja M,SIVAGANGA,IND,0,10th Pass,482295,0,482295
446,4031,Arivazhagan.P,DHARMAPURI,IND,0,12th Pass,3149700,1300000,1849700
447,6992,Arivudainambi.M,DHARMAPURI,IND,0,Post Graduate,7145500,1260000,5885500
448,2475,Arjan Puri,BARMER,IND,0,Literate,386000,0,386000
449,7186,Arjun Balu Arde,MUMBAI NORTH,Ambedkarite Party of India,0,10th Pass,1526630,0,1526630
450,3251,Arjun Charan Mallik,BHADRAK,BSP,0,Graduate Professional,7817500,0,7817500
451,3246,Arjun Charan Sethi,BHADRAK,BJD,0,Post Graduate,6730000,2424000,4306000
452,7195,Arjun Chaudhary,MUMBAI NORTH,IND,0,8th Pass,3081000,0,3081000
453,3869,Arjun Hanmanta Nimbalkar,BEED,IND,0,10th Pass,225000,19000,206000
454,4171,Arjun Prasad Singh,RAJMAHAL,AJSUP,0,Post Graduate,35193984,0,35193984
455,2304,Arjun Ram Meghwal,BIKANER,BJP,0,Post Graduate,18142863,1216408,16926455
456,466,Arjun Singh Thakur,BASTAR,Ambedkarite Party of India,0,Post Graduate,46885000,250000,46635000
457,2693,Arjun Thakur,JAHANABAD,IND,0,Post Graduate,1212500,0,1212500
458,1160,Arjuna Bhatara,NABARANGPUR,Odisha Jan Morcha,0,Graduate,4137000,815000,3322000
459,7329,Arjunbhai Versingbhai Rathva,CHHOTA UDAIPUR,AAP,0,Post Graduate,3157543,1135000,2022543
460,2449,Arjunlal Meena,UDAIPUR,BJP,0,Post Graduate,17049951,8195866,8854085
461,7251,Arjunsing Divansing Vasave,NANDURBAR,Bharipa Bahujan Mahasangh,0,Graduate,233000,0,233000
462,815,Arka Keshari Deo,KALAHANDI,BJD,0,Graduate,69822063,831688,68990375
463,3157,Arman Khan,PILIBHIT,IND,0,Graduate Professional,91775,40000,51775
464,537,Armerington Kharshiing,SHILLONG,AAP,0,Not Given,10547837,211214,10336623
465,4887,Aroon Barooa,MANGALDOI,Regional Democratic Secular Congress,0,Post Graduate,732083,0,732083
466,4828,Arpita Ghosh,BALURGHAT,AITC,0,Graduate,544790,0,544790
467,4017,Arsad Ayub,RANCHI,IND,1,10th Pass,5746855,0,5746855
468,3059,Arshadurraza Khan,AONLA,IND,0,Post Graduate,3973500,0,3973500
469,4131,Arti Singh,RAIGARH,INC,0,Post Graduate,6306588,558727,5747861
470,2984,Arujn Singh (Pappu Kushwah),MORENA,Rashtriya Samanta Dal,0,8th Pass,2006618,0,2006618
471,7371,Arul Anbarasu,SRIPERUMBUDUR,INC,2,Post Graduate,45125593,27706387,17419206
472,5445,Aruljothi A,TIRUVANNAMALAI,IND,0,Graduate,125000,18000,107000
473,5456,Arumugam C,TIRUVANNAMALAI,SP,0,12th Pass,2175777,0,2175777
474,5693,Arumugam M,SALEM,IND,0,10th Pass,11075983,0,11075983
475,5455,Arumugam R,TIRUVANNAMALAI,IND,0,10th Pass,1533000,0,1533000
476,7081,Arumugam. C,MAYILADUTHURAI,IND,0,8th Pass,789651,112500,677151
477,3377,Arun Bhatia,PUNE,Peoples Guardian,1,Post Graduate,842515000,8000000,834515000
478,3647,Arun Harishchandra Manjrekar,RATNAGIRI SINDHUDURG,IND,0,10th Pass,3745087,26000,3719087
479,100,Arun Jaitley,AMRITSAR,BJP,0,Graduate Professional,1130216000,82000000,1048216000
480,2008,Arun Kumar,HISAR,IND,0,12th Pass,13095700,320000,12775700
481,410,Arun Kumar,AMBALA,CPI,0,Graduate Professional,450000,0,450000
482,1794,Arun Kumar Agarwal,DARJEELING,IND,0,12th Pass,29039342,0,29039342
483,165,Arun Kumar Bhowmik,TRIPURA WEST,SUCI(C),0,Graduate,2443828,145939,2297889
484,4672,Arun Kumar Joshi,DURG,IND,0,Others,45500,0,45500
485,7670,Arun Kumar Joshi,AMRITSAR,IND,3,12th Pass,2852000,0,2852000
486,2839,Arun Kumar Mishra,HAZARIBAGH,JVM(P),0,Graduate,55808583,23803410,32005173
487,5074,Arun Kumar Roopak,ALWAR,Naya Daur Party,0,Others,171000,0,171000
488,4744,Arun Marandi,RAJMAHAL,BSP,0,Graduate,365700,0,365700
489,2542,Arun Nagorao Gajbhiye,BHANDARA-GONDIYA,IND,0,Graduate,1295000,8382,1286618
490,5807,Arun Shankar Shukla,UNNAO,SP,2,10th Pass,178200582,2901208,175299374
491,4193,Arun Subhash Chandra Yadav,KHANDWA,INC,2,Graduate,318304270,59900980,258403290
492,1362,Arun Thakur,EAST DELHI,Samyak Parivartan Party,0,12th Pass,1081500,0,1081500
493,6265,"Arun, N.",ARAKKONAM,IND,0,Doctorate,10435836,2093000,8342836
494,5432,Arunachalam P,TIRUVANNAMALAI,IND,0,Graduate,879897,0,879897
495,7442,Arunachalam.A,TIRUCHIRAPPALLI,IND,0,Post Graduate,570200,0,570200
496,613,Arunakumara,MANDYA,IND,0,8th Pass,225000,0,225000
497,2254,Arunangshu Bhattacharjee,SILCHAR,SUCI(C),0,Post Graduate,873605,666567,207038
498,6864,Arundhathi Jaiganesh (A) S.Jaiganesh,CHENNAI CENTRAL,IND,0,10th Pass,0,0,0
499,5356,Arunkumar Sheshram Pathak,NAVSARI,IND,2,10th Pass,649767,40000,609767
500,244,Arunoday Saha,TRIPURA WEST,INC,0,Doctorate,33892463,0,33892463
501,138,Arup Kumar Mahanta,KALIABOR,CPI(ML)L,0,Graduate,458613,0,458613
502,6077,Arvapally Ambati,BHONGIR,BSP,0,10th Pass,100000,0,100000
503,1653,Arvind,BAGHPAT,IND,0,12th Pass,410000,100,409900
504,1590,Arvind Dongre,CHHINDWARA,Bahujan Mukti Party,0,10th Pass,4084000,0,4084000
505,3109,Arvind Giri,KHERI,BSP,20,Graduate Professional,26196212,1471211,24725001
506,6657,Arvind Kumar,FATEHPUR,IND,0,Graduate,4181000,0,4181000
507,5816,Arvind Kumar,UNNAO,AAP,0,Graduate Professional,38453489,1650000,36803489
508,4937,Arvind Kumar,AKBARPUR,AAP,0,Graduate Professional,13672038,0,13672038
509,205,Arvind Kumar Sharma,KARNAL,INC,0,Post Graduate,35428444,15584114,19844330
510,1404,Arvind Shamrao Lillore,WARDHA,IND,0,Others,144186,0,144186
511,2034,Arvind Tiwari,KARNAL,IND,0,Doctorate,160000,0,160000
512,4523,Asaduddin Owaisi,HYDERABAD,All India Majlis-E-Ittehadul Muslimeen,4,Graduate Professional,40611099,14000000,26611099
513,3138,Asarpat Singh,NAGINA,IND,0,12th Pass,600528,0,600528
514,7512,"Asath, M.M.",THENI,IND,0,5th Pass,1862664,530000,1332664
515,2406,Asfak Ali,KOTA,IND,0,8th Pass,1050000,0,1050000
516,1545,Asha Singh,SIDHI,Rashtriya Apna Dal,0,10th Pass,67500,0,67500
517,3624,Ashapak Shaikh,PUNE,IND,1,8th Pass,110000,0,110000
518,2513,Ashatai Abhyankar Amravati,AMRAVATI,IND,0,Graduate,3450000,1360000,2090000
519,1814,Ashfaq Ahmed Madaki,CHIKKODI,AAP,0,Post Graduate,419204,0,419204
520,6067,Ashis Kumar Das,ULUBERIA,IND,0,Graduate,4266900,1362000,2904900
521,7809,Ashish,BATHINDA,IND,0,10th Pass,30267,0,30267
522,440,Ashish,KARNAL,AIFB,0,Graduate,2077000,1100000,977000
523,1238,Ashish Bhushan Pathak,CHATRA,IND,0,Post Graduate,3530500,0,3530500
524,29,Ashish Khetan,NEW DELHI,AAP,0,Post Graduate,17172618,3005294,14167324
525,2711,Ashish Ranjan Sinha,NALANDA,INC,0,Graduate,94210202,0,94210202
526,3115,Ashok,KHERI,AAP,0,Graduate Professional,392000,580000,0
527,4814,Ashok,UJJAIN,IND,0,12th Pass,70000,0,70000
528,3329,Ashok Babarao (Ambhore) Dudhgaonkar,PARBHANI,Ambedkar National Congress,0,12th Pass,50000,0,50000
529,3872,Ashok Bhagoji Thorat,BEED,IND,0,Not Given,50000,0,50000
530,2078,Ashok Bhardwaj,GURGAON,National Janhit Congress (AB),0,Graduate Professional,239374641,3790167,235584474
531,787,Ashok Bisi,BARGARH,CPI,2,Graduate Professional,644707,15000,629707
532,2416,Ashok Chandna,BHILWARA,INC,1,Graduate,141642689,89589191,52053498
533,3871,Ashok Dhondiba Sonwane,BEED,IND,0,8th Pass,0,0,0
534,3650,Ashok Dnanu Mane(Bhau),SANGLI,IND,0,12th Pass,527584,39000,488584
535,7217,Ashok Kisan Lokhande,MUMBAI NORTH CENTRAL,Republican Party of India,0,8th Pass,1274084,600000,674084
536,3970,Ashok Ku Bhagat,KATIHAR,IND,1,Literate,1196345,0,1196345
537,393,Ashok Kumar,GAYA,JMM,0,Post Graduate,1843000,0,1843000
538,2403,Ashok Kumar,KOTA,BSP,0,5th Pass,421000,0,421000
539,128,Ashok Kumar,SATNA,IND,0,Graduate,289957,0,289957
540,570,Ashok Kumar,JAMMU,BSP,0,10th Pass,4435000,350000,4085000
541,621,Ashok Kumar,NAWADA,Rajnaitik Vikalp Party,1,Literate,3116000,0,3116000
542,4481,Ashok Kumar,KATIHAR,IND,0,12th Pass,94891,0,94891
543,4414,Ashok Kumar,MAINPURI,IND,0,10th Pass,7695000,150000,7545000
544,4921,Ashok Kumar,AGRA,IND,0,10th Pass,5900000,0,5900000
545,4325,Ashok Kumar,FATEHPUR SIKRI,Gareeb Adami Party,0,10th Pass,1061000,0,1061000
546,5114,Ashok Kumar,KARAULI-DHOLPUR,IND,0,10th Pass,1565000,0,1565000
547,5516,Ashok Kumar,FATEHPUR,Samtawadi Republican Party,0,12th Pass,2974775,0,2974775
548,5761,Ashok Kumar,MISRIKH,BSP,0,Post Graduate,28370000,2302789,26067211
549,4279,Ashok Kumar Doharey,ETAWAH,BJP,0,Graduate,12252688,0,12252688
550,2400,Ashok Kumar Jain,KOTA,AAP,0,Graduate Professional,30617000,333466,30283534
551,131,Ashok Kumar Masih,BALAGHAT,CPI,0,5th Pass,184000,0,184000
552,1141,Ashok Kumar Panda,SAMBALPUR,IND,0,Graduate,5947626,853925,5093701
553,2238,Ashok Kumar Sharma,JAMMU,IND,0,Graduate,6156613,215602,5941011
554,2044,Ashok Kumar Vashishth,SONIPAT,RPI(A),0,10th Pass,1501000,0,1501000
555,7068,Ashok Kumar.A,KRISHNAGIRI,IND,0,8th Pass,349000,0,349000
556,7060,Ashok Kumar.K,KRISHNAGIRI,AIADMK,3,10th Pass,1176436,0,1176436
557,689,Ashok Mahadeorao Nete,GADCHIROLI-CHIMUR,BJP,0,12th Pass,12125676,5830550,6295126
558,792,Ashok Mittal,BARGARH,AITC,0,10th Pass,0,0,0
559,5736,Ashok Pandey,LUCKNOW,IND,0,Graduate Professional,2150000,0,2150000
560,6252,Ashok Paswan,SAMASTIPUR,Bahujan Mukti Party,0,Graduate,71308,0,71308
561,5708,Ashok Paswan Advocate,KANPUR,IND,0,Post Graduate,14685076,0,14685076
562,2915,Ashok Pawar,BHOPAL,Samata Samadhan Party,1,12th Pass,4808000,600000,4208000
563,3338,Ashok Pradhan,PURI,CPI(ML)L,2,Graduate Professional,2006000,300000,1706000
564,2646,Ashok Ram,ARRAH,IND,0,12th Pass,71051,0,71051
565,1259,Ashok Ram,PALAMAU,IND,0,10th Pass,3099116,0,3099116
566,3340,Ashok Sahu,PURI,BJP,1,Post Graduate,55639509,0,55639509
567,5630,Ashok Shankar Jadhav,THANE,Bahujan Mukti Party,0,Graduate Professional,19550000,970000,18580000
568,3392,Ashok Shirpati Khandebharad,SHIRUR,MNS,2,Graduate,11569911,1781742,9788169
569,2953,Ashok Singh,GWALIOR,INC,0,Graduate,288174756,77611615,210563141
570,418,Ashok Tanwar,SIRSA,INC,1,Doctorate,72777188,11222039,61555149
571,5844,Ashok Tarachand Patil,JALGAON,IND,0,Literate,4501297,0,4501297
572,5606,Ashok Tryambak Ingale,RAVER,IND,0,5th Pass,391000,0,391000
573,924,Ashok Vithoba Khandale,CHANDRAPUR,RPI,0,Graduate,10956000,1000000,9956000
574,7617,Ashok Vitthal Sonwane,JALNA,IND,1,Graduate,821000,700000,121000
575,3677,Ashok Waman Gaikwad,SATARA,RPI(A),3,12th Pass,13608263,857836,12750427
576,4941,Ashok Yadav,AKBARPUR,IND,0,Others,11178000,0,11178000
577,3810,Ashraf,MANDYA,IND,0,10th Pass,7310000,0,7310000
578,3113,Ashraf Ali,KHERI,Peace Party,1,Graduate Professional,141782,18710,123072
579,490,Ashutosh,CHANDNI CHOWK,AAP,3,Post Graduate,81121758,11140787,69980971
580,22,Ashutosh Mudgil,CHANDNI CHOWK,IND,0,8th Pass,453921,0,453921
581,1038,Ashwani Malhotra,KURUKSHETRA,AITC,0,10th Pass,1284743,0,1284743
582,2272,Ashweng J. Rengma,AUTONOMOUS DISTRICT,JMM,0,10th Pass,960000,0,960000
583,1052,Ashwini Kumar,KARNAL,BJP,6,Graduate,698638135,153937858,544700277
584,2656,Ashwini Kumar Choubey,BUXAR,BJP,0,Graduate,22094499,1923552,20170947
585,4691,Asif Jeelani,ANANTNAG,AIFB,0,Post Graduate,300000,0,300000
586,4078,Asif Khan,GWALIOR,IND,0,5th Pass,491000,0,491000
587,1579,Asif Khan,BALAGHAT,Minorities Democratic Party,0,10th Pass,180000,0,180000
588,4378,Asim Kumar Das,MURSHIDABAD,IND,0,Post Graduate,474723,0,474723
589,6070,Asit Mitra,ULUBERIA,INC,1,Graduate,1092609,0,1092609
590,5952,Aslam Hanif Khot,MUMBAI SOUTH CENTRAL,Peace Party,0,8th Pass,782000,0,782000
591,7635,Aslam Mistry,NAVSARI,Bharatiya Bahujan Congress,0,8th Pass,976254,0,976254
592,2419,Aslam Shekh Advocate,BHILWARA,IND,0,Post Graduate,7290000,0,7290000
593,5883,Asmita Pushkar Puranik,KALYAN,IND,0,12th Pass,1391585,0,1391585
594,3260,Asok Das,JAJPUR,INC,0,Post Graduate,14693759,5579589,9114170
595,1578,Asra Anjum Farooqui,BALAGHAT,RPI(A),0,Graduate,450000,0,450000
596,7444,Asraf Ali.M,TIRUCHIRAPPALLI,IND,0,5th Pass,1736907,510000,1226907
597,4003,Asrita Tuti,KHUNTI,IND,0,Post Graduate,3398931,560769,2838162
598,1167,Aswini Kumar Padhy,BERHAMPUR,BSP,0,Graduate Professional,392889,32000,360889
599,438,Atam Parkash,HISAR,IND,0,Post Graduate,13665554,0,13665554
600,352,Ateeque Ahmad Mohd. Badiujjama,NAGPUR,IND,2,10th Pass,14360527,7606,14352921
601,1113,Athawaley Sanjay Hiramanji,AMRAVATI,IND,1,Graduate,1120000,268900,851100
602,4673,Atmaram Sahu,DURG,SUCI(C),0,Post Graduate,777014,0,777014
603,1848,Attuveppil Kunhikkannan,VADAKARA,IND,0,5th Pass,452079,19000,433079
604,1487,Atul Ashok Munginwar,CHANDRAPUR,IND,1,12th Pass,3400000,740000,2660000
605,4391,Atul Chaturvedi,FIROZABAD,INC,0,Post Graduate,27115000,42300,27072700
606,1638,Atul Khodawal,MEERUT,IND,0,Illiterate,61500,0,61500
607,3072,Atul Kumar,BADAUN,IND,0,Graduate,2156941,593817,1563124
608,5531,Atul Kumar Singh,HAMIRPUR,AAP,0,Graduate Professional,2553384,3997631,0
609,3002,Atul Mishra,SAGAR,AAP,1,Graduate Professional,4823372,173000,4650372
610,3535,Atul Prasannakumar Dighe,KOLHAPUR,Bharipa Bahujan Mahasangh,3,Post Graduate,15499770,0,15499770
611,6862,Auditor Gopinarayanan,CHENNAI CENTRAL,Makkal Manadu Katchi,0,Others,13736350,0,13736350
612,7614,Autade Vilas Keshavrao,JALNA,INC,1,12th Pass,130505302,1056950,129448352
613,5956,Avhad Mahesh Zunjar,NASHIK,AIFB,0,10th Pass,0,0,0
614,2749,Avinash Kumar,PATALIPUTRA,Bharatiya Jan Kranti Dal (Democratic),0,Post Graduate,1520412,56797,1463615
615,5529,Avinash Kumar Mishra,HAMIRPUR,AITC,0,Post Graduate,68194327,0,68194327
616,3870,Avinash Namdev Wankhede,BEED,IND,2,Graduate Professional,745000,309000,436000
617,2971,Avnish Tiwari,KHAJURAHO,SHS,0,Graduate Professional,2918424,946893,1971531
618,6142,Avtar Singh,FATEHGARH SAHIB,IND,0,5th Pass,17500,0,17500
619,1272,Avtar Singh Bhadana,FARIDABAD,INC,1,8th Pass,112529244,0,112529244
620,6428,Avula Ranganayakulu,SECUNDERABAD,IND,0,Graduate,15485000,0,15485000
621,3496,Awade Kallappa Baburao,HATKANANGLE,INC,0,10th Pass,157503816,22322097,135181719
622,2733,Awadh Kumar,NALANDA,IND,0,Graduate,6189466,0,6189466
623,6175,Awdhesh Kumar Shingh,JHANJHARPUR,IND,0,Graduate,1280000,134,1279866
624,3901,Ayare Rajendra Lahu,RATNAGIRI SINDHUDURG,BSP,0,Post Graduate,1252000,200000,1052000
625,2972,Ayendr Kumar Sharma,KHAJURAHO,IND,0,Graduate,340000,0,340000
626,3082,Ayesha Islam,BAREILLY,SP,0,Graduate,26491794,4514160,21977634
627,6021,Ayesha Khatun,BIRBHUM,SUCI(C),0,Graduate,56500,0,56500
628,7380,"Ayodhi, L.( Dr).",SRIPERUMBUDUR,IND,0,Doctorate,7719824,745000,6974824
629,3454,Ayub Khan,NAGAUR,SP,0,8th Pass,6579000,100000,6479000
630,7560,Ayyadurai. S,THOOTHUKKUDI,BSP,3,Post Graduate,2914000,649000,2265000
631,7162,Ayyappan .S,RAMANATHAPURAM,IND,0,Not Given,620000,110000,510000
632,5071,Azad Husain,ALWAR,BSP,0,12th Pass,27566246,2125000,25441246
633,3622,Azam Vakil Maniyar,PUNE,IND,0,5th Pass,284000,0,284000
634,7164,Azhagu Meena .A,RAMANATHAPURAM,IND,0,Post Graduate,9651,5500,4151
635,7219,Azimuddin Khan,MUMBAI NORTH CENTRAL,The Lok Party of India,1,Graduate,873404,0,873404
636,6000,Aziz Abdul Kadir Mukadam,RAIGAD,SP,0,5th Pass,4228000,0,4228000
637,4091,Azmal Hussain,DHUBRI,AAP,0,12th Pass,14635426,0,14635426
638,3767,B N Gopalagowda,CHIKKBALLAPUR,IND,0,Graduate Professional,73000,0,73000
639,1895,B Padmanabhan,PALAKKAD,AAP,0,Graduate,1573288,0,1573288
640,2162,B Sreeramulu,BELLARY,BJP,8,Graduate,151392844,4050947,147341897
641,6424,B Subramanyam,SECUNDERABAD,IND,1,Graduate,9370500,6370000,3000500
642,6848,B. Ambeth Venkatesh,CHENNAI CENTRAL,IND,0,Illiterate,116000,0,116000
643,2216,B. Dharmappa,SHIMOGA,JD(U),0,Graduate Professional,13450336,700000,12750336
644,849,B. Gnana Prakash,DAVANAGERE,IND,0,Graduate,2665000,0,2665000
645,288,B. Gopalakrishnan,CHALAKUDY,BJP,2,Graduate Professional,5014237,644405,4369832
646,6939,B. Kumar Sri Sri,CHENNAI SOUTH,IND,0,Not Given,50000,0,50000
647,1097,B. R. Govindaiah,BANGALORE SOUTH,IND,0,12th Pass,4067500,23000,4044500
648,6395,B.B.Patil,ZAHIRABAD,TRS,0,Graduate,1023173039,83517670,939655369
649,3732,B.K. Narayana-Swamy,BANGALORE CENTRAL,IND,0,10th Pass,3000,0,3000
650,2220,B.K. Shashi Kumar,SHIMOGA,Karunaadu Party,0,10th Pass,61000,0,61000
651,3783,B.M.Jayadev Mathad,HAVERI,IND,3,Graduate,3050000,300000,2750000
652,3804,B.Manohar Hanumantappa,KOPPAL,IND,0,10th Pass,2035000,0,2035000
653,1225,B.N. Bachhegouda,CHIKKBALLAPUR,BJP,0,Graduate Professional,475228512,83632650,391595862
654,1085,B.N.Chandrappa,CHITRADURGA,INC,0,Post Graduate,48303759,13800000,34503759
655,2894,B.S. Thaneswariya,BHIND,Bahujan Mukti Party,0,Post Graduate,597002,0,597002
656,399,B.S. Yeddyurappa,SHIMOGA,BJP,9,12th Pass,69746267,500000,69246267
657,842,B.T.Lalitha Naik,GULBARGA,AAP,0,8th Pass,6006253,0,6006253
658,2120,B.V.Nayak,RAICHUR,INC,0,Graduate Professional,73502466,0,73502466
659,3788,B.V.Venkatagiriyappa,KOLAR,IND,0,Graduate,100000,320000,0
660,3726,B.V.Venkateshappa,BANGALORE CENTRAL,IND,0,10th Pass,16105000,0,16105000
661,7886,B.Veera Hanumantha Reddy,MALKAJGIRI,IND,0,Post Graduate,42790000,4100000,38690000
662,6449,B.Venkata Mallaiah,PEDDAPALLE,B. C. United Front,0,10th Pass,5625000,0,5625000
663,606,B.Venkatesha,TUMKUR,Karunaadu Party,0,Graduate Professional,6941000,4400000,2541000
664,3841,B.Vikraman,MADURAI,CPI(M),0,10th Pass,2591109,0,2591109
665,2307,Baadshah,ALIGARH,Peace Party,0,8th Pass,62260000,500000,61760000
666,7460,Baalu.T.R,THANJAVUR,DMK,0,Graduate,201555306,11054616,190500690
667,4785,Baba Abdul Hamid,KHANDWA,IND,0,Not Given,28285000,0,28285000
668,4413,Baba Hardev Singh,MAINPURI,AAP,0,Doctorate,9994500,0,9994500
669,3331,Baban (Anna) Muley,PARBHANI,Bahujan Mukti Party,0,12th Pass,907000,400000,507000
670,7621,Babasaheb Patil Shinde,JALNA,IND,0,10th Pass,351070,98300,252770
671,4383,Bablu Soren,RAIGANJ,Jharkhand Disom Party,0,12th Pass,260290,0,260290
672,4819,Babu Lal,VIDISHA,Samata Samadhan Party,0,8th Pass,260700,0,260700
673,2482,Babu Lal,BARMER,IND,0,8th Pass,569104,15000,554104
674,4726,Babu Lal Soren,DUMKA,AITC,0,Literate,575800,0,575800
675,6873,Babu Mailan .A,CHENNAI NORTH,Lok Satta Party,0,Graduate Professional,4319709,940000,3379709
676,2629,Babu Mathew,BANGALORE NORTH,AAP,0,Post Graduate,94852273,494702,94357571
677,2430,Babu Meghwal,CHITTORGARH,IND,0,Literate,417102,0,417102
678,1306,Babu Singh Dukhiya,WEST DELHI,IND,1,Graduate,1851000,0,1851000
679,6605,Babubhai Chhaganbhai Talaviya,VALSAD,Bahujan Mukti Party,0,Graduate,1944802,0,1944802
680,4316,Babulal,FATEHPUR SIKRI,BJP,3,12th Pass,73028848,16390000,56638848
681,6643,Babulal,BARABANKI,Manavtawadi Samaj Party,0,Literate,7116000,180500,6935500
682,5118,Babulal Jangid,TONK-SAWAI MADHOPUR,IND,1,10th Pass,68800,0,68800
683,4730,Babulal Marandi,DUMKA,JVM(P),0,Graduate,6974656,0,6974656
684,176,Babupasha,BIDAR,IND,0,Not Given,12500,50000,0
685,1451,Baburao Damaduji Meshram,NAGPUR,IND,0,12th Pass,3810000,200000,3610000
686,4206,Babusingh,RATLAM,BSP,0,8th Pass,1170000,0,1170000
687,7960,Bachala Laxmaiah,KHAMMAM,IND,0,Illiterate,425000,0,425000
688,6129,Badal Singh,FARIDKOT,IND,0,8th Pass,50000,0,50000
689,4376,Badaruddoza Khan,MURSHIDABAD,CPI(M),0,Graduate,2758610,0,2758610
690,5346,Badhivala Labhubhai Jivrajbhai,KHEDA,AAP,0,Post Graduate,15806050,0,15806050
691,4000,Badri Gope,HAZARIBAGH,IND,0,5th Pass,1756000,0,1756000
692,4088,Badruddin Ajmal,DHUBRI,AIUDF,1,Others,432748134,0,432748134
693,3917,Badshah Khan,BHOPAL,Naya Daur Party,0,8th Pass,255000,0,255000
694,6326,Bagatsingh Palanichamy M,DINDIGUL,BSP,1,8th Pass,1625034,0,1625034
695,4162,Baghrai Soren,DUMKA,IND,0,Graduate Professional,765000,0,765000
696,374,Bagi Kumar Verma,AURANGABAD,JD(U),0,Graduate,32766379,1600000,31166379
697,803,Bagi Lakra,SUNDARGARH,BSP,1,Graduate Professional,1925530,88983,1836547
698,5834,Bagul Vedu Tanaji,JALGAON,BSP,0,Literate,960000,0,960000
699,6474,Bagwan B,NIZAMABAD,IND,0,Not Given,100000,0,100000
700,6075,Bahaddur Srinivasulu,NAGARKURNOOL,BSP,0,Post Graduate,11505000,1500000,10005000
701,5841,Bahadur Ragib Ahamed,JALGAON,SP,0,Post Graduate,278918,0,278918
702,6839,Bahadur Ram,SURGUJA,IND,0,8th Pass,182000,0,182000
703,4225,Bahadur Singh,BHARATPUR,BJP,0,Literate,19142363,1333100,17809263
704,456,Bahadur Singh,BHIWANI-MAHENDRAGARH,INLD,0,5th Pass,182580199,8699200,173880999
705,577,Bahadur Singh Chowdhary,JAMMU,SP,0,Graduate,1431120,298000,1133120
706,4008,Bahadur Uraon,RANCHI,CPI(ML)L,1,10th Pass,992464,600000,392464
707,3315,Baidhar Mallick,JAGATSINGHPUR,BJP,1,Graduate,6027197,700000,5327197
708,6162,Baijnath Paswan,BEGUSARAI,IND,0,Graduate,119000,0,119000
709,2637,Baijnath Yadav,ARRAH,Bahujan Mukti Party,0,5th Pass,6060167,350000,5710167
710,223,Baikuntha Dhangada Majhi,KALAHANDI,Kalinga Sena,0,10th Pass,20000,0,20000
711,1575,Baishakhoo Maravi,MANDLA,Bhartiya Satya Sangharsh Party,0,5th Pass,0,0,0
712,5126,Bajarang Lal,TONK-SAWAI MADHOPUR,Rashtriya Ahinsa Manch,0,10th Pass,120000,0,120000
713,4643,Bajarang Sidar,RAIGARH,IND,0,12th Pass,398200,12000,386200
714,3396,Bajare Sitaram Namdeo (Baba),SHIRUR,Bahujan Mukti Party,0,Graduate,13978791,0,13978791
715,4269,Bajrang Prasad,AKBARPUR,Samtawadi Republican Party,0,Graduate,1834806,0,1834806
716,6842,Bakkani Narsimlu,NAGARKURNOOL,TDP,0,10th Pass,468000,0,468000
717,8542,Bal Krishan Sharma,AMRITSAR,IND,0,10th Pass,16766167,0,16766167
718,5486,Bal Kumar Patel Alias Rajkumar,BANDA,SP,9,12th Pass,41004212,13432893,27571319
719,5915,Bala Dagadu Nandgaonkar,MUMBAI SOUTH,MNS,8,10th Pass,77108523,1921378,75187145
720,7450,Bala Krishnan.K,TIRUCHIRAPPALLI,IND,0,12th Pass,67267,0,67267
721,7033,Bala Subramanian T.,KANNIYAKUMARI,IND,1,Post Graduate,1490000,0,1490000
722,816,Balabhadra Majhi,NABARANGPUR,BJD,0,Graduate,52977088,705404,52271684
723,3550,Balaji Dnyanoba Kamble,LATUR,SP,0,Post Graduate,2860000,0,2860000
724,6892,Balaji. E,CHENNAI NORTH,IND,0,Post Graduate,1076500,180000,896500
725,7174,Balakrishnan .S.S.,RAMANATHAPURAM,IND,1,Not Given,4355000,500000,3855000
726,7480,Balakrishnan P,SIVAGANGA,IND,0,5th Pass,38400,0,38400
727,7013,"Balamurugan, R",KANCHEEPURAM,IND,0,Others,63000,0,63000
728,7363,Balamurugan.B,TIRUVALLUR,AAP,0,Post Graduate,7900951,220000,7680951
729,7112,"Balan, P.P.",NILGIRIS,IND,0,Post Graduate,0,0,0
730,6834,Balaraju Mittapally,MEDAK,IND,0,5th Pass,758000,0,758000
731,1152,Balaram Hota,KALAHANDI,CPI(ML)L,0,Others,1150,0,1150
732,5151,Balasaheb Asaram Sarate,AURANGABAD,IND,0,Post Graduate,5849936,1955530,3894406
733,3681,Balasaheb Dashrath Bagul,SHIRDI,IND,0,Literate,483000,0,483000
734,1377,Balasaheb Shankar Darade,BULDHANA,IND,0,Post Graduate,2334214,331493,2002721
735,5152,Balasaheb Vitthal Aware,AURANGABAD,IND,0,10th Pass,1831343,16000,1815343
736,6329,Balasubramani.R,DINDIGUL,Ulzaipali Makkal Katchy,0,12th Pass,1511000,0,1511000
737,3916,Balbhadra Mishra,BHOPAL,Bhartiya Jan Yug Party,0,8th Pass,1802210,350000,1452210
738,2145,Balbheem,BIDAR,IND,0,Graduate,415000,0,415000
739,6102,Balbir Singh,AMRITSAR,Bharatiya Gaon Taj Dal,0,5th Pass,2387000,0,2387000
740,6104,Balbir Singh Jadla,ANANDPUR SAHIB,CPI(M),0,10th Pass,28030000,110000,27920000
741,1044,Balbir Singh Saini,KURUKSHETRA,INLD,0,Graduate,42261869,4284205,37977664
742,2392,Baldar,JHALAWAR-BARAN,IND,0,8th Pass,2935000,150000,2785000
743,5383,Baldau Prasad Sahu,DURG,IND,0,8th Pass,114412,0,114412
744,4502,Baldau Prasad Sahu,BILASPUR,IND,0,Graduate,320500,0,320500
745,7687,Baldeep Singh,KHADOOR SAHIB,AAP,0,Graduate,39447450,0,39447450
746,4001,Baldeo Ganjhu,HAZARIBAGH,IND,2,10th Pass,450746,0,450746
747,4514,Baldeo Maravi,SURGUJA,GGP,0,10th Pass,7132000,0,7132000
748,366,Baleshwar Bharti,SASARAM,BSP,0,10th Pass,273200,0,273200
749,5262,Baleshwar Marandi,KATIHAR,JMM,0,Graduate,465871,0,465871
750,6256,Baleshwar Paswan,SAMASTIPUR,Janta Dal Rashtravadi,0,Graduate,1958000,100000,1858000
751,3580,Baliram Sukhdev More,MADHA,IND,0,Others,1202111,375345,826766
752,5979,Baliram Sukur Jadhav,PALGHAR,Bahujan Vikas Aaghadi,1,8th Pass,20841211,2292937,18548274
753,2019,Baljeet,HISAR,IND,0,Graduate,410700,0,410700
754,6154,Baljinder Singh,FIROZPUR,Bharatiya Gaon Taj Dal,0,Graduate,1118000,0,1118000
755,7746,Baljit Kaur,ANANDPUR SAHIB,IND,0,5th Pass,225281,0,225281
756,6467,Balka Suman,PEDDAPALLE,TRS,1,Post Graduate,7351329,620770,6730559
757,3025,Balkrishna Salgaonkar,SOUTH GOA,IND,0,Illiterate,311650,0,311650
758,2291,Balraj Bawari,GANGANAGAR,IND,0,10th Pass,573000,0,573000
759,972,Balram Bari,CHANDNI CHOWK,IND,0,8th Pass,2980000,0,2980000
760,4021,Balram Kumar Bedia,RANCHI,IND,0,12th Pass,5287989,125000,5162989
761,7472,Balu S,SIVAGANGA,Tamil Nadu Makkal Congress,0,8th Pass,323000,0,323000
762,7947,Balunayak Bhukya,MAHABUBABAD,IND,0,Graduate Professional,265000,0,265000
763,6561,Balusingh Somansingh Narve,SABARKANTHA,IND,0,Post Graduate,665409,3600,661809
764,2020,Balwan Singh,HISAR,IND,0,12th Pass,3560500,300000,3260500
765,1234,Balwant Kumar,CHATRA,Jharkhand Party,1,Graduate,9514000,0,9514000
766,1998,Balwant Singh,SIRSA,Bharatiya Sant Mat Party,0,10th Pass,1053000,0,1053000
767,2292,Balwant Singh Hariyala,GANGANAGAR,Bharatiya Sant Mat Party,0,10th Pass,1053000,0,1053000
768,2961,Balwant Singh Kushwah Advocate,GWALIOR,SP,0,Graduate Professional,3200000,80000,3120000
769,7688,Balwant Singh Sultanpuri,KHADOOR SAHIB,Bahujan Samaj Party (Ambedkar),0,8th Pass,95000,0,95000
770,417,Balwinder Kaur,KURUKSHETRA,AAP,0,10th Pass,17852106,1196325,16655781
771,7694,Balwinder Singh,KHADOOR SAHIB,IND,2,Post Graduate,1915000,0,1915000
772,7330,Bamaniya Jyotishkumar Bapubhai,DAHOD,BSP,0,8th Pass,155000,0,155000
773,1178,Banamali Majhi,KORAPUT,Ambedkarite Party of India,0,Post Graduate,48000,0,48000
774,4439,Bandana Barman Baruah,GAUHATI,SP,0,Graduate,2087486,0,2087486
775,6420,Bandaru Dattatreya,SECUNDERABAD,BJP,3,Graduate,98255148,405469,97849679
776,2135,Bandeppa,BIDAR,JD(S),0,Graduate Professional,73218291,3333600,69884691
777,3659,Bandgar Nanaso Balaso,SANGLI,BSP,0,8th Pass,2743505,14000,2729505
778,2879,Bandhu Tirkey,RANCHI,AITC,7,Graduate,1832121,1261689,570432
779,7869,Bandi Sudhakar,MALKAJGIRI,Jai Samaikyandhra Party,0,12th Pass,9271228,0,9271228
780,1767,Bangshi Badan Barman,COOCHBEHAR,IND,5,Graduate,7528892,0,7528892
781,6498,Banja Veerappa,NIZAMABAD,Pyramid Party of India,0,10th Pass,2318000,273820,2044180
782,2537,Banjare Babulal Sundarlal,NAGPUR,IND,0,10th Pass,51017,0,51017
783,7678,Banka Sahadev,ADILABAD,IND,1,Graduate,393000,0,393000
784,3817,Bannur Kumar,MYSORE,IND,0,Graduate,7250000,0,7250000
785,4793,Bano Bee,MANDSOUR,Bharatiya Minorities Suraksha Mahasangh,0,Illiterate,34000,0,34000
786,4530,Banoth Laxma Naik,KHAMMAM,IND,0,12th Pass,4782000,0,4782000
787,7938,Banoth Mohanlal,MAHABUBABAD,TDP,0,Post Graduate,40179000,0,40179000
788,4796,Banshilal Patidar,MANDSOUR,Bahujan Sangharshh Dal,1,5th Pass,3564058,2035000,1529058
789,3899,Bansi Lal,UDHAMPUR,IND,0,8th Pass,6730000,200000,6530000
790,3632,Bansode Chayya Tukaram,PUNE,IND,0,8th Pass,309000,0,309000
791,3547,Bansode Dattatray Gunderao,LATUR,INC,0,Post Graduate,4006396,787720,3218676
792,7236,Bansode Dilip Bapu,MUMBAI NORTH EAST,IND,0,10th Pass,50000,0,50000
793,3564,Bansode Kundan Fulchand,MADHA,BSP,0,5th Pass,410000,30000,380000
794,5153,Bansode Udhav Govardhan,AURANGABAD,IND,0,Graduate,615000,600000,15000
795,5154,Banswal Mannalal Premchand,AURANGABAD,Prabuddha Republican Party,0,Not Given,65000,0,65000
796,1462,Bante Jitendra Ramaji,BHANDARA-GONDIYA,IND,0,12th Pass,510000,0,510000
797,475,Banwari Saw,CHATRA,CPI,0,Literate,5765202,553000,5212202
798,6057,Bappi Aparesh Lahiri,SREERAMPUR,BJP,0,8th Pass,172256444,16091280,156165164
799,6573,Bar Ajamalbhai Karmanbhai,SURENDRANAGAR,Bahujan Mukti Party,3,10th Pass,2791000,0,2791000
800,4745,Barnard Hembrom,RAJMAHAL,Rashtriya Krantikari Samajwadi Party,0,12th Pass,8001008,0,8001008
801,3356,Barne Shrirang Chandu,MAVAL,SHS,2,8th Pass,665047926,11799786,653248140
802,3359,Barne Shrirang Chimaji,MAVAL,JD(U),0,Literate,953049,0,953049
803,4863,Barun Karmakar,BARPETA,IND,0,12th Pass,713000,0,713000
804,6771,Barun Kumar Jha,JHANJHARPUR,IND,0,Graduate Professional,48626946,0,48626946
805,2870,Basant Kumar Longa,KHUNTI,JVM(P),0,Graduate,5442300,0,5442300
806,497,Basant Panwar,NORTH WEST DELHI,BSP,0,8th Pass,2162778,27500,2135278
807,1165,Basanta Kumar Pradhan,KANDHAMAL,IND,0,12th Pass,150000,0,150000
808,1821,Basappa Kallappa Hanchanal,CHIKKODI,IND,0,12th Pass,15991000,270000,15721000
809,2179,Basavanteppa Honnappa Hullatti,HAVERI,Sarva Janata Party,0,Graduate Professional,0,0,0
810,1185,Basavaraj,KOPPAL,INC,0,10th Pass,38334476,2144769,36189707
811,1080,Basavaraj K.J,DAVANAGERE,AAP,0,Graduate,974000,30000,944000
812,2524,Basavegowda,BANGALORE RURAL,RPI(A),0,Graduate,447000,74000,373000
813,2529,Bashir Khan Ramzan Khan,NAGPUR,Minorities Democratic Party,0,Graduate,7839000,52000,7787000
814,6814,Bashir Mohammad Reshi,SRINAGAR,IND,0,12th Pass,15000000,0,15000000
815,800,Basil Ekka,SUNDARGARH,AAP,0,10th Pass,333388,1000000,0
816,6540,Basirbhai Sulemanbhai Sama,RAJKOT,IND,0,5th Pass,185149,0,185149
817,5437,Baskaran M R,TIRUVANNAMALAI,BSP,0,8th Pass,3002000,79000,2923000
818,3389,Basu Mog,TRIPURA EAST,IND,0,10th Pass,1911085,0,1911085
819,3219,Basudeb Naik,KEONJHAR,IND,2,10th Pass,27042432,2090125,24952307
820,4603,Bathwar Nanjibhai Amarshibhai,JAMNAGAR,IND,1,Literate,866500,0,866500
821,3785,Beeda Srinivas N,KOLAR,IND,0,Literate,1356000,600000,756000
822,3127,Begum Noor Bano Urf Mehtab,MORADABAD,INC,0,10th Pass,78531612,0,78531612
823,5882,Belamkar Milind Chandrakant,KALYAN,Lok Bharati,0,10th Pass,13238000,4000000,9238000
824,7017,Bellarmin A.V.,KANNIYAKUMARI,CPI(M),1,Post Graduate,8419973,329228,8090745
825,4441,Benedict Alok Areng,GAUHATI,IND,1,10th Pass,565000,20000,545000
826,2511,Benet Babu Benjamin,THIRUVANANTHAPURAM,IND,0,10th Pass,3503683,0,3503683
827,7781,Benjamin Raju,ZAHIRABAD,IND,0,Graduate Professional,1246959,0,1246959
828,632,Bennet Abraham,THIRUVANANTHAPURAM,CPI,1,Post Graduate,34112353,0,34112353
829,6684,Betalal Diwakar,KANPUR,IND,0,Graduate Professional,1055000,0,1055000
830,5311,Bhabhor Jasvantsinh Sumanbhai,DAHOD,BJP,0,Graduate Professional,19661231,1741547,17919684
831,7331,Bhabhor Mavajibhai Titubhai,DAHOD,SP,0,Literate,290000,0,290000
832,4806,Bhadiya,RATLAM,IND,1,Illiterate,1901000,50000,1851000
833,4860,Bhadreswar Barman,BARPETA,IND,0,12th Pass,251000,0,251000
834,2811,Bhagat Ram Soni,RAJNANDGAON,Chhattisgarh Swabhiman Manch,0,12th Pass,8742244,0,8742244
835,1553,Bhagawati Charan Pandey(Neelu),SIDHI,IND,0,Graduate,3425500,100000,3325500
836,2898,Bhagirath Prasad,BHIND,BJP,0,Doctorate,21240286,3687610,17552676
837,2352,Bhagirath Singh,SIKAR,Akhil Bharat Hindu Mahasabha,0,Post Graduate,258000,0,258000
838,2124,Bhagvantappa,RAICHUR,Lok Satta Party,0,Illiterate,609998,66000,543998
839,3019,Bhagwan Das,TIKAMGARH,IND,0,10th Pass,656000,0,656000
840,3140,Bhagwan Dass Rathor,NAGINA,Mahan Dal,0,Graduate Professional,9219083,0,9219083
841,1835,Bhagwan Kambale,BIJAPUR,RPI(A),0,5th Pass,906668,150000,756668
842,7723,Bhagwan Singh Chauhan,HOSHIARPUR,BSP,0,Graduate,4030849,2640000,1390849
843,7830,Bhagwant Mann,SANGRUR,AAP,0,12th Pass,43057512,16281200,26776312
844,6090,Bhagwant Singh,AMRITSAR,IND,0,10th Pass,3333000,630305,2702695
845,7839,Bhagwant Singh,SANGRUR,IND,0,12th Pass,1051000,0,1051000
846,6121,Bhagwant Singh Samaon,BATHINDA,CPI(ML)L,3,8th Pass,277000,15000,262000
847,2141,Bhagwanth,BIDAR,BJP,0,Graduate Professional,56559290,16829000,39730290
848,3881,Bhagwat Harihar Taware,BEED,IND,0,Graduate,0,0,0
849,1793,Bhaichung Bhutia,DARJEELING,AITC,0,10th Pass,184406721,7746438,176660283
850,7311,Bhailalbhai Chhanabhai Rathod,BARDOLI,Aadivasi Sena Party,0,5th Pass,35124,0,35124
851,39,Bhairaw Dayal Singh,KARAKAT,IND,0,Post Graduate,16847000,0,16847000
852,5484,Bhairon Prasad Mishra,BANDA,BJP,3,12th Pass,50034910,600000,49434910
853,4780,Bhaiyalal Uikey,KHANDWA,GGP,0,Literate,3265000,500000,2765000
854,814,Bhakta Charan Das,KALAHANDI,INC,1,Graduate Professional,11516583,3875982,7640601
855,5203,Bhamare Subhash Ramrao,DHULE,BJP,0,Graduate Professional,125833320,660757,125172563
856,3326,Bhambale Vijay Manikrao,PARBHANI,NCP,3,10th Pass,14944093,1895188,13048905
857,4905,Bhambhi Chandubhai Mulchandbhai,SABARKANTHA,BSP,0,12th Pass,858000,400000,458000
858,2335,Bhan Singh,JHUNJHUNU,Bharatiya Sant Mat Party,0,10th Pass,452500,0,452500
859,5596,Bhande Dashrath Motiram,RAVER,BSP,1,Post Graduate,34810892,0,34810892
860,2441,Bhanji Bhai,BANSWARA,JD(U),0,8th Pass,15752404,250000,15502404
861,5540,Bhanu Pratap Singh,JALAUN,BJP,0,Post Graduate,5774068,650000,5124068
862,5631,Bhanudas Dhotare,THANE,IND,0,12th Pass,2500000,0,2500000
863,5155,Bhanudas Ramdas Sarode,AURANGABAD,IND,0,Not Given,0,0,0
864,3809,Bhanuprakash.K.L,MANDYA,IND,0,Post Graduate,3828500,0,3828500
865,2300,Bhanwar Lal,BIKANER,BSP,0,10th Pass,3840000,980000,2860000
866,2440,Bhanwar Lal,CHITTORGARH,IND,0,10th Pass,1155000,0,1155000
867,2461,Bhanwar Lal Mali,RAJSAMAND,IND,0,8th Pass,2671280,171200,2500080
868,3420,Bhanwar Lal Soni,AJMER,IND,0,8th Pass,1650000,0,1650000
869,3433,Bhanwar Lal Waghela,JALORE,IND,0,12th Pass,233675,0,233675
870,3456,Bhanwar Singh Rathore,NAGAUR,AITC,0,Graduate,42000,0,42000
871,4815,Bhanwarlal,UJJAIN,Jai Maha Bharath Party,0,10th Pass,32904,0,32904
872,2289,Bhanwarlal Meghwal,GANGANAGAR,INC,0,Post Graduate,24098177,255803,23842374
873,3360,Bhapkar Maruti Sahebrao,MAVAL,AAP,18,12th Pass,14386607,195500,14191107
874,5127,Bhar Singh,TONK-SAWAI MADHOPUR,Socialist Party (India),0,5th Pass,211000,0,211000
875,1187,Bharadhawaja,KOPPAL,CPI(ML)L,0,Others,430000,0,430000
876,4674,Bharat Bhusan Pandey,DURG,CPI(ML) Red Star,1,12th Pass,7402516,50000,7352516
877,2638,Bharat Bhushan Pandey,ARRAH,Akhil Bharatiya Jan Sangh,0,Doctorate,1757000,0,1757000
878,3560,Bharat Damodar Londhe,LATUR,IND,0,Graduate,279000,20000,259000
879,3551,Bharat Maroti Kadam,LATUR,Ambedkarite Party of India,0,10th Pass,6906,0,6906
880,2999,Bharat Sen Advocate,SAGAR,IND,0,Graduate Professional,205966,0,205966
881,5803,Bharat Tripathi,SITAPUR,SP,0,Post Graduate,18659184,0,18659184
882,3839,Bharathi Kannamma,MADURAI,IND,0,Graduate,105000,0,105000
883,7075,Bharathi Mohan R.K,MAYILADUTHURAI,AIADMK,1,12th Pass,7378589,969756,6408833
884,7375,"Bharathi, K. Thiru",SRIPERUMBUDUR,CPI(ML)L,0,Post Graduate,1108295,40000,1068295
885,7385,Bharathidasan R. Thiru.,SRIPERUMBUDUR,IND,0,Post Graduate,435535,0,435535
886,4266,Bharti Devi Pasi,AKBARPUR,IND,0,Graduate Professional,9262010,0,9262010
887,3276,Bhartruhari Mahatab,CUTTACK,BJD,0,Post Graduate,88834098,0,88834098
888,3714,Bhaskar Chandra Mohanty,PURI,BSP,0,Graduate Professional,8215000,0,8215000
889,2809,Bhaskar Dwivedi,RAJNANDGAON,AAP,0,Post Graduate,12708752,4814872,7893880
890,4525,Bhaskar Kaki,KHAMMAM,IND,0,Graduate,2360000,0,2360000
891,320,Bhaskar Marotrao Neware,WARDHA,IND,0,Post Graduate,132798,0,132798
892,717,Bhaskaran K V,ERNAKULAM,IND,1,Graduate,4640900,350000,4290900
893,3403,Bhausaheb Rajaram Wakchaure,SHIRDI,INC,1,Doctorate,73540816,9030001,64510815
894,6940,Bhavani Janakiram,CHENNAI SOUTH,IND,0,Post Graduate,425000,350000,75000
895,7318,Bhavesh Ghanshyambhai Rajyaguru,BHAVNAGAR,IND,0,10th Pass,6703000,123028,6579972
896,6085,Bhavesh Patel,DAMAN & DIU,BSP,0,Others,390242,0,390242
897,316,Bhavna Bhavesh Wasnik,AMRAVATI,AAP,0,Post Graduate,12289332,880320,11409012
898,2546,Bheemappa Dhoolappa Ajjodi,BAGALKOT,IND,0,Post Graduate,192646,31200,161446
899,4804,Bheru Singh Damor,RATLAM,JD(U),0,10th Pass,1304200,107000,1197200
900,5228,Bherulal Imliyar,DHAR,Bahujan Mukti Party,0,12th Pass,504167,21000,483167
901,6195,Bhikha Paswan,MADHEPURA,Bharat Vikas Morcha,0,Graduate,5819278,103000,5716278
902,1067,Bhimaraya,RAICHUR,AAP,0,10th Pass,2885000,65000,2820000
903,3366,Bhimrao Anna Kadale,MAVAL,IND,0,10th Pass,1770000,0,1770000
904,3701,Bhise Krishna Nagnath,SOLAPUR,IND,0,10th Pass,511665,0,511665
905,3465,Bhojraj,PALI,BSP,0,Others,18480000,0,18480000
906,2710,Bhola Sao,NALANDA,Krantikari Vikas Dal,0,Literate,140000,0,140000
907,6156,Bhola Singh,BEGUSARAI,BJP,0,Doctorate,25248102,0,25248102
908,7239,Bhole Pushpa Milind,MUMBAI NORTH WEST,BSP,2,Graduate Professional,59238640,4242867,54995773
909,4897,Bhoraniya Soyabbhai Hasambhai,PATAN,IND,0,8th Pass,2413000,0,2413000
910,3592,Bhosale Revan Vishwanath,OSMANABAD,JD(S),0,Post Graduate,11357709,1688121,9669588
911,3728,Bhovi Rama C.B.K,BANGALORE CENTRAL,IND,0,8th Pass,101000,0,101000
912,2496,Bhriguram Reang,TRIPURA EAST,AITC,0,12th Pass,1132884,31473,1101411
913,2334,Bhudar Mal,JHUNJHUNU,AITC,0,Post Graduate,12290000,100000,12190000
914,5960,Bhujbal Chhagan Chandrakant,NASHIK,NCP,1,10th Pass,217559536,350000,217209536
915,2834,Bhuneshwar Prasad Mehta,HAZARIBAGH,CPI,1,12th Pass,10483915,0,10483915
916,385,Bhuneswar Das,GAYA,Rashtriya Ahinsa Manch,0,Literate,1829000,0,1829000
917,1312,Bhup Singh,NORTH WEST DELHI,IND,0,Graduate Professional,61711,0,61711
918,136,Bhupen Kumar Borah,TEZPUR,INC,0,Post Graduate,26084515,3350225,22734290
919,5053,Bhupendra Kumar Dhangar,MATHURA,Rashtriya Shoshit Samamj Party,0,12th Pass,215500,0,215500
920,4754,Bhupendra Singh Uikey,BETUL,IND,0,Post Graduate,50000,0,50000
921,7818,Bhupesh Kumar,BATHINDA,IND,0,Graduate Professional,600000,0,600000
922,2051,Bhupeshwar Dayal,SONIPAT,IND,0,Graduate Professional,3058174,0,3058174
923,196,Bhupinder Kumar,AMBALA,IND,0,10th Pass,120000,0,120000
924,7695,Bhupinder Singh,KHADOOR SAHIB,IND,0,12th Pass,1500,0,1500
925,7335,Bhura Navalabhai Manabhai,DAHOD,IND,0,12th Pass,330000,0,330000
926,1021,Bhura Ram,AMBALA,IND,0,Not Given,26119165,0,26119165
927,5307,Bhura Shabbirbhai Valibhai,BHARUCH,IND,0,10th Pass,567500,0,567500
928,3972,Bibhaker Jha,KATIHAR,AAP,1,Graduate,373035,0,373035
929,3314,Bibhu Prasad Tarai,JAGATSINGHPUR,INC,0,Post Graduate,5756318,799000,4957318
930,7858,Bibi Kamaldeep Kaur Rajoana,PATIALA,IND,0,Graduate,6666352,27000,6639352
931,3241,Bichitra Nanda Das,BALASORE,BSP,1,Post Graduate,5325200,0,5325200
932,3665,Bichukale Abhijit Vamanrao,SATARA,IND,0,Graduate,60397,0,60397
933,3784,Bidaragaddi V.B,HAVERI,IND,0,Graduate,22810000,1150000,21660000
934,2824,Bideshi Mahto,GIRIDIH,Jharkhand Disom Party,0,Graduate,6928610,0,6928610
935,836,Bidhan Chandra Panda,BERHAMPUR,Samata Kranti Dal,0,10th Pass,3551085,950000,2601085
936,4453,Bidya Nand Paswan,ARARIA,Bahujan Mukti Party,0,12th Pass,856973,7000,849973
937,809,Bighna Raj Panda,KALAHANDI,Samruddha Odisha,1,12th Pass,764550,58637,705913
938,6767,Bighnesh Bhagat,JHANJHARPUR,Bahujan Mukti Party,0,Graduate,2092390,0,2092390
939,3349,Bijay Mohanty,BHUBANESWAR,INC,0,Others,17367991,0,17367991
940,828,Bijaya Kumar Mahapatro,ASKA,BSP,0,10th Pass,50000,0,50000
941,7838,Bijender,SANGRUR,IND,0,10th Pass,790500,0,790500
942,2050,Bijender Kumar,SONIPAT,IND,0,10th Pass,1650000,0,1650000
943,680,Bijendra Singh,ALIGARH,INC,2,Graduate,12292000,2201014,10090986
944,1785,Bijoy Chandra Barman,JALPAIGURI,AITC,0,Post Graduate,9396430,797019,8599411
945,527,Bijoy Kr. Tiru,KALIABOR,AIUDF,0,Graduate,5238298,0,5238298
946,6030,Bijoy Krishna Dolui,BOLPUR,SUCI(C),0,Doctorate,2049581,4000000,0
947,139,Bijoy Krishna Handique,JORHAT,INC,0,Post Graduate,43378685,0,43378685
948,2263,Bijoy Krishna Nath,SILCHAR,AGP,0,Graduate,11038641,0,11038641
949,6867,Biju Chacko,CHENNAI NORTH,INC,0,Graduate Professional,53691343,516000,53175343
950,1945,Biju Joseph,IDUKKI,IND,0,10th Pass,1867208,0,1867208
951,3281,Bikash Das,CUTTACK,AAP,0,Doctorate,19920752,4700000,15220752
952,1163,Bilasini Nayak,KANDHAMAL,Aama Odisha Party,0,10th Pass,691500,0,691500
953,312,Bilkan Bara,ALIPURDUARS,Samajwadi Jan Parishad,0,Graduate Professional,9069500,62000,9007500
954,4835,Bimal Mardi,MALDAHA DAKSHIN,Jharkhand Disom Party,0,Graduate,160000,0,160000
955,4352,Bimalendu Sarkar,BALURGHAT,RSP,0,Post Graduate,9149229,0,9149229
956,4238,Bimla Devi Meena,DAUSA,IND,0,Graduate,19869123,800000,19069123
957,3275,Binapani Das,CUTTACK,SUCI(C),0,12th Pass,127124,0,127124
958,161,Binay Debbarma,TRIPURA WEST,Indigenous Peoples Front of Tripura,1,Graduate Professional,520000,0,520000
959,1881,Bindu M.K.,PONNANI,IND,0,8th Pass,318706,33000,285706
960,6211,Binghi Rajashekar,HYDERABAD,Pyramid Party of India,0,10th Pass,490000,200000,290000
961,42,Binod Gogoi,KALIABOR,IND,0,Graduate,3600000,0,3600000
962,624,Binod Kumar Das,JAMUI,AAP,1,12th Pass,252600,0,252600
963,5278,Binod Kumar Sahu,SUPAUL,IND,0,Graduate,1535000,50000,1485000
964,4715,Binod Singh,DHANBAD,IND,0,10th Pass,963000,0,963000
965,6763,Bipin Kumar Jha,JHANJHARPUR,Bharat Vikas Morcha,0,Graduate,4051668,300000,3751668
966,980,Bir Singh Soni,CHANDNI CHOWK,IND,0,12th Pass,1030100,0,1030100
967,2271,Biren Singh Engti,AUTONOMOUS DISTRICT,INC,0,Post Graduate,35367390,0,35367390
968,1777,Birendra Bara (Oraon),ALIPURDUARS,BJP,0,Graduate,115340,0,115340
969,484,Birendra Bhagat,LOHARDAGA,JVM(P),0,10th Pass,2911000,0,2911000
970,6180,Birendra Kumar Chaudhary,JHANJHARPUR,BJP,0,Post Graduate,5158792,0,5158792
971,4022,Birendra Kumar Jaiswal,RANCHI,IND,0,10th Pass,10201398,1698482,8502916
972,4435,Birendra Prasad Baishya,GAUHATI,AGP,0,Post Graduate,15564483,1790999,13773484
973,127,Birendra Singh,SATNA,IND,0,12th Pass,2451500,100000,2351500
974,7213,Birje Hemant Anant,MUMBAI NORTH CENTRAL,AIFB,0,Graduate,60430000,0,60430000
975,3644,Birje Yashwant Anant,RATNAGIRI SINDHUDURG,Bahujan Mukti Party,0,Post Graduate,3278000,0,3278000
976,5537,Bishambhar Prasad Nishad,HAMIRPUR,SP,3,Post Graduate,21648071,0,21648071
977,7736,Bishan Dass,HOSHIARPUR,IND,0,10th Pass,5539310,242610,5296700
978,4619,Bishat Kurre,RAIPUR,CPI(ML)L,0,8th Pass,6767000,0,6767000
979,4009,Bisheshwar Mahto,RANCHI,Samata Party,0,10th Pass,9999500,300000,9699500
980,4845,Bishnu Pada Barman,MALDAHA UTTAR,Amra Bangalee,0,Graduate,1005000,260000,745000
981,585,Bishnu Pada Ray,ANDAMAN & NICOBAR ISLANDS,BJP,1,Graduate,5658980,175115,5483865
982,3288,Bishnu Prasad Das,KENDRAPARA,BJP,0,Graduate,1837410,0,1837410
983,3223,Bishnupriya Naik,KEONJHAR,Odisha Jan Morcha,0,10th Pass,245000,0,245000
984,3708,"Bismaya Mahapatra,",BHUBANESWAR,AAP,0,Post Graduate,15156959,3824000,11332959
985,6544,Bismillakhan Abdulkhan Pathan,RAJKOT,IND,0,8th Pass,2700,0,2700
986,4838,Bisnu Pada Roy,MALDAHA DAKSHIN,BJP,1,Post Graduate,5419006,650967,4768039
987,1332,Biswajit Ranjit Chatterjee,NEW DELHI,AITC,0,12th Pass,33350000,0,33350000
988,3244,Biswajit Ray,BALASORE,IND,0,Graduate,71000,0,71000
989,4350,Biswapriya Roy Choudhury,BALURGHAT,BJP,5,Graduate Professional,4440487,0,4440487
990,4727,Bitiya Manjhi,DUMKA,CPI(ML)L,0,10th Pass,1214500,0,1214500
991,7758,Bittu,LUDHIANA,RPI(A),0,Literate,180864,0,180864
992,3320,Bochare Shankar Mahadji,NANDED,IND,0,10th Pass,7978374,761000,7217374
993,6232,Boda Raasi,MAHABUBABAD,BSP,0,12th Pass,1950000,400000,1550000
994,7892,Boddu Sainath Reddy,HYDERABAD,Yuvajana Sramika Rythu Congress Party,0,10th Pass,5031000,0,5031000
995,761,Bodhsingh Bhagat,BALAGHAT,BJP,0,Graduate,24959436,1393732,23565704
996,6379,Boilla Narender,BHONGIR,Republican Party of India,0,10th Pass,27700,0,27700
997,3847,Bojanna N Somaiah,MYSORE,IND,0,Graduate Professional,2835000,500000,2335000
998,6828,Bomma Balesham,MEDAK,IND,0,12th Pass,5381475,0,5381475
999,2538,Borkar Ravindra,NAGPUR,IND,0,10th Pass,300000,0,300000
1000,157,Brahmadav Anand Paswan,JAMUI,BSP,0,12th Pass,9493973,175000,9318973
1001,6165,Brahmadeo Prasad Karyee,DARBHANGA,Bajjikanchal Vikas Party,0,Doctorate,4328327,919512,3408815
1002,1552,Brahmanand Pratap Singh,SIDHI,IND,0,Graduate,0,0,0
1003,2569,Brahmananda Reddy,TUMKUR,IND,7,Graduate Professional,261074,126000,135074
1004,4597,Brahmbhatt Sanjaybhai Amarbhai,GANDHINAGAR,IND,0,12th Pass,822729,0,822729
1005,6188,Brahmdev Mukhiya,KHAGARIA,Rashtriya Naujawan Dal,2,Literate,4472000,0,4472000
1006,3925,Brajendra Gappu Chaturvedi,BHOPAL,IND,0,Post Graduate,890000,0,890000
1007,5808,Brajesh Pathak,UNNAO,BSP,1,Graduate Professional,14937219,0,14937219
1008,3034,Brajlal,AMROHA,Bahujan Mukti Party,0,Post Graduate,6502000,0,6502000
1009,4212,Brajmohan Malviya,UJJAIN,Prajatantrik Samadhan Party,0,Graduate Professional,882436,120000,762436
1010,5777,Brijlal,MOHANLALGANJ,Samtawadi Republican Party,0,8th Pass,9790200,0,9790200
1011,5546,Brijlal Khabhri,JALAUN,BSP,0,Post Graduate,29512616,0,29512616
1012,2977,Brindawan Singh Sikarwar,MORENA,BSP,1,12th Pass,18606750,0,18606750
1013,1537,Brmhadatta Mishra Urf Chote,REWA,IND,0,12th Pass,2283500,0,2283500
1014,5298,Bubadia Mahendrabhai Kesharbhai,BANASKANTHA,IND,1,Graduate,5652660,0,5652660
1015,7953,Budan Baig Shaik,KHAMMAM,TRS,1,Graduate,13210000,200000,13010000
1016,2865,Buday Munda,KHUNTI,Akhil Bhartiya Jharkhand Party,0,12th Pass,1669500,50000,1619500
1017,401,Budayya Pujeri,BANGALORE CENTRAL,Karunaadu Party,0,Graduate,1966100,0,1966100
1018,6076,Buddula Srinivasulu,NAGARKURNOOL,IND,0,10th Pass,460000,0,460000
1019,6602,Budhabhai Ranchhodbhai Patel,VALSAD,IND,0,10th Pass,9773500,0,9773500
1020,7261,Budhdhpriya Jasvant Somabhai,AHMEDABAD EAST,Prajatantra Aadhar Party,0,Literate,6565962,0,6565962
1021,2891,Budhram Laguri,SINGHBHUM,Bahujan Mukti Party,0,12th Pass,1639671,43898,1595773
1022,3165,Budhsen Verma,PILIBHIT,SP,0,8th Pass,36598361,4550000,32048361
1023,6459,Bupelli Narayana,PEDDAPALLE,IND,0,Doctorate,0,0,0
1024,6214,Burla Ravi,KARIMNAGAR,NCP,0,10th Pass,595000,300000,295000
1025,4531,Busireddy Shankar Reddy,KHAMMAM,IND,0,12th Pass,32525000,100000,32425000
1026,6099,Buta Singh,AMRITSAR,Bahujan Samaj Party (Ambedkar),0,Literate,80000,0,80000
1027,6522,Butani Rajeshbhai Maganbhai,PORBANDAR,IND,0,10th Pass,2799596,0,2799596
1028,6215,Byagari Laxman,KARIMNAGAR,BSP,0,Post Graduate,13180000,0,13180000
1029,328,C B Chandrababu,ALAPPUZHA,CPI(M),10,Graduate Professional,1466177,360075,1106102
1030,904,C G Saji Kumar,ANDAMAN & NICOBAR ISLANDS,IND,0,12th Pass,50000,0,50000
1031,2231,C J Jagannath,UDUPI CHIKMAGALUR,CPI(ML) Red star,0,5th Pass,111000,0,111000
1032,2555,C Mohan Kumar,MYSORE,BSP,0,10th Pass,5250000,0,5250000
1033,297,C N Jayadevan,THRISSUR,CPI,3,Post Graduate,20041642,294000,19747642
1034,3452,C R Choudhary,NAGAUR,BJP,0,Post Graduate,17921949,0,17921949
1035,1042,C. L. Ruala,MIZORAM,INC,0,Graduate,25733421,0,25733421
1036,6852,C.D. Meyyappan,CHENNAI CENTRAL,INC,0,Post Graduate,89988340,1100000,88888340
1037,1201,C.H. Vijayashankar,HASSAN,BJP,0,Graduate,42165344,5100000,37065344
1038,1897,C.K. Ramakrishnan,PALAKKAD,IND,0,Not Given,729614,380200,349414
1039,2952,C.L. Karodiya,GWALIOR,Jan-Nyay Dal,0,Graduate,806184,0,806184
1040,2632,C.Narayana Swamy,BANGALORE NORTH,INC,0,Post Graduate,247952597,922460,247030137
1041,1088,C.S.Puttaraju,MANDYA,JD(S),0,12th Pass,45209196,11231000,33978196
1042,7255,C.S.Valvi,NANDURBAR,IND,0,Graduate,10500,0,10500
1043,6088,Captain Amarinder Singh,AMRITSAR,INC,3,Graduate,863564071,4853456,858710615
1044,3060,Captain Phool Chandra Sharma,AONLA,Jawan Kisan Morcha,0,Graduate,1010000,0,1010000
1045,2948,Captan Babulal Goswami,GWALIOR,IND,0,Graduate,4300000,0,4300000
1046,4552,Ch. Murahari,SECUNDERABAD,SUCI(C),0,Post Graduate,2544964,0,2544964
1047,7843,Ch.Malla Reddy,MALKAJGIRI,TDP,0,12th Pass,488525332,6328146,482197186
1048,5396,Chaitram Suryavanshi,JANJGIR-CHAMPA,IND,0,Post Graduate,418000,0,418000
1049,2198,Chalawadi Ashok Sahadevappa,UTTARA KANNADA,IND,0,Graduate,1780000,1505000,275000
1050,2796,Champa Lal Patel,MAHASAMUND,IND,0,Graduate,1860000,0,1860000
1051,480,Chamra Linda,LOHARDAGA,AITC,2,Graduate,7010805,1550000,5460805
1052,6208,Chan Pasha,CHEVELLA,Akhil Bharatiya Muslim League (Secular),1,Illiterate,2100000,0,2100000
1053,6146,Chanan Singh Wattu,FIROZPUR,IND,0,Graduate,11339000,0,11339000
1054,7061,Chanbasha.M,KRISHNAGIRI,BSP,0,5th Pass,1106000,0,1106000
1055,2534,Chanda Manwatkar,NAGPUR,IND,0,12th Pass,0,0,0
1056,4094,Chandan Brahma,KOKRAJHAR,BPF,0,Graduate,61378388,26772159,34606229
1057,5138,Chandan Lal Meena,TONK-SAWAI MADHOPUR,IND,0,Graduate,5862017,1000000,4862017
1058,4419,Chandan Singh,MATHURA,SP,0,Graduate Professional,33511293,0,33511293
1059,6012,Chandana Majhi,BARDHAMAN PURBA,INC,0,Graduate,10055920,0,10055920
1060,4071,Chandoo Lal Sahu S/O Avadh Ram Sahu,MAHASAMUND,IND,0,8th Pass,4000,0,4000
1061,4647,Chandra Bhusan Kanwar,KORBA,Ambedkarite Party of India,0,Graduate Professional,21597,0,21597
1062,4454,Chandra Bhushan,ARARIA,AAP,0,Graduate Professional,14088067,5025161,9062906
1063,2763,Chandra Bhushan Prasad Chandravnsi,PATNA SAHIB,Bahujan Mukti Party,1,Literate,29711938,50200,29661738
1064,2759,Chandra Dev Prasad,PATALIPUTRA,Bahujan Mukti Party,0,Post Graduate,479600,0,479600
1065,5015,Chandra Pal,HARDOI,Bharatiya Republican Paksha,0,8th Pass,184037,0,184037
1066,4920,Chandra Pal,AGRA,Adarsh Samaj Party,0,Doctorate,111676624,7056864,104619760
1067,2436,Chandra Prakash,CHITTORGARH,BJP,0,Graduate,14134693,687284,13447409
1068,2425,Chandra Prakash Gocher,BHILWARA,Bharatiya Yuva Shakti,0,12th Pass,7612000,60000,7552000
1069,3987,Chandra Prakash Mandle,DURG,IND,3,Graduate Professional,23602100,2330000,21272100
1070,834,Chandra Sekhar Sahu,BERHAMPUR,INC,0,Graduate Professional,22114000,642430,21471570
1071,6193,Chandra Shekhar Yadav,MADHEPURA,Bahujan Mukti Party,2,Graduate,16557292,3400000,13157292
1072,2397,Chandra Singh,JHALAWAR-BARAN,BSP,0,8th Pass,225000,0,225000
1073,1957,Chandrababu,ALAPPUZHA,IND,0,10th Pass,0,0,0
1074,6658,Chandrabhan Singh,FATEHPUR,IND,0,Graduate,1696453,0,1696453
1075,767,Chandrabhan Singh Choudhary,CHHINDWARA,BJP,0,Graduate Professional,88884662,2258313,86626349
1076,2685,Chandrabhushan Sharma,JAHANABAD,AAP,0,Doctorate,7877980,0,7877980
1077,1231,Chandradev Thakur,CHATRA,Socialist Party (India),0,8th Pass,1683317,0,1683317
1078,817,Chandradhwaja Majhi,NABARANGPUR,IND,0,Graduate,2028926,0,2028926
1079,6956,"Chandragasan, N",CHIDAMBARAM,IND,0,8th Pass,525000,0,525000
1080,2139,Chandrakant,BIDAR,AAP,0,Post Graduate,5000070,417370,4582700
1081,5156,Chandrakant Bhaurao Khaire,AURANGABAD,SHS,8,12th Pass,90614560,20307244,70307316
1082,3663,Chandrakant Tatu Khandait,SATARA,Bharipa Bahujan Mahasangh,0,Graduate,223500,100000,123500
1083,6182,Chandramohan Jha,JHANJHARPUR,IND,3,Doctorate,138813648,51588,138762060
1084,6331,Chandramohan P,DINDIGUL,IND,0,10th Pass,3422000,0,3422000
1085,6969,"Chandran, D.",COIMBATORE,CPI(ML)L,0,Graduate,3388439,1651255,1737184
1086,2934,Chandrapal Singh Tomar,GUNA,IND,0,Post Graduate,6730000,200000,6530000
1087,5550,Chandrapal Singh Yadav,JHANSI,SP,9,Doctorate,69561317,0,69561317
1088,7365,Chandrasekaran.M,TIRUVALLUR,IND,0,Others,14147894,0,14147894
1089,2550,Chandrashekaraiah,MYSORE,JD(S),0,Post Graduate,28573891,0,28573891
1090,7348,Chandravijaysinh Takhubha Rana,JAMNAGAR,IND,0,12th Pass,12388172,522000,11866172
1091,4152,Chandrda Shekhar Dubey,DHANBAD,AITC,4,10th Pass,40055646,190000,39865646
1092,3440,Chandresh Kumari,JODHPUR,INC,0,12th Pass,307822286,4101175,303721111
1093,5230,Chandresh Singh,VIDISHA,IND,0,10th Pass,42613,0,42613
1094,4231,Chandu Lal Meena,DAUSA,BSP,3,10th Pass,1218571031,26015101,1192555930
1095,110,Chandu Lal Sahu (Chandu Bhaiya) S/O Late Puneen Ram,MAHASAMUND,BJP,0,Graduate Professional,20879652,2700000,18179652
1096,3909,Chandu Lal Sahu S/O Balchand Sahu,MAHASAMUND,IND,0,10th Pass,209000,0,209000
1097,4070,Chandu Lal Sahu S/O Biju Ram Sahu,MAHASAMUND,IND,0,5th Pass,6000,0,6000
1098,4067,Chandu Lal Sahu S/O Late Nathu Ram,MAHASAMUND,IND,0,5th Pass,254500,150000,104500
1099,4069,Chandu Lal Sahu S/O Parmanand Sahu,MAHASAMUND,IND,0,Literate,2574000,0,2574000
1100,4068,Chandu Lal Sahu S/O Same Lal Sahu,MAHASAMUND,IND,0,8th Pass,1114000,0,1114000
1101,4066,Chandu Lal Sahu S/O Soju Lal Sahu,MAHASAMUND,IND,0,8th Pass,1307000,0,1307000
1102,4074,Chandu Ram Sahu S/O Nakul Sahu,MAHASAMUND,IND,0,5th Pass,12000,0,12000
1103,4072,Chandu Ram Sahu S/O Pilau Ram Sahu,MAHASAMUND,IND,0,8th Pass,648000,0,648000
1104,7307,Chandubhai Machalabhai Chaudhari,BARDOLI,AAP,0,Graduate,5295872,440000,4855872
1105,4073,Chanduram Sahu S/O Ram Karosa Sahu,MAHASAMUND,IND,0,Literate,12000,0,12000
1106,4664,Charan Bhaya,KORBA,IND,0,Not Given,352000,0,352000
1107,4648,Charan Das Mahant,KORBA,INC,0,Doctorate,98328278,2500000,95828278
1108,1301,Charan Jeet Singh,WEST DELHI,AIFB,0,Post Graduate,709000,0,709000
1109,1056,Charanjeet Singh,SIRSA,INLD,0,10th Pass,8146887,3260000,4886887
1110,6882,Charavanan. M.P.,CHENNAI NORTH,IND,0,Graduate,3716798,0,3716798
1111,920,Chatap Wamanrao Sadashiv,CHANDRAPUR,AAP,3,Graduate Professional,29375000,1300000,28075000
1112,1626,Chater Singh Kashyap,MUZAFFARNAGAR,Vanchit Jamat Party,0,10th Pass,12559000,0,12559000
1113,198,Chattar Singh,KURUKSHETRA,BSP,0,Graduate Professional,72970569,3500000,69470569
1114,3018,Chaturbhuj Snehi,TIKAMGARH,IND,0,12th Pass,0,0,0
1115,3384,Chaudhari Kalu Vinayak,BARAMATI,BSP,0,8th Pass,65000,0,65000
1116,5801,Chaudhari Lal,SITAPUR,Bahujan Mukti Party,0,8th Pass,4127815,0,4127815
1117,5994,Chaudhari Mujjafar Jainuddin Alias Modi,RAIGAD,IND,0,5th Pass,1069000,515000,554000
1118,2092,Chaudhary Daya Chand,FARIDABAD,Bhartiya Shakti Chetna Party,0,Graduate,10745000,0,10745000
1119,4892,Chaudhary Dineshbhai Salubhai,MAHESANA,Vishva Hindustani Sangathan,0,Literate,4410200,695000,3715200
1120,4570,Chaudhry Haribhai Parthibhai,BANASKANTHA,BJP,0,Graduate,15773564,0,15773564
1121,4615,Chauhan Devusinh Jesingbhai,KHEDA,BJP,0,12th Pass,9426376,1047919,8378457
1122,5357,Chauhan Kesavbhai Malabhai,NAVSARI,BSP,0,12th Pass,225000,0,225000
1123,5362,Chauhan Prabhatsinh Pratapsinh,PANCHMAHAL,BJP,3,10th Pass,10464000,0,10464000
1124,5330,Chavada Ashokbhai Nathabhai,JAMNAGAR,IND,0,8th Pass,41000,0,41000
1125,6609,Chavada Harishchandrasinh Prabhatsinh,PANCHMAHAL,IND,1,10th Pass,45000,0,45000
1126,6610,Chavada Surendrasinh Narvatsinh,PANCHMAHAL,IND,0,Graduate,1702950,0,1702950
1127,5822,Chavan Harishchandra Deoram,DINDORI,BJP,1,Graduate,37240147,881137,36359010
1128,2598,Chavan Vinod Narayan,YAVATMAL-WASHIM,IND,0,10th Pass,3361500,570000,2791500
1129,5292,Chavda Manubhai Parsottambhaix,AMRELI,JD(U),2,12th Pass,36141803,9105641,27036162
1130,7651,Chavda Palabhai Nanjibhai,SURENDRANAGAR,IND,0,Illiterate,172498,0,172498
1131,4608,Chavda Vinod Lakhmashi,KACHCHH,BJP,0,Graduate Professional,5618643,411255,5207388
1132,5614,Chavhan Mohan Shamrao,RAVER,IND,0,Post Graduate,4213625,450000,3763625
1133,7208,Chawan Suryakant Gangaram,MUMBAI NORTH CENTRAL,IND,0,8th Pass,3482557,0,3482557
1134,943,Chaware Maya Namdeo,RAMTEK,SP,7,Post Graduate,13746000,1220000,12526000
1135,6413,Chaya Ratan Musinipally,SECUNDERABAD,AAP,0,Post Graduate,22724510,0,22724510
1136,7063,Chellakumar. Dr. A,KRISHNAGIRI,INC,1,Graduate Professional,52280762,29502704,22778058
1137,5673,Chellakumarasamy.T.S,NAMAKKAL,AAP,0,Post Graduate,43275164,2061000,41214164
1138,331,Chengara Surendran,MAVELIKKARA,CPI,1,Graduate,3363470,794051,2569419
1139,241,Cheni Ram Moran,DIBRUGARH,AIFB,0,10th Pass,824337,0,824337
1140,6216,Chennamaneni Vidya Sagar Rao,KARIMNAGAR,BJP,0,Graduate Professional,41209642,6369354,34840288
1141,6078,Cherupally Seetharamulu,BHONGIR,CPI(M),0,10th Pass,7692700,0,7692700
1142,321,Chetan Bhimraj Pendam,WARDHA,BSP,1,Post Graduate,13251784,0,13251784
1143,6817,Chetan Sharma,SRINAGAR,IND,0,Post Graduate,12798000,300000,12498000
1144,3207,Chetram,SHAHJAHANPUR,INC,0,Graduate Professional,13768803,0,13768803
1145,6743,Chetram Pasi,UNNAO,RPI(A),0,Literate,817500,0,817500
1146,3233,Chhabi Mahali,MAYURBHANJ,AAP,0,Others,75674,0,75674
1147,1153,Chhabilal Nial,KALAHANDI,Ambedkarite Party of India,0,Graduate Professional,580758,0,580758
1148,3426,Chhaganaram / Bhalaram,JALORE,Bahujan Mukti Party,0,8th Pass,118668,0,118668
1149,3425,Chhaganaram / Prhalad,JALORE,Hindustan Janta Party,0,Literate,1652000,4000,1648000
1150,2986,Chhavendra,MORENA,IND,0,Literate,785508,0,785508
1151,4161,Chhaya Kole,DUMKA,CPI,0,8th Pass,3061595,700000,2361595
1152,145,Chhedi Paswan,SASARAM,BJP,0,Post Graduate,35776803,275000,35501803
1153,6179,Chhedi Ram,JHANJHARPUR,IND,0,Literate,17707,0,17707
1154,7898,Chhotubhai Babubhai Patel,DADRA & NAGAR HAVELI,AAP,0,10th Pass,8847442,68500,8778942
1155,3459,Chhoturam,NAGAUR,IND,0,10th Pass,837000,275000,562000
1156,6401,Chiluveru Prathap,WARANGAL,IND,0,8th Pass,0,0,0
1157,913,Chinchole Gangaram Kaluji,BULDHANA,IND,0,12th Pass,21065000,117000,20948000
1158,7062,Chinna Pillappa.P,KRISHNAGIRI,DMK,0,Post Graduate,152477730,430835,152046895
1159,7122,"Chinna Rajendran, C.",PERAMBALUR,IND,0,12th Pass,2700000,0,2700000
1160,2570,Chinnappa.V,TUMKUR,CPI,0,Graduate,201696,21412,180284
1161,7040,"Chinnasamy, M.",KARUR,DMK,0,Graduate Professional,76747420,16329000,60418420
1162,7050,"Chinnasamy, M.",KARUR,IND,0,8th Pass,790800,100000,690800
1163,7051,"Chinnasamy, V.",KARUR,IND,0,8th Pass,1329000,0,1329000
1164,843,Chinnayyanaik,RAICHUR,IND,0,12th Pass,1658400,0,1658400
1165,7185,Chinnusamy N,SALEM,IND,0,5th Pass,451500,0,451500
1166,6670,Chintamani,JHANSI,Akhil Rashtrawadi Party,0,Graduate Professional,2736855,0,2736855
1167,4019,Chintamani Mahto,RANCHI,IND,1,12th Pass,7763850,26150,7737700
1168,4209,Chintamani Malviya,UJJAIN,BJP,0,Doctorate,18888754,5483153,13405601
1169,6404,Chintha Swamy,WARANGAL,AAP,0,Graduate,3730000,2000000,1730000
1170,158,Chirag Kumar Paswan,JAMUI,LJP,0,12th Pass,10414470,4458954,5955516
1171,6475,Chirulingadrulu Venkatesham,NIZAMABAD,IND,0,12th Pass,130000,0,130000
1172,3766,Chitra Prasad,CHIKKBALLAPUR,BSP,0,Post Graduate,4740600,1800000,2940600
1173,5264,Chitranjan Singh,KISHANGANJ,IND,0,10th Pass,630000,20000,610000
1174,2886,Chitrasen Sinku,SINGHBHUM,INC,0,12th Pass,8992000,1100000,7892000
1175,4371,Chitta Ranjan Kirttania,MALDAHA UTTAR,BSP,0,Graduate,17660906,840000,16820906
1176,2063,Chitter Singh Bali,BHIWANI-MAHENDRAGARH,IND,0,10th Pass,2196500,650000,1546500
1177,6325,Chitthan N.S.V,DINDIGUL,INC,0,Graduate,27649207,0,27649207
1178,710,Chittoor Rajamannar,IDUKKI,IND,0,Post Graduate,60222146,1365374,58856772
1179,1129,Chole Omprakash Bakaram,BHANDARA-GONDIYA,IND,0,Graduate Professional,1007000,800000,207000
1180,2274,Chomang Kro,AUTONOMOUS DISTRICT,IND,0,Graduate,4122196,0,4122196
1181,3657,Chopade Shriprasad Janardan,SANGLI,IND,0,12th Pass,334194,0,334194
1182,3973,Chote Lal Mahto,KISHANGANJ,IND,0,5th Pass,334500,0,334500
1183,7301,Choudhary Adambhai Nasirbhai,BANASKANTHA,SP,0,8th Pass,63893750,130649812,0
1184,6773,Choudhary Mahboob Ali Kaiser,KHAGARIA,LJP,1,Graduate,66569502,0,66569502
1185,5083,Choudhary Nashrudeen,ALWAR,Socialist Party (India),0,Literate,24094100,1450000,22644100
1186,3759,Chowdahalli Javaraiah,CHAMARAJANAGAR,CPI(ML)L,0,Graduate Professional,393000,0,393000
1187,302,Christy Fernandez,ERNAKULAM,IND,0,Doctorate,27176949,2620749,24556200
1188,4605,Chudasama Rajeshbhai Naranbhai,JUNAGADH,BJP,1,12th Pass,7446059,1110690,6335369
1189,195,Chungkhokai Doungel,OUTER MANIPUR,NCP,0,Graduate,6685000,0,6685000
1190,197,Chuni Manoj Kumar,KURUKSHETRA,IND,0,5th Pass,1593000,0,1593000
1191,1991,Churchill Alemao,SOUTH GOA,AITC,3,Others,149868252,72589679,77278573
1192,1854,Cleatus,WAYANAD,IND,2,8th Pass,6905000,0,6905000
1193,3026,Cliffton De Souza,SOUTH GOA,Bahujan Mukti Party,0,10th Pass,152500,0,152500
1194,3381,Col Suresh Patil (Rtd),PUNE,Bahujan Mukti Party,0,12th Pass,1034609,0,1034609
1195,2472,Col. Sona Ram,BARMER,BJP,1,Graduate Professional,174678454,5584331,169094123
1196,3627,Colonel Jayantrao Chitale,PUNE,IND,0,Graduate Professional,1014500,0,1014500
1197,6916,Colonel Kadar Basha,CHENNAI SOUTH,IND,0,Others,9991131,0,9991131
1198,6171,Colonel Lakshmeshwar Mishra,DARBHANGA,CPI(ML)L,0,Graduate Professional,15406445,2079445,13327000
1199,940,Com. Bandu Ramchandra Meshram,RAMTEK,CPI(ML) Red star,0,12th Pass,285146,0,285146
1200,912,Commander (Rtd) Ashok Raut,BULDHANA,IND,0,Graduate Professional,7250500,0,7250500
1201,4811,Comrade Lata Bhabor,RATLAM,CPI(M),3,8th Pass,78649422,0,78649422
1202,3327,Comrade Rajan Kshirsagar,PARBHANI,CPI,7,Graduate,4099277,700000,3399277
1203,199,Comrade Ram Kumar,SIRSA,CPI(M),0,12th Pass,877705,0,877705
1204,3344,Comred Bhise Ganpat Devrao,PARBHANI,IND,2,Graduate,757300,225000,532300
1205,1739,Cp Verma,SAHARANPUR,IND,3,Literate,4750000,0,4750000
1206,3816,D Eswar Thoremavu,MYSORE,IND,0,Graduate,500000,25000,475000
1207,844,D H Pujar,KOPPAL,CPI(ML) Red star,4,5th Pass,2219600,350000,1869600
1208,1283,D K Chopra,SOUTH DELHI,IND,1,Graduate,7080000,0,7080000
1209,3769,D N Narasimhamurthy,CHIKKBALLAPUR,IND,0,10th Pass,290000,130000,160000
1210,2176,D Prasad Sangappa,HAVERI,RPI(A),0,12th Pass,7850000,1080000,6770000
1211,3814,D S Nirvanappa,MYSORE,CPI(ML) Red Star,0,5th Pass,629000,5000,624000
1212,7502,D Sivamuthu Kumar,MADURAI,DMDK,2,Post Graduate,12866994,4084000,8782994
1213,6851,D. Babu,CHENNAI CENTRAL,IND,0,5th Pass,60000,0,60000
1214,6858,D. Ramesh,CHENNAI CENTRAL,IND,0,Post Graduate,495000,0,495000
1215,3510,D.B.Naik,HINGOLI,CPI(M),1,Graduate,4071000,470000,3601000
1216,2122,D.B.Nayak,RAICHUR,JD(S),1,Graduate,10591888,0,10591888
1217,7882,D.Bikshapathi,MALKAJGIRI,IND,0,12th Pass,3221000,0,3221000
1218,5619,D.D.Wani,RAVER,IND,1,10th Pass,771968,10000,761968
1219,5474,D.Elumalai,VILUPPURAM,IND,0,Graduate,40000,0,40000
1220,2861,D.G.Raja,JAMSHEDPUR,SP,0,Graduate,1899744,265504,1634240
1221,2633,D.Jayaram,BANGALORE NORTH,Gareeb Aadmi Party,0,12th Pass,40000,0,40000
1222,2369,D.K. Chhangani,JAIPUR,CPI,0,Graduate,2605791,0,2605791
1223,1090,D.K.Suresh,BANGALORE RURAL,INC,7,12th Pass,858713138,184854756,673858382
1224,2619,D.M.Ambareesha,KOLAR,BSP,0,Post Graduate,145000,0,145000
1225,1224,D.V. Sadananda Gowda,BANGALORE NORTH,BJP,0,Graduate Professional,98888874,37020152,61868722
1226,6667,Daalchandra,JALAUN,AAP,0,10th Pass,654500,0,654500
1227,7297,Dabhi Navajibhai Madhabhai,BANASKANTHA,IND,0,Graduate Professional,323000,0,323000
1228,2659,Dadan Yadav,BUXAR,BSP,22,10th Pass,26250000,103594500,0
1229,731,Dadhibal,SATNA,Apna Dal,0,Post Graduate,2933600,0,2933600
1230,4123,Daduram Manhar,JANJGIR-CHAMPA,AAP,0,Post Graduate,2517042,0,2517042
1231,7280,Dafada Ramjibhai Nanjibhai,AMRELI,BSP,0,5th Pass,486000,0,486000
1232,3573,Dagadu Manik Pawar,MADHA,IND,0,5th Pass,1521697,0,1521697
1233,915,Daharwal Ganeshdeo Raghuji,BHANDARA-GONDIYA,GGP,0,5th Pass,7113000,0,7113000
1234,1154,Daitary Pradhan,KALAHANDI,Aama Odisha Party,2,Post Graduate,47792839,367818,47425021
1235,447,Dalbir Singh Chahal,SONIPAT,Rashtravadi Janata Party,0,5th Pass,16475000,90000,16385000
1236,1336,Dalchand,NEW DELHI,IND,0,8th Pass,2970854,300000,2670854
1237,1773,Dalendra Nath Ray,COOCHBEHAR,Amra Bangalee,0,10th Pass,2358865,0,2358865
1238,6091,Daljit Singh,AMRITSAR,AAP,0,Post Graduate,175331173,0,175331173
1239,6112,Daljit Singh,ANANDPUR SAHIB,IND,0,Post Graduate,11507000,800000,10707000
1240,745,Dalpat Singh Paraste,SHAHDOL,BJP,0,Graduate Professional,5524870,0,5524870
1241,5022,Dalveer Singh,HATHRAS,IND,0,5th Pass,68575,0,68575
1242,3401,Damale Shivajirao Waman,AHMEDNAGAR,Bhartiya Navjawan Sena (Paksha),0,Graduate Professional,1721000,905302,815698
1243,4002,Daman Chandra Bhakat,JAMSHEDPUR,BSP,0,10th Pass,38695000,40000,38655000
1244,3628,Dambale Rahul Dharma,PUNE,IND,13,12th Pass,20000,0,20000
1245,3688,Dambale Ram Dharma,SHIRUR,IND,0,10th Pass,1383000,105000,1278000
1246,4167,Damodar Singh,GODDA,AITC,0,12th Pass,3802143,100000,3702143
1247,994,Dan Bahadur Yadav,NORTH EAST DELHI,IND,0,Graduate,1345000,0,1345000
1248,1475,Dandekar Baburao Laxman,GADCHIROLI-CHIMUR,IND,0,12th Pass,580000,0,580000
1249,5157,Dandge Nanasaheb Damodhar,AURANGABAD,IND,0,Graduate,1335000,0,1335000
1250,5344,Danicha Govindbhai Punamchand,KACHCHH,AAP,0,Graduate Professional,3777000,0,3777000
1251,2918,Daniel John,BHOPAL,IND,0,12th Pass,8081017,0,8081017
1252,5855,Danve Raosaheb Dadarao,JALNA,BJP,4,Graduate,184411862,8534130,175877732
1253,4275,Danvir,ETAH,IND,0,10th Pass,1423000,0,1423000
1254,7715,Darshan Nahar,JALANDHAR,IND,0,8th Pass,1568000,85000,1483000
1255,7785,Darshan Singh,FARIDKOT,Shiromani Akali Dal (Amritsar)(Simranjit Sing,0,5th Pass,412000,0,412000
1256,7756,Darshan Singh,LUDHIANA,SHS,0,12th Pass,5022000,170000,4852000
1257,649,Daryl William Ch Momin,TURA,INC,0,Post Graduate,1250390,204472,1045918
1258,6619,Das Girishbhai Manubhai,ANAND,Bahujan Mukti Party,1,Graduate Professional,3041264,3651,3037613
1259,696,Das K Varkala,ATTINGAL,IND,2,10th Pass,13633,39000,0
1260,4540,Dasari Bharath Reddy,MALKAJGIRI,IND,0,Graduate Professional,21000,0,21000
1261,3231,Dashmat Soren,MAYURBHANJ,BSP,0,10th Pass,855000,0,855000
1262,2885,Dashrath Gagrai,SINGHBHUM,JVM(P),3,Graduate,3940724,100000,3840724
1263,5080,Dashrath Kumar,ALWAR,Ambedkarite Party of India,0,Doctorate,1905000,200000,1705000
1264,5284,Dashrath Misrilal Devda,AHMEDABAD EAST,IND,0,5th Pass,227060,56700,170360
1265,1775,Dasrath Tirkey,ALIPURDUARS,AITC,0,Graduate,3550353,293909,3256444
1266,6258,"Dass, D.",ARAKKONAM,BSP,0,10th Pass,50000,0,50000
1267,7944,Datla Nageshwar Rao,MAHABUBABAD,IND,0,Graduate,1650000,400000,1250000
1268,1984,Dattaram Desai,NORTH GOA,AAP,0,Post Graduate,9795686,335819,9459867
1269,3699,Dattatraya Vitthal Thorat,SOLAPUR,IND,0,8th Pass,227000,0,227000
1270,5505,Daud Ahmad,DHAURAHRA,BSP,1,Literate,156626608,19408646,137217962
1271,5369,Dausingh Maravi,BILASPUR,IND,0,Graduate,435500,40000,395500
1272,6178,Davendra Prasad Yadav,JHANJHARPUR,JD(U),0,Graduate,7941707,600000,7341707
1273,404,David Horo,LAKHIMPUR,IND,0,10th Pass,94000,0,94000
1274,1037,Davinder Kumar,KURUKSHETRA,IND,2,12th Pass,2275000,250000,2025000
1275,6109,Davinder Kumar Verma,ANANDPUR SAHIB,IND,0,8th Pass,60000,0,60000
1276,7734,Davinder Singh,HOSHIARPUR,IND,0,10th Pass,1329540,0,1329540
1277,1051,Davinder Singh,KARNAL,Rashtriya Karmyog Party,0,12th Pass,240000,0,240000
1278,5370,Daya Das Lahre,BILASPUR,IND,0,8th Pass,2097599,49000,2048599
1279,4967,Daya Shanker,FARRUKHABAD,Adarsh Rashtriya Vikas Party,0,8th Pass,506000,0,506000
1280,2869,Dayamani Barla,KHUNTI,AAP,5,Post Graduate,175500,0,175500
1281,1981,Dayanand G. Narvekar,NORTH GOA,IND,2,Graduate Professional,184306689,62952534,121354155
1282,1827,Dayanand Guruputrayya Chikkamath,BELGAUM,SP,0,Graduate,7050000,2000000,5050000
1283,6853,Dayanidhi Maran,CHENNAI CENTRAL,DMK,0,Graduate,109429193,0,109429193
1284,4444,Deba Kumar Barman,MANGALDOI,AITC,0,Others,15202790,948237,14254553
1285,3232,Debashis Marndi,MAYURBHANJ,JMM,0,Doctorate,3993858,627225,3366633
1286,6015,Debasree Chaudhuri,BARDHAMAN-DURGAPUR,BJP,0,Post Graduate,4636550,0,4636550
1287,3257,Debendra Kumar Mallik,JAJPUR,BSP,0,Graduate Professional,10000,0,10000
1288,4381,Deepa Dasmunsi,RAIGANJ,INC,1,Post Graduate,19163081,0,19163081
1289,7234,Deepak Digambar Shinde,MUMBAI NORTH EAST,IND,0,Post Graduate,2394016,0,2394016
1290,18,Deepak Gaur,FARIDABAD,Aarakshan Virodhi Party,0,12th Pass,1183000,325000,858000
1291,467,Deepak Karma,BASTAR,INC,0,Graduate,3601587,0,3601587
1292,1356,Deepak Kumar,EAST DELHI,IND,0,12th Pass,236200,0,236200
1293,1304,Deepak Kumar,WEST DELHI,Rashtriya Janadhikar Party,0,8th Pass,21000,0,21000
1294,4106,Deepak Kumar,BANKA,SUCI(C),0,12th Pass,2633089,0,2633089
1295,7728,Deepak Kumar,HOSHIARPUR,Bahujan Mukti Party,0,10th Pass,5316000,0,5316000
1296,2958,Deepak Kumar Bansal Rangwale (Prerak),GWALIOR,IND,0,Graduate,4059104,264727,3794377
1297,6443,Deepak Kumar.B,SECUNDERABAD,Republican Party of India (Khobragade),0,Graduate,201781,0,201781
1298,5397,Deepak Narang,JANJGIR-CHAMPA,IND,0,10th Pass,1231800,0,1231800
1299,3375,Deepak Natharam Paigude,PUNE,MNS,1,12th Pass,114428519,50291943,64136576
1300,2609,Deepak Rajesh Coelho,DAKSHINA KANNADA,IND,0,Graduate,3328000,0,3328000
1301,587,Deepak Shukla,CHANDIGARH,IND,0,Graduate,1874000,338837,1535163
1302,6888,Deepak. C,CHENNAI NORTH,IND,0,Graduate,6832000,7000000,0
1303,1398,Deepaksingh Trymbakrao Deshmukh,WARDHA,IND,0,10th Pass,6900000,0,6900000
1304,3402,Deepali Sayyad,AHMEDNAGAR,AAP,1,Graduate,30052370,3767489,26284881
1305,1268,Deepender Singh,ROHTAK,INC,0,Post Graduate,358749354,39310300,319439054
1306,7846,Deepinder Singh Dhillon,PATIALA,SAD,0,Graduate Professional,167763561,1074803,166688758
1307,4903,Degda Pravinbhai Meghajibhai,RAJKOT,RPI (A),6,Illiterate,2125000,50000,2075000
1308,7144,Deivasigamani.K,POLLACHI,IND,0,10th Pass,9050000,0,9050000
1309,7900,Delkar Mohanbhai Sanjibhai,DADRA & NAGAR HAVELI,INC,0,Graduate,414613478,12162079,402451399
1310,774,Denis Siangshai,SHILLONG,IND,0,Graduate,1287025457,0,1287025457
1311,1931,Densil Mendez,ERNAKULAM,JD(U),0,10th Pass,2634109,169614,2464495
1312,4424,Deol Hema Malini Dharmendra,MATHURA,BJP,0,Doctorate,1782015620,231234174,1550781446
1313,5914,Deora Milind Murli,MUMBAI SOUTH,INC,0,Graduate,408001069,59250670,348750399
1314,736,Deoraj Singh Patel,REWA,BSP,0,Post Graduate,70149663,17924260,52225403
1315,692,Deorao Monba Nannaware,GADCHIROLI-CHIMUR,Ambedkarite Party of India,0,Graduate Professional,4463077,922967,3540110
1316,5198,Deore Mahendra Trambak,DHULE,IND,0,Graduate,1940029,0,1940029
1317,921,Deotale Sanjay Wamanrao,CHANDRAPUR,INC,0,Graduate Professional,45464118,3496308,41967810
1318,6507,Desai Ishwarbhai Mahadevbhai,PATAN,IND,0,Literate,1027300,240000,787300
1319,7338,Desai Khodabhai Laljibhai,GANDHINAGAR,IND,1,5th Pass,50258019,0,50258019
1320,5316,Desai Naishadhbhai Bhupatbhai,SURAT,INC,0,Graduate Professional,66444237,3940761,62503476
1321,5925,Desai Rajendra Daulat,MUMBAI SOUTH,IND,0,8th Pass,113800,0,113800
1322,3522,Deshmukh Balasaheb Desai,HINGOLI,IND,0,Not Given,680000,50000,630000
1323,5845,Deshmukh Iqbal A. Rehman,JALGAON,IND,0,5th Pass,130500,0,130500
1324,549,Deshmukh Jaideep Rajendra,WARDHA,IND,1,Post Graduate,2227258,0,2227258
1325,3488,Deshmukh Vikas Nanasaheb,AHMEDNAGAR,IND,0,12th Pass,3796964,510000,3286964
1326,2200,Deshpande Prashanth,UTTARA KANNADA,INC,0,Post Graduate,999522016,64619045,934902971
1327,599,Dev Kumar Choudhary,GAYA,IND,0,Graduate Professional,5087170,800000,4287170
1328,2747,Dev Kumar Verma,PATALIPUTRA,RPI(A),0,12th Pass,4333000,0,4333000
1329,3908,Dev Prasad Kelkar,MAHASAMUND,IND,0,10th Pass,6915060,250000,6665060
1330,7584,Devadasa Sundaram,TIRUNELVELI,DMK,0,Graduate,186962206,0,186962206
1331,6359,Devadass. R,KALLAKURICHI,INC,1,Graduate Professional,76577515,6568797,70008718
1332,7599,Devadoss.A.R,TIRUNELVELI,IND,0,10th Pass,51880493,1329992,50550501
1333,7100,Devaki. G,NAGAPATTINAM,IND,0,Post Graduate,45000,0,45000
1334,2306,Devanand,ALIGARH,Lok Dal,0,Graduate,305016,0,305016
1335,6890,Devaraj. G,CHENNAI NORTH,IND,0,Graduate Professional,577000,0,577000
1336,889,Devchand Dhruw,BASTAR,CPI(ML) Red star,0,8th Pass,371000,52235,318765
1337,1107,Devender,KARNAL,RPI(A),0,12th Pass,625000,201000,424000
1338,2920,Devendra Chaourasia,DAMOH,BSP,1,Graduate,8658000,340000,8318000
1339,2978,Devendra Kumar Agrval,MORENA,AAP,0,Graduate Professional,6240542,490100,5750442
1340,5722,Devendra Kumar Sharma,KANPUR,Akhil Bharatiya Ashok Sena,2,Post Graduate,2175602,0,2175602
1341,1604,Devendra Kumar Urf Gudda Bhaiyya,HOSHANGABAD,IND,0,10th Pass,95509,0,95509
1342,4264,Devendra Singh Urf Bhole Singh,AKBARPUR,BJP,0,10th Pass,28546617,559965,27986652
1343,3227,Devi Prasanna Besra,MAYURBHANJ,IND,0,Graduate,5178227,0,5178227
1344,1329,Devi Singh,NEW DELHI,Rashtriya Jankranti Party,0,Post Graduate,285000,0,285000
1345,500,Devinder Kumar Sehrawat,SOUTH DELHI,AAP,0,Post Graduate,23237892,540000,22697892
1346,3521,Devji Gangaram Asole,HINGOLI,IND,0,Graduate Professional,195500,0,195500
1347,3424,Devji Patel,JALORE,BJP,0,10th Pass,51846777,12780726,39066051
1348,3574,Devkate Somanath Alias Someshwar Chandrakant,MADHA,IND,1,5th Pass,148500,0,148500
1349,3468,Devkishan Dehiya,PALI,Megh Desham Party,0,10th Pass,443500,0,443500
1350,3630,Devkule Bibhishan Jagannath,PUNE,IND,0,10th Pass,1195000,0,1195000
1351,5280,Devnarayan Yadav,SUPAUL,Bahujan Mukti Party,0,Post Graduate,9500500,250000,9250500
1352,5345,Devusinh Motisinh Chauhan,KHEDA,IND,0,10th Pass,410000,0,410000
1353,3523,Dhabe Uttam Maroti,HINGOLI,IND,0,Literate,1241000,0,1241000
1354,3595,Dhale Padmasheel Ramchandra,OSMANABAD,BSP,3,Post Graduate,3372138,330000,3042138
1355,23,Dhan Raj Chauhan,CHANDNI CHOWK,Naya Daur Party,0,8th Pass,370000,0,370000
1356,831,Dhanada Kanta Mishra,BERHAMPUR,AAP,0,Doctorate,10787163,5662400,5124763
1357,4356,Dhananjay Banerjee,JANGIPUR,Amra Bangalee,0,Post Graduate,929000,0,929000
1358,3532,Dhananjay Bhimrao Mahadik,KOLHAPUR,NCP,1,Graduate,448882000,71333000,377549000
1359,389,Dhananjay Kishore,GAYA,AAP,0,Graduate Professional,6509560,6102,6503458
1360,4644,Dhananjay Rathiya,RAIGARH,IND,0,10th Pass,121000,0,121000
1361,1130,Dhananjay Shamlalji Rajabhoj,BHANDARA-GONDIYA,IND,0,Post Graduate,3070000,0,3070000
1362,3733,Dhananjaya. H.H,BANGALORE CENTRAL,IND,1,12th Pass,809580000,460000,809120000
1363,295,Dhanapalan,THRISSUR,INC,1,Graduate,12435866,2269212,10166654
1364,7589,Dhanaraj.R.,TIRUNELVELI,Indian Christian Secular Party,0,Graduate,7160090,37000,7123090
1365,5575,Dhanarasu @ Mathimaharaja,PONDICHERRY,IND,0,8th Pass,7300000,1640000,5660000
1366,6334,Dhandabani.K,DINDIGUL,IND,0,10th Pass,1191095,425000,766095
1367,7411,"Dhandapani, M.",VELLORE,IND,0,Graduate,147168,0,147168
1368,5371,Dhani Ram Khare,BILASPUR,Republican Paksha (Khoripa),0,5th Pass,13485,0,13485
1369,5372,Dhani Ram Yadav,BILASPUR,SP,0,8th Pass,0,0,0
1370,1598,Dhaniram Yaduwanshi,CHHINDWARA,IND,0,12th Pass,504199,148810,355389
1371,7347,Dhanjibhai Laljibhai Ranevadia,JAMNAGAR,IND,0,Literate,895000,0,895000
1372,5113,Dhanraj Bairwa,KARAULI-DHOLPUR,Socialist Party (India),0,5th Pass,300000,0,300000
1373,3441,Dhanraj Gehlot,JODHPUR,Jai Maha Bharath Party,0,Graduate,3506231,300000,3206231
1374,4649,Dhansingh Dhurve,KORBA,BSP,0,Post Graduate,542768,55693,487075
1375,4116,Dharam Bhargav,BILASPUR,BSP,0,12th Pass,1919014,506437,1412577
1376,7860,Dharam Pal,PATIALA,IND,0,5th Pass,302000,0,302000
1377,2780,Dharam Pal Balgotra,UDHAMPUR,BSP,0,Others,16995852,1158038,15837814
1378,7775,Dharam Singh,FATEHGARH SAHIB,Shiromani Akali Dal (Amritsar)(Simranjit Sing,0,10th Pass,528006,10000,518006
1379,7836,Dharam Singh,SANGRUR,IND,0,8th Pass,9278598,50000,9228598
1380,865,Dharambir,BHIWANI-MAHENDRAGARH,BJP,0,Graduate,50057200,4530000,45527200
1381,2064,Dharambir S/O Banwari,BHIWANI-MAHENDRAGARH,IND,0,Illiterate,2715000,0,2715000
1382,2066,Dharambir Singh,BHIWANI-MAHENDRAGARH,IND,0,Post Graduate,1424342,0,1424342
1383,4187,Dharamdas Ahirwar,INDORE,BSP,0,12th Pass,4086330,0,4086330
1384,458,Dharampal,GURGAON,BSP,0,12th Pass,16990111,0,16990111
1385,1030,Dharampal Dhiman,KURUKSHETRA,IND,0,10th Pass,765000,0,765000
1386,462,Dharampal Yadav,GURGAON,INC,0,Graduate,76792493,0,76792493
1387,1315,Dharamraj,NORTH WEST DELHI,Bhartiya Pragatisheel Congress,0,8th Pass,3486700,0,3486700
1388,997,Dharamveer Singh,NORTH EAST DELHI,Rashtriya Ekta Party,1,10th Pass,6497000,0,6497000
1389,3290,Dharanidhar Nayak,KENDRAPARA,INC,0,Post Graduate,35040745,11869710,23171035
1390,7343,Dharaviya Vallabhbhai,JAMNAGAR,IND,0,5th Pass,2463263,0,2463263
1391,2065,Dharm Bir S/O Hari Singh,BHIWANI-MAHENDRAGARH,IND,0,10th Pass,51000,48000,3000
1392,5688,Dharmalingam.M,NAMAKKAL,IND,0,8th Pass,420000,0,420000
1393,3066,Dharmandra Yadav,BADAUN,SP,0,Post Graduate,24987715,8950291,16037424
1394,1704,Dharmender,GAUTAM BUDHHA NAGAR,Dharam Nirpeksh Dal,0,8th Pass,55813000,0,55813000
1395,588,Dharmender Singh,CHANDIGARH,Hindustan Ekta Party,0,Graduate,1623000,70000,1553000
1396,3051,Dharmendra Kumar,AONLA,BJP,0,10th Pass,5364652,0,5364652
1397,1449,Dharmendra Wasudeorao Mandlik,NAGPUR,Hindustan Janta Party,0,Post Graduate,23900,0,23900
1398,5099,Dharmi Ghunawat,DAUSA,Indian Peoples Green Party,0,12th Pass,663000,0,663000
1399,7716,Dharminder,JALANDHAR,IND,1,Illiterate,1294000,200000,1094000
1400,6825,Dharmjeet Singh Markam,SURGUJA,BSP,0,10th Pass,4633187,25000,4608187
1401,3848,Dhas Suresh Ramchandra,BEED,NCP,2,Graduate,74408903,10490592,63918311
1402,3861,Dhatture Hafizbhai Husain,SANGLI,IND,0,8th Pass,7288408,2035500,5252908
1403,243,Dhebor Gohain Boruah,LAKHIMPUR,AITC,0,Graduate Professional,7878597,0,7878597
1404,1327,Dheeraj Puri,NEW DELHI,SHS,0,10th Pass,27148834,0,27148834
1405,7590,Dhevanathan Yadav.T.,TIRUNELVELI,Tamil Nadu Makkal Congress,1,Illiterate,323363744,30874899,292488845
1406,7793,Dhian Singh Mand,FIROZPUR,Shiromani Akali Dal (Amritsar),0,8th Pass,922000,300000,622000
1407,1426,Dhimati Vidya Kishor Bhimte,RAMTEK,Ambedkarite Party of India,0,Post Graduate,3902394,69000,3833394
1408,7282,Dhimecha Nareshbhai Nanjibhai,AMRELI,IND,1,5th Pass,100000,0,100000
1409,2362,Dhiraj Gurjar,JAIPUR RURAL,SP,0,Post Graduate,413290807,500000,412790807
1410,2535,Dhiraj Jaidev Gajbhiye,NAGPUR,IND,0,12th Pass,0,0,0
1411,4912,Dhirajlal Bhurabhai Aghera,PORBANDAR,IND,0,10th Pass,3450000,0,3450000
1412,2726,Dhirendra Kumar,NALANDA,Janvadi Party(Socialist),0,10th Pass,250000,0,250000
1413,1784,Dhirendra Nath Roy,JALPAIGURI,Amra Bangalee,0,Graduate,1360000,0,1360000
1414,950,Dhote Jambuwantrao Bapurao,YAVATMAL-WASHIM,AIFB,0,10th Pass,6545000,0,6545000
1415,543,Dhotre Sanjay Shyamrao,AKOLA,BJP,3,Graduate Professional,48501735,6928458,41573277
1416,1782,Dhritiman Roy,JALPAIGURI,Rashtriya Janadhikar Suraksha Party,0,8th Pass,182500,0,182500
1417,6235,Dhruv Narayan Karn,MADHUBANI,CPI(ML)L,7,10th Pass,2262312,21250,2241062
1418,1064,Dhulappa Gundappa,GULBARGA,JD(S),0,Graduate Professional,7335800,0,7335800
1419,7470,Dhurai Raaj Subha,SIVAGANGA,DMK,0,Others,119200359,16880062,102320297
1420,3502,Digambar Alias Gabbar Sudam Sakat,HATKANANGLE,Bharipa Bahujan Mahasangh,0,5th Pass,547074,0,547074
1421,1564,Digvijay Singh,JABALPUR,Bhartiya Shakti Chetna Party,0,Post Graduate,67620000,0,67620000
1422,982,Dildar Hussain Beg,CHANDNI CHOWK,IND,0,12th Pass,946408,0,946408
1423,2829,Dileep Kumar Rajak,GIRIDIH,IND,0,Graduate,439561,46500,393061
1424,4805,Dileep Singh Bhuriya,RATLAM,BJP,0,10th Pass,12259882,0,12259882
1425,3976,Dileshwar Kamait,SUPAUL,JD(U),0,Post Graduate,17930142,0,17930142
1426,5984,Dilip Atmaram Dumada,PALGHAR,Bahujan Mukti Party,0,10th Pass,2024600,0,2024600
1427,5942,Dilip Bhausaheb Gaikwad,MUMBAI SOUTH CENTRAL,IND,0,Illiterate,6100,100,6000
1428,6805,Dilip Kumar Hait,ULUBERIA,IND,0,Post Graduate,5000,0,5000
1429,3984,Dilip Kumar Koshle,BILASPUR,IND,0,12th Pass,2764540,1150000,1614540
1430,1455,Dilip Narayan,NAGPUR,IND,0,Others,607658,0,607658
1431,625,Dilip Paswan,JAMUI,IND,0,10th Pass,1531232,0,1531232
1432,5890,Dilip Prabhakar Aloni,KALYAN,IND,1,Post Graduate,7600000,198000,7402000
1433,3298,Dilip Sarkar,JALPAIGURI,Bahujan Mukti Party,0,Graduate,1011000,0,1011000
1434,7903,Dilipbhai N. Bhurkud,DADRA & NAGAR HAVELI,IND,0,12th Pass,16936974,0,16936974
1435,801,Dillip Kumar Tirkey,SUNDARGARH,BJD,0,Graduate,70158593,831924,69326669
1436,7913,Dilshad Ahmad,JHANSI,IND,0,Post Graduate,1052000,0,1052000
1437,4411,Dimple Yadav,KANNAUJ,SP,0,Graduate,280516418,6917710,273598708
1438,4245,Dinesh,TONK-SAWAI MADHOPUR,AITC,0,10th Pass,1632000,0,1632000
1439,5286,Dinesh Babulal Vaghela,AHMEDABAD EAST,AAP,0,Graduate,24387875,4705653,19682222
1440,5493,Dinesh Chandra,BARABANKI,AAP,1,Post Graduate,428300,10516,417784
1441,111,Dinesh Kashyap,BASTAR,BJP,1,Post Graduate,16108199,2191216,13916983
1442,556,Dinesh Kumar,KARAKAT,Bahujan Mukti Party,1,Doctorate,478500,0,478500
1443,1298,Dinesh Kumar,WEST DELHI,Akhand Bharat Samaj Party,0,10th Pass,7386000,252000,7134000
1444,3111,Dinesh Kumar,KHERI,Bahujan Mukti Party,0,10th Pass,180872,0,180872
1445,4253,Dinesh Kumar Gautam,AGRA,IND,2,12th Pass,526770,0,526770
1446,6801,Dinesh Kumar Sharma,HOWRAH,IND,0,Graduate Professional,10000,0,10000
1447,5373,Dinesh Kumar Singh Khusro Nikhil,BILASPUR,IND,0,10th Pass,72000,0,72000
1448,2854,Dinesh Mahato,JAMSHEDPUR,IND,0,12th Pass,5169920,0,5169920
1449,3474,Dinesh Mev,PALI,IND,0,5th Pass,1387500,0,1387500
1450,27,Dinesh Pal Singh,NORTH EAST DELHI,IND,0,8th Pass,6931000,0,6931000
1451,3629,Dinesh Pandurang Pawar,PUNE,IND,0,10th Pass,113500,0,113500
1452,7207,Dinesh Phulsing Rathod,MUMBAI NORTH CENTRAL,IND,0,10th Pass,2133000,0,2133000
1453,5130,Dinesh Saini,TONK-SAWAI MADHOPUR,Jai Maha Bharath Party,0,12th Pass,1581000,0,1581000
1454,7189,Dinesh Shah,MUMBAI NORTH,Sardar Vallabhbhai Patel Party,0,Graduate,31634182,0,31634182
1455,6186,Dineshchandra Yadav,KHAGARIA,JD(U),0,Others,17668299,0,17668299
1456,7452,Dineshkumar.G,TIRUCHIRAPPALLI,IND,0,Post Graduate,6379498,1773000,4606498
1457,4611,Dinsha Jhavarbhai Patel,KHEDA,INC,0,10th Pass,52207873,3061779,49146094
1458,4451,Dipak Kumar Borah,NOWGONG,AITC,0,Post Graduate,627023,0,627023
1459,311,Dipak Kumar Roy,COOCHBEHAR,AIFB,1,Post Graduate,2859128,195000,2664128
1460,4364,Dipak Singh,MALDAHA DAKSHIN,Rashtriya Janadhikar Suraksha Party,0,Graduate,1408500,0,1408500
1461,3549,Dipratna Prabhakarrao Nilangekar,LATUR,AAP,0,Post Graduate,2025000,26672,1998328
1462,4541,Divakar Dharanikota Sudhakar,MALKAJGIRI,All India Majlis-E-Ittehadul Muslimeen,0,Post Graduate,1106850,0,1106850
1463,2922,Divan Upendr Pratap Singh (Raja Sab),DAMOH,Bhartiya Shakti Chetna Party,0,12th Pass,8328072,312910,8015162
1464,2565,Divya Spandana Uruf Ramya,MANDYA,INC,0,12th Pass,28043931,5530653,22513278
1465,1008,Diwakar,KAIRANA,AITC,0,12th Pass,155543,0,155543
1466,4675,Diwakar Bairagi,DURG,IND,1,Post Graduate,3340000,34000,3306000
1467,1474,Diwakar Pendam,GADCHIROLI-CHIMUR,Bahujan Mukti Party,0,8th Pass,3850000,0,3850000
1468,5603,Dnyaneshwar Vitthal Amale,RAVER,AIFB,1,Graduate,1115000,783000,332000
1469,6228,Dodda Ram Babu,KHAMMAM,BSP,0,Literate,2700000,750000,1950000
1470,2158,Doddamani Prasad,BELLARY,CPI(ML)L,1,Graduate Professional,16043,0,16043
1471,3852,Dongare Milind Kashinath,BEED,Prabuddha Republican Party,1,Graduate Professional,30393000,300000,30093000
1472,1435,Dongre Ashok Namaji,RAMTEK,IND,0,5th Pass,980000,0,980000
1473,546,Dongre Priya Anil,AMRAVATI,IND,0,8th Pass,702059,0,702059
1474,6971,"Doraisamy, A.",COIMBATORE,Makkal Manadu Katchi,0,8th Pass,5000,0,5000
1475,7367,Doss. R,TIRUVALLUR,IND,0,8th Pass,145000,0,145000
1476,4538,Dr A Chandra Sekhar,MAHBUBNAGAR,IND,0,Post Graduate,7600000,500000,7100000
1477,827,Dr Bansidhar Tripathy,ASKA,AITC,0,Doctorate,1991383,0,1991383
1478,5195,Dr Bhupesh Prakash Patil,DHULE,IND,0,Graduate Professional,450000,60000,390000
1479,4486,Dr Dilip Kumar Jaiswal,KISHANGANJ,BJP,0,Doctorate,32949581,5793000,27156581
1480,2980,Dr Govind Singh,MORENA,INC,1,Graduate Professional,69688035,3184026,66504009
1481,3453,Dr Jyoti Mirdha,NAGAUR,INC,0,Graduate Professional,582676804,230942000,351734804
1482,3350,Dr Kulamani Nayak,BHUBANESWAR,"Proutist Bloc, India",0,Doctorate,2024713,0,2024713
1483,7264,Dr Parmar Jivanbhai Gabhabhai,AHMEDABAD WEST,Bahujan Mukti Party,0,Not Given,18219448,2207833,16011615
1484,6392,Dr Punukuri Sadhu Satyanadhan,CHEVELLA,Indian Christian Secular Party,1,Graduate Professional,13623818,700000,12923818
1485,6810,Dr Raja Muzaffar Bhat,SRINAGAR,AAP,1,Graduate,2110000,0,2110000
1486,841,Dr Rajesh Alias Ravi Vallyapur,BIJAPUR,IND,0,Graduate Professional,12208000,0,12208000
1487,2329,Dr Rajkumar Sharma,JHUNJHUNU,IND,4,Doctorate,4537299,0,4537299
1488,5745,Dr Rita Joshi,LUCKNOW,INC,1,Doctorate,19231172,0,19231172
1489,3119,Dr S T Hasan,MORADABAD,SP,0,Post Graduate,31217401,175000,31042401
1490,3188,Dr Safiq Ur Rahman Barq,SAMBHAL,SP,0,Graduate,12883691,0,12883691
1491,121,Dr Shankar Bidari,BAGALKOT,IND,0,Graduate,55962000,0,55962000
1492,4102,Dr. Aditya Langthasa,NOWGONG,AIUDF,0,Doctorate,5644731,301684,5343047
1493,4168,Dr. Anil Murmu,RAJMAHAL,JVM(P),1,Post Graduate,2986472,328617,2657855
1494,526,Dr. Arun Kr. Sarmah,KALIABOR,AGP,0,Doctorate,19515691,4850186,14665505
1495,2671,Dr. Arun Kumar,JAHANABAD,Rashtriya Lok Samta Party,1,Doctorate,38846631,1000000,37846631
1496,681,Dr. Arvind Kumar Singh,ALIGARH,BSP,0,Doctorate,41664986,6100000,35564986
1497,6249,Dr. Ashok Kumar,SAMASTIPUR,INC,1,Graduate Professional,14532873,1192539,13340334
1498,2708,Dr. Ashok Kumar Singh,MUNGER,SHS,0,Doctorate,2054194,0,2054194
1499,2287,Dr. Balkrishan Bawari,GANGANAGAR,AAP,0,Graduate Professional,3855000,1090000,2765000
1500,105,Dr. Banshilal Mahato,KORBA,BJP,0,Graduate Professional,72303762,382905,71920857
1501,192,Dr. Banuprakash.K,HASSAN,IND,1,Graduate Professional,244250,200000,44250
1502,5823,Dr. Bharati Pravin Pawar,DINDORI,NCP,0,Doctorate,143541254,173000,143368254
1503,1214,Dr. Bhola Singh,BULANDSHAHR,BJP,0,Graduate,12577537,0,12577537
1504,6184,Dr. Binay Kumar Jha,JHANJHARPUR,IND,0,Graduate Professional,664000,15000,649000
1505,1102,Dr. C Mohan,KOLAR,IND,0,Graduate Professional,11910000,0,11910000
1506,2365,Dr. C.P. Joshi,JAIPUR RURAL,INC,0,Doctorate,54972948,1400000,53572948
1507,2567,Dr. C.S.Hanumanthappa,MANDYA,AAP,0,Post Graduate,6965000,0,6965000
1508,6039,Dr. Chandan Sourav Mitra,HOOGHLY,BJP,0,Post Graduate,97550630,10354197,87196433
1509,78,Dr. Debomoy Sanyal,DHUBRI,BJP,0,Post Graduate,18136679,150000,17986679
1510,1569,Dr. Dhai Akshar (Rakesh Sonkar),JABALPUR,IND,0,Graduate,620000,95000,525000
1511,6791,Dr. Dhanapati Das,BARDHAMAN-DURGAPUR,Bahujan Mukti Party,0,12th Pass,14600,0,14600
1512,3999,Dr. Dhirendra Kumar Raj,HAZARIBAGH,IND,0,Graduate Professional,43518730,0,43518730
1513,4609,Dr. Dinesh Parmar,KACHCHH,INC,2,Graduate Professional,13760562,249199,13511363
1514,5158,Dr. Feroz Khan Murtuza Khan,AURANGABAD,IND,0,Doctorate,21375000,0,21375000
1515,928,Dr. Gajbe Rameshkumar Baburaoji,GADCHIROLI-CHIMUR,AAP,0,Post Graduate,9315000,69000,9246000
1516,6002,Dr. Ghone Adesh Yashwant,RAIGAD,Bahujan Mukti Party,0,Graduate Professional,3246908,31702,3215206
1517,2429,Dr. Girija Vyas,CHITTORGARH,INC,1,Doctorate,23585480,0,23585480
1518,3483,Dr. Gurumayum Tonsana Sharma,INNER MANIPUR,Manipur Democratic Peoples Front,0,Doctorate,7135000,0,7135000
1519,65,Dr. Harsh Vardhan,CHANDNI CHOWK,BJP,2,Post Graduate,28229308,1780492,26448816
1520,4184,Dr. Hemlata Jamuna Devi,DHAR,AAP,0,Post Graduate,70225022,0,70225022
1521,668,Dr. Himanshu Singh,MEERUT,AAP,3,Graduate Professional,9408585,0,9408585
1522,3481,Dr. Ibomcha Singh,INNER MANIPUR,AAP,0,Graduate Professional,497250,0,497250
1523,6917,Dr. J. Jayavardhan,CHENNAI SOUTH,AIADMK,0,Graduate Professional,33959072,10981100,22977972
1524,7923,Dr. Janardhan Reddy Nagam,MAHBUBNAGAR,BJP,8,Graduate Professional,46883202,0,46883202
1525,2778,Dr. Jitendra Singh,UDHAMPUR,BJP,0,Graduate Professional,38464932,11881,38453051
1526,6597,Dr. K.C.Patel,VALSAD,BJP,0,Graduate Professional,131141867,2381344,128760523
1527,4587,Dr. Kanubhai V. Kalsaria,BHAVNAGAR,AAP,7,Graduate Professional,1799128,0,1799128
1528,3027,Dr. Kapin Ch. Boro,ALIPURDUARS,IND,0,Graduate,6782287,0,6782287
1529,3747,Dr. Kodur Venkatesh,BANGALORE SOUTH,IND,0,Doctorate,44213130,0,44213130
1530,4151,Dr. Krishna Chandra Singh Raj,DHANBAD,IND,0,Post Graduate,734500,0,734500
1531,464,Dr. Kshetra Pal Singh,FARIDABAD,IND,0,Graduate Professional,3280000,0,3280000
1532,280,Dr. M.V. Ibraheem,MALAPPURAM,IND,3,Graduate Professional,232700,0,232700
1533,1196,Dr. Meer Layaq Hussain,BANGALORE CENTRAL,IND,0,Graduate Professional,30000,0,30000
1534,5796,Dr. Ms. Suchita Kumar,SITAPUR,IND,0,Post Graduate,4859859,0,4859859
1535,1358,Dr. Nabhit Kapur,EAST DELHI,Naya Daur Party,0,Doctorate,150000,0,150000
1536,927,Dr. Namdeo Dalluji Usendi,GADCHIROLI-CHIMUR,INC,1,Post Graduate,14281020,9382799,4898221
1537,2432,Dr. Narendra Kumar Gupta,CHITTORGARH,AAP,0,Graduate Professional,10723839,484486,10239353
1538,6377,Dr. Narsaiah Boora,BHONGIR,TRS,0,Post Graduate,202983225,13574088,189409137
1539,4235,Dr. Naseem Chaudhary Alias Dr. Naseem Gujjar,DAUSA,IND,0,Graduate Professional,6309000,0,6309000
1540,3180,Dr. Nepal Singh,RAMPUR,BJP,0,Doctorate,27136042,1614820,25521222
1541,3225,Dr. Nepole Raghu Murmu,MAYURBHANJ,BJP,0,Doctorate,4573490,419980,4153510
1542,2355,Dr. Om Singh Meena,JAIPUR RURAL,IND,0,Post Graduate,19869123,800000,19069123
1543,3875,Dr. Owhal Jitendra Mahadev,BEED,IND,0,Graduate Professional,3438256,1572500,1865756
1544,7933,Dr. Palla Rajeshwar Reddy,NALGONDA,TRS,0,Doctorate,178513297,25121804,153391493
1545,3978,Dr. Pervez Ali Ahmed,BARPETA,AITC,0,Graduate Professional,327895738,1163236,326732502
1546,3749,Dr. Pradeep Gadugesh,BANGALORE SOUTH,IND,0,Graduate Professional,737397,185386,552011
1547,2527,Dr. Pradeep Rambhau Nagrale,NAGPUR,Ambedkarite Party of India,0,Graduate Professional,8052965,4637487,3415478
1548,3666,Dr. Prakash Shamrao Pawar,SATARA,IND,0,Graduate Professional,886693,0,886693
1549,1728,Dr. Rahul Dipankar,BULANDSHAHR,AAP,0,Post Graduate,74254557,10800000,63454557
1550,2025,Dr. Rajesh Mahendia,HISAR,IND,0,Doctorate,3298180,350000,2948180
1551,2764,Dr. Rakesh Datta Mishra,PATNA SAHIB,Bharatiya Jan Kranti Dal (Democratic),0,Post Graduate,149047,0,149047
1552,4482,Dr. Ram Prakash Mahto,KATIHAR,JD(U),5,Doctorate,11829625,1231046,10598579
1553,3596,Dr. Ramesh Subrav Bansode,OSMANABAD,Republican Party of India,0,Graduate,410000,176114,233886
1554,4778,Dr. Rameshsingh Solanki,KHANDWA,Prajatantrik Samadhan Party,0,Graduate,3800000,2375000,1425000
1555,4916,Dr. Ramshankar Katheria,AGRA,BJP,21,Doctorate,14634885,4035000,10599885
1556,3192,Dr. Rashid Ali,SAMBHAL,Peace Party,0,Post Graduate,6576936,0,6576936
1557,937,Dr. Sandeep Natthuji Nandeshwar,RAMTEK,Bharipa Bahujan Mahasangh,0,Post Graduate,302494,836870,0
1558,6006,Dr. Sanjay Yashwant Aparanti,RAIGAD,AAP,0,Post Graduate,16266714,2924885,13341829
1559,663,Dr. Sanjeev Kumar Balyan,MUZAFFARNAGAR,BJP,1,Doctorate,10794222,3090803,7703419
1560,672,Dr. Satyapal Singh,BAGHPAT,BJP,0,Doctorate,67402076,352000,67050076
1561,64,Dr. Shashi Tharoor,THIRUVANANTHAPURAM,INC,0,Doctorate,230275186,0,230275186
1562,4562,Dr. Solanki Kiritbhai Premjibhai,AHMEDABAD WEST,BJP,0,Post Graduate,34085266,208007,33877259
1563,6060,Dr. Somnath Ghosh,SREERAMPUR,IND,0,Graduate Professional,550000,673368,0
1564,3221,Dr. Sudarshan Lohar,KEONJHAR,Rashtriya Indepndent Morcha,0,Post Graduate,4627400,0,4627400
1565,7771,Dr. Suneel Kumar Venigalla,ZAHIRABAD,AAP,0,Graduate Professional,23467855,1730982,21736873
1566,1431,Dr. Sunilbhau Vishwanathji Narnavre,RAMTEK,Republican Party of India (Khobragade),0,Not Given,2760000,0,2760000
1567,1247,Dr. Suraj Mandal,KODARMA,Jharkhand Vikas Dal,2,Doctorate,7871582,700000,7171582
1568,2643,Dr. Surendra Kumar Prasad,ARRAH,AAP,0,Post Graduate,12314344,0,12314344
1569,5090,Dr. Suresh Jatav,BHARATPUR,INC,0,Post Graduate,35400729,1504711,33896018
1570,422,Dr. Sushil Indora,SIRSA,Haryana Janhit Congress (BL),0,Graduate Professional,31066422,28522,31037900
1571,6187,Dr. Swami Vivekanand,KHAGARIA,AAP,2,Doctorate,9890017,900000,8990017
1572,2380,Dr. Tanmay Sharma,JAIPUR,Indian Peoples Green Party,0,Post Graduate,23869513,1000000,22869513
1573,1373,Dr. Tarun Kumar,CHANDNI CHOWK,Vishva Shakti Party,0,Graduate Professional,5518804,2334044,3184760
1574,3477,Dr. Thokchom Meinya,INNER MANIPUR,INC,0,Doctorate,3825200,0,3825200
1575,5608,Dr. Ulhas Vasudeo Patil,RAVER,IND,1,Doctorate,112059276,2043531,110015745
1576,3667,Dr. Vijaysinha Diliprao Patil,SATARA,IND,0,Graduate Professional,0,0,0
1577,3011,Dr. Virendra Kumar,TIKAMGARH,BJP,0,Doctorate,8764635,0,8764635
1578,2374,Dr. Virendra Singh,JAIPUR,AAP,0,Post Graduate,72141860,0,72141860
1579,434,Dr. Yudhbir Singh Khyalia,HISAR,AAP,0,Doctorate,23346340,7678981,15667359
1580,7888,Dr.Bhagavanth Rao,HYDERABAD,BJP,0,Graduate Professional,4274998,0,4274998
1581,3582,Dr.Bhise Indrakumar Devrao,MADHA,IND,0,Graduate Professional,13265000,13550000,0
1582,7853,Dr.Dharam Vira Gandhi,PATIALA,AAP,0,Graduate Professional,45115421,0,45115421
1583,6217,Dr.Dharmaiah Vendavetla,KARIMNAGAR,Bahujan Mukti Party,0,Doctorate,8985000,0,8985000
1584,6460,Dr.Gaddam Vivekanand,PEDDAPALLE,INC,1,Graduate Professional,2665292981,123152497,2542140484
1585,7593,Dr.Ganesan.M,TIRUNELVELI,IND,0,Graduate Professional,10943691,0,10943691
1586,7249,Dr.Gavit Heena Vaijaykumar,NANDURBAR,BJP,0,Graduate Professional,131103963,7571753,123532210
1587,7919,Dr.Golla Ramaiah,CHEVELLA,Telangana Loksatta Party,0,Doctorate,141800,0,141800
1588,7671,Dr.Inderpal,AMRITSAR,IND,2,Graduate Professional,6007000,0,6007000
1589,6468,Dr.Janapati Sarat Babu,PEDDAPALLE,TDP,0,Graduate Professional,11265199,3875000,7390199
1590,7568,Dr.Jayakumar.K.,TENKASI,INC,0,Doctorate,12385277,0,12385277
1591,4543,Dr.Jayaprakash Narayan N,MALKAJGIRI,Lok Satta Party,0,Doctorate,62743517,2200000,60543517
1592,1132,Dr.Kohapare Harshawardhan Muneshwar,BHANDARA-GONDIYA,Bahujan Mukti Party,0,Graduate Professional,980000,14000,966000
1593,7569,Dr.Krishnasamy.K.,TENKASI,Puthiya Tamilagam,2,Post Graduate,166640601,10238049,156402552
1594,5713,Dr.Mahmood Husain Rahmani,KANPUR,AAP,0,Post Graduate,33447841,4984897,28462944
1595,6841,Dr.Manda Jagannath,NAGARKURNOOL,TRS,0,Post Graduate,68881380,4287202,64594178
1596,1094,Dr.Meerlayaq Hussain,BANGALORE NORTH,IND,0,Graduate Professional,31000,0,31000
1597,5847,Dr.Mubeen Ahmad,JALGAON,IND,1,Others,22500,0,22500
1598,5714,Dr.Murli Manohar Joshi,KANPUR,BJP,1,Doctorate,78410008,0,78410008
1599,6439,Dr.N.S.Uday Kumar,SECUNDERABAD,Prem Janata Dal,0,Doctorate,6750000,0,6750000
1600,7873,Dr.N.V.Sudha Kiran,MALKAJGIRI,AAP,0,Graduate Professional,29100000,10000000,19100000
1601,4769,Dr.Neha Sharma,INDORE,SP,0,Doctorate,12661316,0,12661316
1602,5723,Dr.Nikhil Gupta,KANPUR,Nav Bharat Democratic Party,1,Graduate Professional,43775031,13527529,30247502
1603,2853,Dr.Om Prakash Ananad,JAMSHEDPUR,IND,0,Post Graduate,2292704,559358,1733346
1604,6829,Dr.P. Sravan Kumar Reddy,MEDAK,INC,0,Graduate Professional,150851000,0,150851000
1605,3578,Dr.Pramod Ramchandra Gawade,MADHA,IND,0,Doctorate,498000,266676,231324
1606,2995,Dr.Prashant Tripathi,RAJGARH,AAP,1,Graduate Professional,11252908,3907073,7345835
1607,781,Dr.Rajendra Ramkrishna Gawai,AMRAVATI,RPI,0,Graduate Professional,38261507,0,38261507
1608,7571,Dr.Sadhan Thirumalaikumar.T.,TENKASI,MDMK,1,Graduate Professional,34406591,18526162,15880429
1609,5835,Dr.Satish Bhaskarrao Patil,JALGAON,NCP,1,Graduate,46486689,7296297,39190392
1610,2994,Dr.Shivnarayan Verma,RAJGARH,BSP,0,Graduate Professional,410000,0,410000
1611,5869,Dr.Shrikant Eknath Shinde,KALYAN,SHS,0,Graduate Professional,998000,0,998000
1612,850,Dr.Sridhar Udupa,DAVANAGERE,IND,0,Doctorate,918000,0,918000
1613,4650,Dr.Urmila Singh Marko,KORBA,Rashtriya Gondvana Party,0,Graduate,3213305,0,3213305
1614,3376,Dr.Vishwajeet Patangrao Kadam,PUNE,INC,0,Doctorate,874957697,204983496,669974201
1615,140,Drupad Borgohain,JORHAT,CPI,0,Graduate,1479690,0,1479690
1616,5424,Dubraj Singh Markam,SURGUJA,IND,0,12th Pass,103540,0,103540
1617,4119,Dujram Boudh,JANJGIR-CHAMPA,BSP,0,12th Pass,1249497,216000,1033497
1618,3829,Dulal Rajbanshi,RAIGANJ,SUCI(C),2,12th Pass,885667,266749,618918
1619,206,Duli Chand,KARNAL,Lok Parivartan Party(DC),0,Graduate Professional,4828000,290000,4538000
1620,2351,Duli Chand Kumawat,SIKAR,IND,0,Graduate,9036500,0,9036500
1621,2295,Dulichand Meghwal,GANGANAGAR,IND,0,5th Pass,6113000,0,6113000
1622,3446,Dungar Mal Puniya,JODHPUR,IND,0,10th Pass,3116000,0,3116000
1623,6889,Durai Babu. R,CHENNAI NORTH,IND,0,8th Pass,402800,0,402800
1624,7002,Duraisamy.A,ERODE,IND,0,5th Pass,19312,0,19312
1625,2874,Durga Munda,RANCHI,BSP,0,8th Pass,16842973,0,16842973
1626,379,Durga Thakur,AURANGABAD,IND,0,10th Pass,730000,0,730000
1627,6174,"Durganand Mahavir Nayak,",DARBHANGA,BSP,2,Post Graduate,63562000,304995,63257005
1628,1799,Durgesh Chandra Gautam,ALIGARH,AITC,0,Graduate Professional,5878725,0,5878725
1629,2744,Durgesh Nandan Singh,PATALIPUTRA,IND,0,Graduate Professional,3273000,0,3273000
1630,1294,Dushmanta Kumar Giri,SOUTH DELHI,IND,1,Doctorate,9500000,2720000,6780000
1631,2394,Dushyant,JHALAWAR-BARAN,BJP,0,Post Graduate,239006838,2798782,236208056
1632,201,Dushyant Chautala,HISAR,INLD,0,Graduate,361326990,68744460,292582530
1633,797,Dusmanta Kar,SAMBALPUR,IND,0,Graduate Professional,10000,0,10000
1634,5288,Dutt Akashbhai Natwarbhai,AHMEDABAD EAST,JD(U),5,Graduate Professional,208392,0,208392
1635,5901,Dutt Priya Sunil,MUMBAI NORTH CENTRAL,INC,0,Graduate,655093802,33463408,621630394
1636,7230,Dv. Amarsen Baburao Babar,MUMBAI NORTH EAST,IND,0,Doctorate,2629000,1500000,1129000
1637,1597,Dwarka Prasad Pahade,CHHINDWARA,IND,0,12th Pass,1276700,0,1276700
1638,7817,Dyal Chand,BATHINDA,IND,0,Literate,58600,0,58600
1639,1891,E S Khaja Hussain,PALAKKAD,SDPI,2,10th Pass,6490438,35000,6455438
1640,279,E. Ahamed,MALAPPURAM,IUML,1,Graduate Professional,11818952,0,11818952
1641,273,E. T. Mohammed Basheer,PONNANI,IUML,0,12th Pass,13216259,0,13216259
1642,3724,E.Salam,BANGALORE CENTRAL,IND,0,5th Pass,200000,0,200000
1643,4303,E.V.K.S. Elangovan,TIRUPPUR,INC,3,Graduate,153853744,18850000,135003744
1644,7140,Easwaran . R,POLLACHI,IND,0,8th Pass,2391135,600000,1791135
1645,1920,Edappally Basheer,CHALAKUDY,IND,0,Graduate,4228516,2000000,2228516
1646,5431,Ediroli Manian G,TIRUVANNAMALAI,Pattali Makkal Katchi,0,Post Graduate,6695071,839500,5855571
1647,7942,Eesam Sudhakar,MAHABUBABAD,IND,0,Graduate,0,0,0
1648,6328,Elanchezhian.S,DINDIGUL,AAP,0,Graduate Professional,10729709,0,10729709
1649,6267,"Elango, D.",ARAKKONAM,IND,0,8th Pass,400000,0,400000
1650,6268,"Elango, N.",ARAKKONAM,IND,0,8th Pass,260000,0,260000
1651,6257,"Elango, N.R",ARAKKONAM,DMK,0,Graduate Professional,43068404,1304056,41764348
1652,6269,"Elangovan, A.",ARAKKONAM,IND,0,8th Pass,400000,0,400000
1653,6270,"Elangovan, D.",ARAKKONAM,IND,0,10th Pass,747800,0,747800
1654,503,Elias Kujur,TEZPUR,IND,0,Graduate Professional,502074,0,502074
1655,1778,Eliash Narjinary,ALIPURDUARS,BSP,0,12th Pass,4236000,0,4236000
1656,2196,Eliya Kati,UTTARA KANNADA,Sarva Janata Party,0,12th Pass,6330,30000,0
1657,7592,Elizabeth.D,TIRUNELVELI,IND,0,8th Pass,3646910,0,3646910
1658,1217,Em. Narayanaswamy,KOLAR,BJP,0,Graduate,22377047,7984143,14392904
1659,4548,Endala Lakshminarayana,NIZAMABAD,BJP,0,Graduate,35586859,3356600,32230259
1660,1456,Eng. Sanjay Raghunath Nasare,BHANDARA-GONDIYA,BSP,0,Graduate Professional,8504878,511145,7993733
1661,4213,Engineear Bhagwat Singh Rajput,VIDISHA,AAP,0,Others,2513476,0,2513476
1662,3121,Engineer Mohammad Irfan,MORADABAD,Peace Party,0,Graduate Professional,25678455,828616,24849839
1663,4862,Entaz Ali,BARPETA,Lok Bharati,0,8th Pass,1200000,0,1200000
1664,1565,"Er. Pravin Gajbhiye \""Dada\""",JABALPUR,Bahujan Mukti Party,0,Graduate Professional,4462,0,4462
1665,4504,Er. Ramfal Mandrey,BILASPUR,Ambedkarite Party of India,0,Post Graduate,301500,0,301500
1666,2299,Er. Shankar Pannu,BIKANER,INC,0,Others,56245484,3791491,52453993
1667,746,Er. Vijay Kumar Kol,SHAHDOL,AAP,0,Post Graduate,180118,0,180118
1668,5805,Eraj Beg,SITAPUR,Nagrik Ekta Party,0,8th Pass,8215000,0,8215000
1669,5211,Eshi Yogesh Yashwant,DHULE,BSP,0,10th Pass,1339900,0,1339900
1670,7404,"Eswaran, R.",VELLORE,IND,0,Illiterate,219000,0,219000
1671,7108,"Eswaran, T.",NILGIRIS,Makkal Manadu Katchi,0,8th Pass,10000,0,10000
1672,7134,Eswaran.E.R.,POLLACHI,BJP,0,Graduate Professional,283641697,146250595,137391102
1673,7446,Eswaran.J,TIRUCHIRAPPALLI,IND,0,12th Pass,41000,0,41000
1674,6952,"Ezhumalai, V",CHIDAMBARAM,Akhil Bharat Hindu Mahasabha,0,Literate,0,44500,0
1675,129,Faggan Singh Kulaste,MANDLA,BJP,2,Post Graduate,25738420,98311,25640109
1676,4750,Fagram,BETUL,Samajwadi Jan Parishad,0,5th Pass,216170,6000,210170
1677,4496,Fagu Marandi,PURNIA,Jharkhand Disom Party,1,Graduate,1151323,0,1151323
1678,6240,Faiz Ahmad,MADHUBANI,Jai Prakash Janata Dal,2,Post Graduate,326684,0,326684
1679,6172,"Faizal Ahmad,",DARBHANGA,Janta Dal Rashtravadi,0,Graduate,60000,0,60000
1680,2003,Fakir Chand,SIRSA,IND,0,8th Pass,438500,0,438500
1681,2498,Falguni Tripura,TRIPURA EAST,CPI(ML)L,0,12th Pass,3500,0,3500
1682,6114,Faqir Chand Kariha,ANANDPUR SAHIB,IND,0,10th Pass,1460000,0,1460000
1683,3038,Farhat Hasan,AMROHA,BSP,1,10th Pass,47354896,0,47354896
1684,6807,Farooq Abdullah,SRINAGAR,JKNC,0,Graduate Professional,131005305,0,131005305
1685,2379,Farooq Khan,JAIPUR,BSP,0,5th Pass,13091000,0,13091000
1686,4881,Faruk Aahammed Bhuyan,GAUHATI,IND,1,Doctorate,875500,300000,575500
1687,4450,Faruk Hazarika,NOWGONG,IND,0,5th Pass,2408443,700000,1708443
1688,5971,Fasale Baban Namdev,NASHIK,IND,0,10th Pass,101000,0,101000
1689,6575,Fatepara Devajibhai Govindbhai,SURENDRANAGAR,BJP,1,Literate,11685000,0,11685000
1690,7088,Fathima Alias Bharathi. R,MAYILADUTHURAI,IND,1,10th Pass,808518,190000,618518
1691,4125,Fatte Singh Shyam,KORBA,IND,0,Illiterate,10250700,702807,9547893
1692,211,Fauji Jai Kawar Tyagi Dixit,GURGAON,IND,0,8th Pass,42915552,0,42915552
1693,2223,Fayaz Ahamed Alias Mohammad Fayaz Ahamad,SHIMOGA,Sarva Janata Party,0,8th Pass,6884684,409000,6475684
1694,6818,Fayaz Ahmad Bhat,SRINAGAR,BJP,0,Graduate,152000,0,152000
1695,3319,Feroz Khan Gazi,NANDED,IND,0,12th Pass,3482000,0,3482000
1696,1482,Firaj Pathan,CHANDRAPUR,Bahujan Mukti Party,1,12th Pass,6370,62000,0
1697,3202,Firoj Haider,SAMBHAL,IND,0,Graduate,8301000,0,8301000
1698,7235,Firoz Ahmed Siddiqui,MUMBAI NORTH EAST,IND,0,8th Pass,1669355,0,1669355
1699,4840,Firoz Akhtar,MALDAHA DAKSHIN,Bahujan Mukti Party,0,Post Graduate,909008,1533677,0
1700,2786,Foolodevi Netam,KANKER,INC,0,12th Pass,4819534,0,4819534
1701,16,Fr.Stephen,THIRUVANANTHAPURAM,IND,2,Post Graduate,169587,181000,0
1702,7206,Francis Lawrence Fernandes,MUMBAI NORTH CENTRAL,IND,0,Graduate,15071413,0,15071413
1703,4483,Fulmani Hembram,KATIHAR,Bharat Vikas Morcha,0,8th Pass,753000,0,753000
1704,4165,Furkan Ansari,GODDA,INC,1,Graduate,21332923,1040000,20292923
1705,3802,G Anojirao,KOPPAL,IND,0,12th Pass,2101000,0,2101000
1706,602,G C Patel,DAVANAGERE,Sarva Janata Party,0,Graduate Professional,719300,0,719300
1707,2621,G C Venkataramanappa,CHIKKBALLAPUR,RPI(A),0,5th Pass,375000,0,375000
1708,3772,G N Ravi,CHIKKBALLAPUR,IND,0,Others,673700,50000,623700
1709,2156,G Nataraja,BELLARY,Karunaadu Party,0,Others,885000,0,885000
1710,853,G V Sreerama Reddy,CHIKKBALLAPUR,CPI(M),1,Graduate Professional,6720730,620000,6100730
1711,4036,G. Anandhan,VILUPPURAM,CPI(M),1,10th Pass,192800,21500,171300
1712,3731,G. Narayanaswamy (Kapali),BANGALORE CENTRAL,IND,0,10th Pass,8146501,0,8146501
1713,4058,G. Palani,PONDICHERRY,CPI(ML)L,0,10th Pass,1239728,90000,1149728
1714,5593,G. Sutha,PONDICHERRY,IND,0,10th Pass,1120900,0,1120900
1715,3752,G. Venkatesh Bhovi,BANGALORE SOUTH,IND,0,10th Pass,3532000,0,3532000
1716,4347,G.Balasubramanian,KARUR,IND,0,12th Pass,5889437,332804,5556633
1717,4287,G.Bojan,KALLAKURICHI,IND,0,8th Pass,422000,0,422000
1718,7495,G.Kannan,MADURAI,IND,0,Graduate,101000,0,101000
1719,1220,G.M. Siddeshwara,DAVANAGERE,BJP,0,10th Pass,232375703,17951455,214424248
1720,3992,G.M.Siddeshi,DAVANAGERE,IND,0,12th Pass,1501000,275000,1226000
1721,6204,G.Mallesham Goud,CHEVELLA,IND,0,Post Graduate,14600000,5600000,9000000
1722,3842,G.Maria Joseph Xaviour,MADURAI,IND,0,Post Graduate,7492013,0,7492013
1723,3786,G.N.Venkatesh,KOLAR,IND,0,Graduate Professional,545000,80000,465000
1724,2568,G.Nagendra,TUMKUR,IND,0,10th Pass,275000,0,275000
1725,5110,G.R.Barua,KARAULI-DHOLPUR,BSP,0,Post Graduate,24397589,278400,24119189
1726,1087,G.S.Basavaraj,TUMKUR,BJP,0,Graduate Professional,275785995,67200540,208585455
1727,4061,G.Shanmugam,PONDICHERRY,IND,0,Others,5875000,0,5875000
1728,4753,Gabbar Sinh Warkade,BETUL,Bahujan Mukti Party,0,8th Pass,75000,0,75000
1729,6452,Gaddala Vinay Kumar,PEDDAPALLE,IND,0,8th Pass,8237500,488664,7748836
1730,4607,Gadhiya Soyeb Husenbhai,JUNAGADH,IND,2,Others,263000,120561,142439
1731,1226,Gadkari Nitin Jairam,NAGPUR,BJP,4,Graduate Professional,153704475,19004037,134700438
1732,4791,Gaffar,KHARGONE,IND,0,Literate,525500,0,525500
1733,978,Gagan Rastogi,CHANDNI CHOWK,IND,0,Graduate,53919,0,53919
1734,6103,Gagandeep Kumar,AMRITSAR,IND,0,Post Graduate,1903789,0,1903789
1735,2597,Gaikawad Rajendra Vitthal,YAVATMAL-WASHIM,IND,1,12th Pass,30250,0,30250
1736,5831,Gaikwad Abhijeet Kalyanrao,DINDORI,IND,0,Graduate Professional,200000,0,200000
1737,5598,Gaikwad Bhagwan Madhav,RAVER,Prabuddha Republican Party,0,Literate,50000,0,50000
1738,5934,Gaikwad Eknath Mahadeo,MUMBAI SOUTH CENTRAL,INC,0,10th Pass,24441410,2050000,22391410
1739,934,Gaikwad Mohan Ramrao,NAGPUR,BSP,0,Doctorate,47473922,33921023,13552899
1740,3598,Gaikwad Ravindra Vishwanath,OSMANABAD,SHS,8,Post Graduate,32852793,5962702,26890091
1741,3548,Gaikwad Sunil Baliram,LATUR,BJP,0,Doctorate,17463251,0,17463251
1742,3354,Gaikwad Texas Bhausaheb,MAVAL,BSP,0,Graduate Professional,38366000,0,38366000
1743,3599,Gaikwad Umaji Pandurang,OSMANABAD,IND,0,10th Pass,597,0,597
1744,6827,Gajabheemkar Bansilal,MEDAK,IND,0,10th Pass,233000,0,233000
1745,7877,Gajabinkar Bansilal,MALKAJGIRI,IND,0,12th Pass,233000,0,233000
1746,5908,Gajanan Chandrakant Kirtikar,MUMBAI NORTH WEST,SHS,0,Graduate,58352000,2257000,56095000
1747,3561,Gajanan Pandurang Mane,LATUR,IND,0,Not Given,838628,0,838628
1748,1700,Gajendra,GAUTAM BUDHHA NAGAR,Indian Oceanic Party,0,Post Graduate,50000,0,50000
1749,2777,Gajendra Kumar,PATNA SAHIB,Sankhyanupati Bhagidari Party,0,Graduate,1575000,0,1575000
1750,3556,Gajendra Limbaji Avghade,LATUR,IND,0,12th Pass,761000,0,761000
1751,6272,"Gajendran, S.",ARAKKONAM,IND,0,12th Pass,152000,0,152000
1752,3438,Gajendrasingh Shekhawat,JODHPUR,BJP,0,Post Graduate,143491494,92198588,51292906
1753,1755,Gajresh Kumar,BIJNOR,IND,1,Graduate,266000,0,266000
1754,7299,Gamar Vadhabhai Radhabhai,BANASKANTHA,IND,0,12th Pass,660000,0,660000
1755,3492,Gandhi Dilipkumar Mansukhlal,AHMEDNAGAR,BJP,10,10th Pass,65316725,34176876,31139849
1756,7105,"Gandhi, P.",NILGIRIS,INC,0,Graduate,3575000,538000,3037000
1757,7069,Gandhi.Tvs,KRISHNAGIRI,IND,0,Graduate,35033,0,35033
1758,6323,Gandhirajan S,DINDIGUL,DMK,0,Graduate Professional,64318720,13001000,51317720
1759,5676,Gandhiselvan.S,NAMAKKAL,DMK,0,Post Graduate,33049195,800000,32249195
1760,6910,Ganesan S,CHENNAI SOUTH,SUCI(C),0,Graduate Professional,32901000,0,32901000
1761,7575,Ganesan.S.,TENKASI,IND,0,Post Graduate,185000,0,185000
1762,3016,Ganesh,TIKAMGARH,IND,0,5th Pass,20000,0,20000
1763,6788,Ganesh Bag,ARAMBAG,Jharkhand Disom Party,0,8th Pass,0,0,0
1764,938,Ganesh Bapurao Patil,RAMTEK,GGP,0,5th Pass,5220000,20000,5200000
1765,5941,Ganesh Bhimrao Budhe,MUMBAI SOUTH CENTRAL,IND,0,12th Pass,60000,50000,10000
1766,6255,Ganesh Kumar,SAMASTIPUR,AAP,0,10th Pass,2262533,0,2262533
1767,6776,Ganesh Mukhiya Nishad,KHAGARIA,Sarvajan Kalyan Loktantrik Party,1,12th Pass,6829298,0,6829298
1768,4820,Ganesh Rajak,VIDISHA,Samata Party,0,12th Pass,560000,0,560000
1769,2761,Ganesh Shaw,PATNA SAHIB,BSP,0,Graduate,64000,52000,12000
1770,732,Ganesh Singh,SATNA,BJP,2,Post Graduate,37800000,0,37800000
1771,5374,Ganesh Yadav,BILASPUR,GGP,0,10th Pass,100500,0,100500
1772,2588,Ganesha,CHITRADURGA,IND,0,Not Given,115500,0,115500
1773,6348,Ganesha Murthi.A,ERODE,MDMK,1,Graduate,29856503,2512561,27343942
1774,6962,"Ganeshkumar, K.",COIMBATORE,DMK,0,Graduate Professional,12964091,222000,12742091
1775,5035,Ganga Charan,KANNAUJ,Rashtriya Kranti Party,0,Post Graduate,1538638,75000,1463638
1776,5543,Ganga Singh,JALAUN,Al-Hind Party,0,10th Pass,8500,0,8500
1777,2771,Ganga Vishnu Prasadq,PATNA SAHIB,IND,0,Graduate Professional,6401308,0,6401308
1778,7405,"Gangadaran, K.",VELLORE,IND,0,Not Given,4009373,0,4009373
1779,2802,Gangadhar Patel,MAHASAMUND,IND,0,5th Pass,929000,0,929000
1780,178,Gangadhar S. Badiger,DHARWAD,SUCI(C),0,Graduate,60000,0,60000
1781,3877,Gangadhar Sitaram Kalkute,BEED,IND,0,Graduate,425000,0,425000
1782,7398,"Gangadharan, K.",VELLORE,Tamil Nadu Makkal Congress,0,10th Pass,167000,17500,149500
1783,4789,Gangaram Pratap,KHARGONE,Aadijan Mukti Sena,0,8th Pass,38287,0,38287
1784,194,Gangmumei Kamei,OUTER MANIPUR,BJP,0,Post Graduate,10656364,0,10656364
1785,6402,Gannarapu Surender,WARANGAL,BSP,0,Post Graduate,9110000,3000000,6110000
1786,4697,Ganpat Mahto,DHANBAD,IND,1,12th Pass,21327928,0,21327928
1787,124,Gaur Chandra Majumder,ANDAMAN & NICOBAR ISLANDS,BSP,0,Graduate,3192819,688689,2504130
1788,6600,Gaurangbhai Rameshbhai Patel,VALSAD,Hindustan Janta Party,1,12th Pass,240000,0,240000
1789,687,Gaurav,BIJNOR,AAP,0,Graduate Professional,28246000,24000000,4246000
1790,5255,Gaurav Kumar Ghosh,BHAGALPUR,National Tiger Party,0,12th Pass,8464037,250000,8214037
1791,2301,Gauri Shankar,BIKANER,AAP,0,Doctorate,2173200,300000,1873200
1792,2533,Gaus Mohammed Sheikh Ayyub Sheikh,NAGPUR,IND,0,10th Pass,50000,0,50000
1793,7920,Gautam Bharti,MOHANLALGANJ,Rashtriya Rashtrawadi Party,0,12th Pass,637543,0,637543
1794,4707,Gautam Kumar Mahato,DHANBAD,IND,0,10th Pass,415157,2000,413157
1795,4864,Gautam Kumar Sarma,BARPETA,IND,0,Post Graduate,5276151,600000,4676151
1796,1581,Gautam Ramteke,BALAGHAT,Republican Party of India (Khobragade),0,12th Pass,2000,0,2000
1797,4367,Gautam Sarkar,MALDAHA UTTAR,SUCI(C),0,Post Graduate,327400,0,327400
1798,3915,Gautam Shinde,BHOPAL,Apna Dal,0,Graduate Professional,633000,0,633000
1799,5988,Gavari Shyam Anant,PALGHAR,BSP,0,12th Pass,150000,0,150000
1800,7248,Gavit Manikrao Hodlya,NANDURBAR,INC,2,5th Pass,51833563,271769,51561794
1801,1511,Gawali Bhavana Pundlikrao,YAVATMAL-WASHIM,SHS,4,Graduate,60886040,7368967,53517073
1802,3668,Gawde Sukhdev Bhanudas,SATARA,IND,0,10th Pass,2170000,0,2170000
1803,3259,Gayadhar Mallick,JAJPUR,Samata Kranti Dal,1,10th Pass,371500,0,371500
1804,5160,Gayake Sadashiv Ambadas,AURANGABAD,SP,4,Graduate Professional,12025302,227000,11798302
1805,5200,Gazi Atejad,DHULE,IND,0,10th Pass,33000,0,33000
1806,369,Geeta Arya,SASARAM,AAP,0,8th Pass,18756436,0,18756436
1807,2884,Geeta Kora,SINGHBHUM,Jai Bharat Samanta Party,1,Graduate,30267735,583602,29684133
1808,2947,Geeta Rajput,GWALIOR,Al-Hind Party,0,12th Pass,53000,0,53000
1809,6123,Geeta Rani,BATHINDA,Akhil Bharatiya Shivsena Rashtrawadi,0,5th Pass,0,0,0
1810,3393,Geetaram Ramchandra Kadam,SHIRUR,Socialist Party (India),0,12th Pass,6423981,1100000,5323981
1811,5997,Geete Anant Gangaram,RAIGAD,SHS,0,10th Pass,44466487,23968087,20498400
1812,1190,Geetha Shivarajkumar,SHIMOGA,JD(S),0,Graduate,176721674,38712502,138009172
1813,6044,George Baker,HOWRAH,BJP,0,Others,1185773,0,1185773
1814,638,George Mankidiyil,THIRUVANANTHAPURAM,IND,0,Graduate Professional,20103771,0,20103771
1815,7400,"George, V.A.",VELLORE,Bharatiya Dr. B.R.Ambedkar Janta Party,0,5th Pass,7850,0,7850
1816,7609,Germanus.S,TIRUNELVELI,IND,0,Post Graduate,1264010,0,1264010
1817,4686,Gh. Nabi Shah,ANANTNAG,SP,0,10th Pass,19939000,878970,19060030
1818,5109,Ghanshyam,KARAULI-DHOLPUR,AAP,0,10th Pass,2100191,100000,2000191
1819,5542,Ghanshyam Anuragi,JALAUN,SP,1,Graduate Professional,22697258,12500000,10197258
1820,4768,Ghanshyam Chandel,INDORE,IND,0,Graduate,3465000,220000,3245000
1821,1335,Ghanshyam Dass,NEW DELHI,IND,0,10th Pass,21043000,0,21043000
1822,1577,Ghanshyam Kudape,MANDLA,IND,0,10th Pass,1351051,0,1351051
1823,5740,Ghanshyam Singh,LUCKNOW,IND,0,Others,7842986,1857893,5985093
1824,3357,Gharat Santosh Rohidas,MAVAL,Bahujan Mukti Party,0,8th Pass,11200149,780879,10419270
1825,1489,Ghaywan Roshan Jambuwantrao,CHANDRAPUR,Republican Party (Khoripa),0,Post Graduate,1921000,0,1921000
1826,5094,Ghisu Lal,BHARATPUR,IND,0,12th Pass,275000,0,275000
1827,3680,Gholap Sandeep Bhaskar,SHIRDI,IND,0,8th Pass,193600,0,193600
1828,4591,Ghosh Niranjan Somabhai,GANDHINAGAR,BSP,0,Graduate,4063969,0,4063969
1829,555,Ghulam Kundanam,KARAKAT,AAP,1,Graduate Professional,623000,280800,342200
1830,670,Ghulam Mohammed,BAGHPAT,SP,0,Post Graduate,22108104,5678445,16429659
1831,2785,Ghulam Nabi Azad,UDHAMPUR,INC,0,Post Graduate,41389590,0,41389590
1832,3520,Ghunnar Prakash Vitthalrao,HINGOLI,IND,0,12th Pass,10572325,300000,10272325
1833,485,Ghuran Ram,PALAMAU,JVM(P),3,Graduate,14586699,1046647,13540052
1834,874,Gicho Kabak,ARUNACHAL WEST,NCP,0,10th Pass,400000,0,400000
1835,3017,Girdhari,TIKAMGARH,IND,0,12th Pass,1403342,0,1403342
1836,3897,Girdhari Lal,UDHAMPUR,Bharatiya Bahujan Party,0,Post Graduate,24920000,0,24920000
1837,6606,Giri Ramchandra Vaijnath,PANCHMAHAL,BSP,0,12th Pass,2182000,80000,2102000
1838,1172,Giridhar Gamang,KORAPUT,INC,0,Graduate,5895460,2500000,3395460
1839,341,Girija Kumary,ATTINGAL,BJP,0,12th Pass,3279941,146000,3133941
1840,3297,Girindra Nath Barman,COOCHBEHAR,BSP,0,10th Pass,103000,0,103000
1841,149,Giriraj Singh,NAWADA,BJP,1,Graduate,50054771,0,50054771
1842,6879,Giriraj. D,CHENNAI NORTH,IND,0,5th Pass,3415000,0,3415000
1843,6865,Girirajan .R,CHENNAI NORTH,DMK,0,Not Given,46700792,7733259,38967533
1844,3148,Girish Chandra,NAGINA,BSP,1,Graduate,24839368,8097654,16741714
1845,1541,Girish Kumar Gautam,REWA,IND,0,Post Graduate,381000,0,381000
1846,2174,Girishgouda Channabasanagouda Bistanagoudar,HAVERI,IND,0,Graduate,6555,0,6555
1847,7628,Girishji Jenaji Dabhi,MAHESANA,Bharatiya National Janta Dal,2,5th Pass,2333000,300000,2033000
1848,6752,Girja Shankar @ Raju,UNNAO,Swarajya Party Of India,0,Literate,198200,0,198200
1849,2941,Girraj Yadav,GUNA,IND,6,10th Pass,565000,0,565000
1850,4586,Gita Chetan Paunda,BHAVNAGAR,BSP,0,Graduate Professional,468200,113000,355200
1851,4166,Gita Mandal,GODDA,CPI(ML)L,3,Graduate,1887379,0,1887379
1852,5690,Gnanapandithan.P,NAMAKKAL,RPI (A),0,Illiterate,146000,0,146000
1853,6045,Gobarddhan Manna,HOWRAH,Indian Unity Centre,0,8th Pass,457000,0,457000
1854,7783,Gobind Singh,FARIDKOT,RPI(A),0,8th Pass,100000,0,100000
1855,7674,Godam Nagesh,ADILABAD,TRS,0,Post Graduate,10378857,148784,10230073
1856,5961,Godse Hement Tukaram,NASHIK,SHS,1,12th Pass,83611067,23559648,60051419
1857,7324,Gohel Bharatbhai Bhimabhai,BHAVNAGAR,IND,0,8th Pass,0,0,0
1858,7325,Gohil Pravinsinh Dhirubha,BHAVNAGAR,IND,0,10th Pass,1851000,168890,1682110
1859,5304,Gohil Virsangbhai Parbatbhai,BHARUCH,IND,0,10th Pass,6286233,0,6286233
1860,7167,Gokila .K,RAMANATHAPURAM,IND,0,Post Graduate,134022,240000,0
1861,6229,Gokinepalli Venkateswara Rao,KHAMMAM,IND,2,5th Pass,370000,0,370000
1862,4181,Gokul Prasad Dongre,DEWAS,BSP,1,Graduate,18675000,329980,18345020
1863,7187,Gondane Divakar Laxman,MUMBAI NORTH,Bharipa Bahujan Mahasangh,1,Graduate,4103000,0,4103000
1864,7168,Gopal .R,RAMANATHAPURAM,IND,0,Graduate,570000,0,570000
1865,2303,Gopal Balmiki,BIKANER,IND,0,10th Pass,1000,0,1000
1866,5896,Gopal Chinayya Shetty,MUMBAI NORTH,BJP,10,5th Pass,95617889,0,95617889
1867,5775,Gopal Kanaujiya,MOHANLALGANJ,RPI(A),0,12th Pass,1239961,0,1239961
1868,5089,Gopal Paharia,BHARATPUR,AAP,1,Graduate,108894131,0,108894131
1869,2775,Gopal Prasad Sinha,PATNA SAHIB,JD(U),0,Post Graduate,59131851,0,59131851
1870,1159,Gopal Pujari,NABARANGPUR,Aama Odisha Party,1,10th Pass,100000,0,100000
1871,2649,Gopal Singh,ARRAH,IND,0,10th Pass,2410664,0,2410664
1872,2457,Gopal Singh Shekhawat,RAJSAMAND,INC,0,Graduate Professional,4157012,796727,3360285
1873,7094,Gopal. Dr. K,NAGAPATTINAM,AIADMK,0,Graduate Professional,19074709,13629120,5445589
1874,7106,"Gopalakrishnan, C.",NILGIRIS,AIADMK,0,Post Graduate,10941189,1224754,9716435
1875,3439,Goparam Meghwal,JODHPUR,BSP,0,5th Pass,8626500,0,8626500
1876,4876,Gopi Baruah,GAUHATI,Lok Bharati,0,8th Pass,670004,0,670004
1877,506,Gopi Chand Shahabadi,TEZPUR,AITC,0,Graduate,20624119,3437403,17186716
1878,4093,Gopi Nath Das,GAUHATI,AIUDF,0,Graduate,11382580,0,11382580
1879,6352,Gopi P,ERODE,INC,0,Literate,19406959,895121,18511838
1880,4265,Gopi Raman,AKBARPUR,JD(U),1,10th Pass,1899211,20295,1878916
1881,819,Gopinath Jani,NABARANGPUR,BSP,0,8th Pass,426659,37200,389459
1882,5634,Gopinath Sakharam Mhaske,THANE,Bharipa Bahujan Mahasangh,0,Illiterate,2045000,0,2045000
1883,6273,"Gopinathan, G.",ARAKKONAM,IND,0,Graduate,25686000,3020900,22665100
1884,282,Gopinathan.N,MALAPPURAM,IND,0,Post Graduate,2486000,201347,2284653
1885,7407,"Gopu, C.",VELLORE,IND,0,12th Pass,2500000,150000,2350000
1886,6615,Gora Shoeb Mohmadhanif,PANCHMAHAL,IND,0,5th Pass,50000,0,50000
1887,2324,Gordhan Sarswat,CHURU,AITC,0,Literate,500000,0,500000
1888,6466,Gorre Ramesh,PEDDAPALLE,IND,0,Post Graduate,621500,200000,421500
1889,2448,Gotam Lal Meena,UDAIPUR,CPI(ML)L,1,5th Pass,141876,0,141876
1890,254,Gothra Moopan Nellikadan Kannan,KASARAGOD,IND,0,Not Given,240000,0,240000
1891,115,Gourav Gogoi,KALIABOR,INC,0,Post Graduate,5473199,1042133,4431066
1892,1791,Goutam Bhattacharya,DARJEELING,SUCI(C),0,10th Pass,1201800,0,1201800
1893,2250,Goutam Malakar,KARIMGANJ,IND,0,8th Pass,242000,0,242000
1894,1424,Goutam Shriram Wasnik,RAMTEK,IND,0,8th Pass,764000,0,764000
1895,3756,Govind,BIDAR,SP,0,10th Pass,43703163,2740661,40962502
1896,1990,Govind Gaude,SOUTH GOA,IND,4,Others,5478000,650000,4828000
1897,2423,Govind Kumar Bairwa,BHILWARA,BSP,0,8th Pass,2470000,0,2470000
1898,5135,Govind Prasad,TONK-SAWAI MADHOPUR,IND,0,8th Pass,265000,0,265000
1899,3000,Govind Singh Rajput,SAGAR,INC,1,Post Graduate,30758478,2458028,28300450
1900,5613,Govinda Narayan Gunjal,RAVER,IND,0,Graduate Professional,484400,0,484400
1901,7408,"Govindan, C.",VELLORE,IND,0,Illiterate,250000,0,250000
1902,4295,Govindaraju K,SALEM,IND,0,8th Pass,1745550,78214,1667336
1903,3295,Govindarju.G,TUMKUR,IND,0,10th Pass,3285000,50000,3235000
1904,3805,Govindhareddy Pacharalli,KOPPAL,IND,0,Graduate,120000,30000,90000
1905,6504,Govindji Okhaji Thakor,PATAN,JD(U),1,5th Pass,1891361,0,1891361
1906,7064,Gowda.Nsm,KRISHNAGIRI,JD(S),0,Graduate,682247,0,682247
1907,3946,Gowrimani.S,KARUR,IND,0,5th Pass,8750000,500000,8250000
1908,3303,Granthi Narendrasingh Anmolsingh,NANDED,AAP,0,Graduate,14385756,36503,14349253
1909,1713,Grisa Kumar,GAUTAM BUDHHA NAGAR,IND,0,8th Pass,828000,0,828000
1910,6376,Guahati Motilal,BHONGIR,All India Majlis-E-Ittehadul Muslimeen,2,Literate,7493876,0,7493876
1911,4520,Guduru Janardhan Reddy,BHONGIR,Jai Samaikyandhra Party,0,10th Pass,2223000,1550000,673000
1912,227,Gufran Ahamad,MUZAFFARNAGAR,IND,0,12th Pass,2054600,125000,1929600
1913,7957,Gugulothu Ranjith Kumar,KHAMMAM,IND,0,Literate,270000,0,270000
1914,7958,Gugulothu Sarvan,KHAMMAM,IND,0,Literate,270000,0,270000
1915,7940,Gugulotu Jagan,MAHABUBABAD,Marxist Communist Party of India (United),0,8th Pass,685000,400000,285000
1916,2431,Gulab Chand Sahlot,CHITTORGARH,IND,0,10th Pass,1087100,0,1087100
1917,2925,Gulab Khan,DAMOH,IND,0,Post Graduate,432000,0,432000
1918,2045,Gulab Singh,SONIPAT,POORVANCHAL RASHTRIYA CONGRESS,0,Graduate,53952000,0,53952000
1919,2456,Gulam Farid,RAJSAMAND,SP,0,8th Pass,858960,148000,710960
1920,2340,Gulam Nabi,SIKAR,BSP,0,12th Pass,6711505,293515,6417990
1921,6191,Guljar Kumar,MADHEPURA,BSP,0,Graduate,35,0,35
1922,589,Gulkirat Kaur Panag,CHANDIGARH,AAP,0,Post Graduate,129508000,2164000,127344000
1923,600,Gullihatty. D. Shekhar,CHITRADURGA,JD(S),1,Graduate,7903095,682408,7220687
1924,3620,Gulmir Khan,PARBHANI,BSP,2,8th Pass,270000,0,270000
1925,875,Gumjum Haider,ARUNACHAL WEST,AITC,0,Graduate,8808016,0,8808016
1926,7475,Gunasekaran P,SIVAGANGA,IND,0,10th Pass,0,0,0
1927,6999,Gunasekaran T.K,ERODE,United Communist Party of India,0,10th Pass,21195000,5200000,15995000
1928,7109,"Gunasekaran, K.",NILGIRIS,RPI(A),0,12th Pass,87000,0,87000
1929,7570,Gunasekaran.K.,TENKASI,Tamil Nadu Makkal Congress,0,10th Pass,123000,0,123000
1930,7082,Gunasekaran.N,MAYILADUTHURAI,IND,0,Graduate,55500,0,55500
1931,5670,Gunasekaran.S,NAMAKKAL,IND,4,8th Pass,480184,81600,398584
1932,7463,Gunasekaran.T,THANJAVUR,IND,0,Graduate,5050,0,5050
1933,3922,Gundesh Khambra,BHOPAL,IND,0,10th Pass,179000,0,179000
1934,511,Gunin Basumatari,JORHAT,SP,0,Graduate Professional,10322068,217200,10104868
1935,7934,Gunnam Nagi Reddy,NALGONDA,Yuvajana Sramika Rythu Congress Party,0,Graduate,8861773,0,8861773
1936,547,Gunwant Sudamrao Devpare,AMRAVATI,BSP,0,Others,209390631,23488366,185902265
1937,7209,Gupta Kanhaiyalal Rajaram,MUMBAI NORTH CENTRAL,IND,0,5th Pass,16996369,0,16996369
1938,7859,Gurbhej Singh,PATIALA,IND,0,10th Pass,7500,0,7500
1939,6124,Gurcharan Singh,BATHINDA,IND,0,10th Pass,140000,0,140000
1940,6130,Gurcharan Singh,FARIDKOT,Republican Party of India,0,10th Pass,805000,0,805000
1941,7805,Gurdeep Singh,BATHINDA,Indian Krantikari Lehar,0,Illiterate,570000,0,570000
1942,7826,Gurdeep Singh,SANGRUR,Democratic Bharatiya Samaj Party,0,10th Pass,812000,0,812000
1943,7774,Gurdeep Singh,FATEHGARH SAHIB,Inqalab Vikas Dal,0,10th Pass,335519,0,335519
1944,7763,Gurdeep Singh Kahlon,LUDHIANA,IND,2,Graduate Professional,9975000,70000,9905000
1945,7668,Gurdial Singh Gill,AMRITSAR,Democratic Bharatiya Samaj Party,0,10th Pass,200000,0,200000
1946,7795,Gurjant Singh,FIROZPUR,IND,0,Literate,618766,0,618766
1947,2826,Gurjeet Singh,GIRIDIH,AAP,0,Post Graduate,3182920,237000,2945920
1948,1036,Gurmeet Singh,KURUKSHETRA,Lok Dal,0,Graduate,3125677,69000,3056677
1949,7744,Gurmeet Singh,ANANDPUR SAHIB,IND,0,8th Pass,4097703,300000,3797703
1950,7660,Gurmeet Singh Bakhatpura,GURDASPUR,CPI(ML)L,0,12th Pass,3700000,200000,3500000
1951,7806,Gurmeet Singh Ranghreta,BATHINDA,Punjab Labour Party,1,12th Pass,3574000,100000,3474000
1952,7692,Gurnam Singh,KHADOOR SAHIB,IND,1,10th Pass,474040,0,474040
1953,7743,Gurnam Singh,ANANDPUR SAHIB,IND,0,Post Graduate,981975,100000,881975
1954,1498,Gurnule Ramesh Vithoba,YAVATMAL-WASHIM,IND,0,8th Pass,85000,530,84470
1955,7686,Gurpal Singh,KHADOOR SAHIB,All India Mazdoor Party (Rangreta),0,5th Pass,2027000,0,2027000
1956,7852,Gurpreet Singh,PATIALA,Bahujan Samaj Party (Ambedkar),0,5th Pass,1070000,0,1070000
1957,7827,Gurpreet Singh,SANGRUR,CPI(ML)L,0,5th Pass,15350,0,15350
1958,7659,Gurpreet Singh Khanna,GURDASPUR,Bharatiya Gaon Taj Dal,0,Graduate,1654228,0,1654228
1959,878,Gursagar Singh,JAMMU,Socialistic Democratic Party,0,12th Pass,19540000,3350000,16190000
1960,7742,Gursharn Singh Panesar,ANANDPUR SAHIB,IND,0,Post Graduate,4630000,0,4630000
1961,3711,Guru Prasad Pradhan,DHENKANAL,IND,0,Graduate Professional,1157381,0,1157381
1962,1428,Gurudas Uddhav Bawane,RAMTEK,IND,0,12th Pass,3742000,820000,2922000
1963,2230,Gurudeva S H,UDUPI CHIKMAGALUR,AAP,0,Graduate Professional,6971500,250000,6721500
1964,6835,Gurujada Beeraiah,MEDAK,IND,1,12th Pass,6200000,0,6200000
1965,2188,Gurushantappa Chalwadi,DHARWAD,RPI(A),0,10th Pass,320255,0,320255
1966,3757,Guruswamy B,CHAMARAJANAGAR,SP,0,Graduate Professional,11061200,995250,10065950
1967,4547,Gutha Sukhender Reddy,NALGONDA,INC,1,12th Pass,85907866,10103677,75804189
1968,791,Gyan Chand,BARGARH,BSP,0,5th Pass,7854072,0,7854072
1969,3765,H D Kumara Swamy,CHIKKBALLAPUR,JD(S),1,Graduate,1677777589,729603654,948173935
1970,2626,H N Ramakrishna Reddy,CHIKKBALLAPUR,Pyramid Party of India,0,10th Pass,2626000,674000,1952000
1971,3960,H Raja,SIVAGANGA,BJP,0,Graduate Professional,9313714,2094707,7219007
1972,2592,H. Siddagangappa,CHITRADURGA,Ambedkar National Congress,0,12th Pass,209000,1150000,0
1973,2225,H. Suresh Poojari,SHIMOGA,IND,0,5th Pass,26000,0,26000
1974,7926,H.A. Rahman,MAHBUBNAGAR,Yuvajana Sramika Rythu Congress Party,3,Graduate,45000,0,45000
1975,3400,H.B.P. Ajay Sahebrao Baraskar Maharaj,AHMEDNAGAR,Bahujan Mukti Party,2,12th Pass,11185018,442109,10742909
1976,2613,H.D. Devegowda,HASSAN,JD(S),0,Graduate Professional,42721242,8648283,34072959
1977,2614,H.D. Revanna,HASSAN,Karunaadu Party,0,10th Pass,483000,50000,433000
1978,2214,H.K. Kenchveerappa,DAVANAGERE,Vichara Jagruthi Congress Paksha,1,10th Pass,4359500,50000,4309500
1979,1003,H.K. Mahendru,NORTH EAST DELHI,IND,0,8th Pass,41985,0,41985
1980,2201,H.K. Ramachandrappa,DAVANAGERE,CPI,0,10th Pass,3180981,0,3180981
1981,2566,H.K.Krishna,MANDYA,Karunaadu Party,0,Graduate,390000,0,390000
1982,3736,H.L. Manjunatha,BANGALORE CENTRAL,Kannada Chalavali Vatal Paksha,0,12th Pass,6000,0,6000
1983,2576,H.L.Mohan Kumar,TUMKUR,Hindustan Janta Party,0,8th Pass,978000,400000,578000
1984,3792,H.N.Narayanaswamy,KOLAR,IND,0,10th Pass,335000,100000,235000
1985,6297,H.Senthilkumar,ARANI,IND,0,10th Pass,5287542,0,5287542
1986,3796,H.V.Anjappa,KOLAR,IND,0,Post Graduate,5141000,0,5141000
1987,951,Habung Payeng,ARUNACHAL WEST,AAP,0,Post Graduate,14587055,0,14587055
1988,847,Hadapad Basavaraj,UTTARA KANNADA,Rani Chennamma Party,1,12th Pass,410000,0,410000
1989,1284,Hafiz Mustaq,SOUTH DELHI,Jan Samanta Party,0,Illiterate,430000,0,430000
1990,6772,Haidar,JHANJHARPUR,VANCHITSAMAJ INSAAF PARTY,3,Others,640000,0,640000
1991,7194,Haji Akhtar Paperwala,MUMBAI NORTH,IND,0,10th Pass,5401000,750000,4651000
1992,474,Haji Jainul Abedin,CHATRA,BSP,0,Graduate,15758303,0,15758303
1993,3123,Haji Mohd Yaqoob,MORADABAD,BSP,2,8th Pass,68484555,575735,67908820
1994,1910,Haji Moideen Shah,THRISSUR,JD(U),0,Others,2100000,0,2100000
1995,2903,Hakim Singh,BHIND,IND,0,10th Pass,741417,0,741417
1996,5051,Hakim Singh,MAINPURI,IND,0,12th Pass,18326297,0,18326297
1997,2175,Halappa Doddaneelappa Timmenahalli,HAVERI,BSP,0,Graduate,1080000,200000,880000
1998,5886,Hameed Mohammad Gulamhussain Sayyed,KALYAN,SP,0,8th Pass,76138101,15207081,60931020
1999,95,Hamid Khan,FARIDABAD,Hindustan Kranti Dal,0,Graduate,5219608,49608,5170000
2000,2603,Haneef Khan,DAKSHINA KANNADA,SDPI,0,10th Pass,1703900,0,1703900
2001,2107,Hanmant Krishna Majukar,BELGAUM,IND,0,10th Pass,12403000,0,12403000
2002,1841,Hanmanth Holer,BIJAPUR,IND,1,12th Pass,141500,0,141500
2003,5764,Hans Mukhi,MISRIKH,IND,0,8th Pass,1492126,115000,1377126
2004,4958,Hansh Mukhi,ETAWAH,INC,0,Post Graduate,11522942,0,11522942
2005,4949,Hanshraj Singh,ETAH,AAP,0,8th Pass,8515861,400000,8115861
2006,204,Hansraj,HISAR,IND,0,12th Pass,60000,0,60000
2007,2001,Hansraj Hansa,SIRSA,Jan Morcha,0,12th Pass,77000,0,77000
2008,1748,Hansraj Saini,SAHARANPUR,IND,0,Graduate Professional,3411840,42000,3369840
2009,3462,Hanuman Beniwal,NAGAUR,IND,1,Graduate Professional,3309739,0,3309739
2010,3457,Hanumanram,NAGAUR,AAP,0,Graduate Professional,3023141,80027,2943114
2011,598,Hanumantappa Kabbar,HAVERI,IND,0,Graduate,1600000,0,1600000
2012,2191,Hanumantappa Mallappa Bankapur,DHARWAD,JD(S),0,8th Pass,25257819,1710000,23547819
2013,3317,Hanumante Dhondopant Nagorao,NANDED,Rashtriya Kisan Congress Party,0,Post Graduate,1075000,26000,1049000
2014,3325,Hanumante Vijay Chandrao,NANDED,IND,0,8th Pass,86000,0,86000
2015,7845,Hanumanth Rao Mynampally,MALKAJGIRI,TRS,2,Graduate Professional,74860123,9600000,65260123
2016,3070,Har Bhagwan,BADAUN,IND,0,Graduate,6395670,44625,6351045
2017,1303,Har Gobind Arora,WEST DELHI,SHS,1,12th Pass,6189246,0,6189246
2018,4651,Harbhajan Singh,KORBA,IND,0,12th Pass,1341613,0,1341613
2019,6113,Harcharan Singh,ANANDPUR SAHIB,IND,0,Graduate,4000000,0,4000000
2020,3032,Harekrishna Sarkar,JALPAIGURI,RPI(A),0,Post Graduate,962066,665800,296266
2021,1771,Harekrishna Sarkar,COOCHBEHAR,RPI(A),0,Post Graduate,1562066,665800,896266
2022,1888,Hari Arumbil,PALAKKAD,BSP,0,12th Pass,415000,80000,335000
2023,877,Hari Chand Jalmeria,JAMMU,JKNPP,0,Graduate Professional,4004437,500000,3504437
2024,3929,Hari G,ARAKKONAM,AIADMK,4,Post Graduate,32966706,0,32966706
2025,6756,Hari Kant Prasad,BEGUSARAI,Bharatiya Bahujan Congress,0,10th Pass,1951470,90000,1861470
2026,155,Hari Manjhi,GAYA,BJP,1,8th Pass,10184120,2000000,8184120
2027,2459,Hari Om Singh Rathore,RAJSAMAND,BJP,0,Graduate,188310824,2728752,185582072
2028,448,Hari Parkash,SONIPAT,SUCI(C),0,10th Pass,5588154,0,5588154
2029,5077,Hari Prasad,ALWAR,IND,0,Post Graduate,707938,0,707938
2030,5124,Hari Ram,TONK-SAWAI MADHOPUR,IND,0,Graduate,112200,0,112200
2031,5748,Hari Ram,LUCKNOW,Samyak Parivartan Party,0,12th Pass,1179873,0,1179873
2032,7754,Hari Ram Sahni,LUDHIANA,AIFB,1,8th Pass,4382738,0,4382738
2033,5084,Hari Singh Sharma,ALWAR,IND,0,8th Pass,516000,0,516000
2034,2851,Hari Uraon,JAMSHEDPUR,IND,0,12th Pass,819405,122000,697405
2035,6263,"Hari, S.",ARAKKONAM,IND,0,10th Pass,233800,0,233800
2036,6262,"Hari, S.",ARAKKONAM,IND,0,10th Pass,422300,0,422300
2037,1781,Haribhakta Sardar,JALPAIGURI,SUCI(C),1,10th Pass,1048500,70,1048430
2038,5986,Haribhau Soma Vartha,PALGHAR,IND,0,5th Pass,758500,0,758500
2039,820,Harihara Karana,KANDHAMAL,INC,0,Post Graduate,96350411,269368,96081043
2040,6264,"Harikrishnan, P.",ARAKKONAM,IND,0,Not Given,100000,0,100000
2041,7355,Harilal Ranchodbhai Chauhan,JUNAGADH,IND,0,Graduate Professional,619375,0,619375
2042,5766,Harinam,MISRIKH,Socialist Party (India),0,10th Pass,632030,0,632030
2043,6236,Harinarayan Yadav,MADHUBANI,BSP,1,10th Pass,12547000,25000,12522000
2044,7833,Harinder Kumar,SANGRUR,IND,0,8th Pass,9508574,0,9508574
2045,6141,Harinder Singh Khalsa,FATEHGARH SAHIB,AAP,0,Post Graduate,35588128,6700000,28888128
2046,3120,Hariom,MORADABAD,Naya Daur Party,0,12th Pass,3270600,0,3270600
2047,973,Hariom Sharma,CHANDNI CHOWK,AITC,0,10th Pass,23010474,3391550,19618924
2048,3299,Haripada Barman,JALPAIGURI,Rashtriya Janasachetan Party,0,12th Pass,239580,0,239580
2049,518,Hariprasad Dihingia,LAKHIMPUR,AGP,2,10th Pass,80659606,1997168,78662438
2050,3463,Hariram,NAGAUR,IND,0,8th Pass,1420000,0,1420000
2051,3458,Hariram Mehrada,NAGAUR,Bahujan Sangharshh Dal,0,Post Graduate,480500,0,480500
2052,4237,Harish Chandra,DAUSA,BJP,0,Graduate,60394789,45000,60349789
2053,2473,Harish Chaudhary,BARMER,INC,0,Post Graduate,8822577,2407054,6415523
2054,7851,Harish Kumar,PATIALA,SHS,0,8th Pass,1807873,0,1807873
2055,2445,Harish Rawat,BANSWARA,AAP,0,10th Pass,1941143,0,1941143
2056,5189,Harishchandra Dattu Patil,BHIWANDI,IND,0,Graduate,4851734,975000,3876734
2057,1328,Harkrishan Das Nijhawan,NEW DELHI,IND,1,12th Pass,29194281,572550,28621731
2058,7681,Harminder Singh Gill,KHADOOR SAHIB,INC,0,Post Graduate,29131071,3128091,26002980
2059,7773,Harpreet Singh,FATEHGARH SAHIB,Bahujan Mukti Party,0,12th Pass,10000,0,10000
2060,1370,Harsh Kumar,NORTH EAST DELHI,IND,0,Graduate Professional,466633,0,466633
2061,7800,Harsimrat Kaur Badal,BATHINDA,SAD,0,10th Pass,1081664910,412634299,669030611
2062,1726,Harveer,BULANDSHAHR,IND,0,12th Pass,608000,0,608000
2063,4959,Harvilas Doharey,ETAWAH,Bahujan Mukti Party,0,Graduate Professional,6492000,140000,6352000
2064,7753,Harvinder Singh Phoolka,LUDHIANA,AAP,0,Graduate Professional,108596036,10210645,98385391
2065,2169,Hasan Ali Sirquazi,HAVERI,AAP,0,Post Graduate,3439291,800000,2639291
2066,4086,Hasnein Raza,AMROHA,New All India Congress Party,1,5th Pass,588000,0,588000
2067,7229,Hayat Abdullah Shaikh,MUMBAI NORTH EAST,IUML,0,Illiterate,39907,0,39907
2068,2460,Heera Alias Heera Bhai Kathat,RAJSAMAND,IND,0,Literate,885000,50000,835000
2069,550,Hem Chandra Barman,COOCHBEHAR,BJP,0,12th Pass,5092000,1050000,4042000
2070,516,Hem Kanta Miri,LAKHIMPUR,SUCI(C),0,Graduate Professional,69500,0,69500
2071,3065,Hema Mehra,BADAUN,AAP,0,10th Pass,103368000,0,103368000
2072,837,Hemanand Biswal,SUNDARGARH,INC,0,12th Pass,20107728,1300000,18807728
2073,2080,Hemant Kumar Saini,GURGAON,Bahujan Mukti Party,0,10th Pass,15206538,1008079,14198459
2074,3903,Hemant Pradhan,MAHASAMUND,IND,0,8th Pass,219000,0,219000
2075,1166,Hemendra Chandra Singh,KANDHAMAL,BJD,2,Graduate,503907437,4786551,499120886
2076,4421,Hemendraveer Singh,MATHURA,Sarva Samaj Kalyan Party,0,Post Graduate,143500,0,143500
2077,4948,Hemendraveer Singh,ETAH,Sarva Samaj Kalyan Party,0,Post Graduate,143500,0,143500
2078,2792,Hemlal Markam,KANKER,GGP,1,Graduate,967000,0,967000
2079,4169,Hemlal Murmu,RAJMAHAL,BJP,0,Graduate,41894447,13010487,28883960
2080,4156,Hemlata S. Mohan,DHANBAD,AJSUP,0,Doctorate,30794844,2087939,28706905
2081,4756,Hemraj Singh,DEWAS,Bahujan Sangharshh Dal,0,Post Graduate,65000,0,65000
2082,4810,Henary,RATLAM,AAP,0,Graduate,107000,0,107000
2083,2286,Hetram,GANGANAGAR,Rajasthan Vikas Party,0,Literate,965000,80000,885000
2084,6683,Himmat Lal,KANPUR,Akhil Bharatiya Rajarya Sabha,0,Graduate Professional,30630000,0,30630000
2085,6108,Himmat Singh Shergill,ANANDPUR SAHIB,AAP,0,Graduate Professional,44487450,10975665,33511785
2086,132,Hina Likhiram Kawre,BALAGHAT,INC,0,Post Graduate,4804487,0,4804487
2087,5016,Hira Lal Verma,HARDOI,AAP,0,Post Graduate,6019712,500000,5519712
2088,2949,Hiraday Narayan Singh Tomar,GWALIOR,Akhil Bharat Hindu Mahasabha,0,10th Pass,398500,0,398500
2089,4710,Hiralal Sankhwar,DHANBAD,Jharkhand Party,0,Post Graduate,3422500,0,3422500
2090,520,Hiramoni Deka Sonowal,LAKHIMPUR,AAP,0,Doctorate,192000,0,192000
2091,763,Hirasan Uikey,BALAGHAT,GGP,0,Graduate Professional,3765446,200000,3565446
2092,4653,Hirasingh Markam,KORBA,GGP,3,Post Graduate,700304,0,700304
2093,4610,Hirji Punjabhai Siju,KACHCHH,Bahujan Mukti Party,0,10th Pass,5003935,570200,4433735
2094,1769,Hitendra Das,COOCHBEHAR,IND,0,8th Pass,2546997,0,2546997
2095,3894,Hoke (Patil)Rajedra Achyutrao,BEED,IND,0,12th Pass,142000,60000,82000
2096,240,Horen Borgohain,JORHAT,AIFB,0,Post Graduate,3260000,800,3259200
2097,4622,Hori Lal Yadav,RAIPUR,IND,2,Illiterate,8064318,26318,8038000
2098,6760,Hriday Narayun Yadav,DARBHANGA,CPI(M),2,8th Pass,7363000,51576,7311424
2099,522,Hrishikesh Baruah,LAKHIMPUR,IND,0,Post Graduate,9000,0,9000
2100,6237,Hukum Deo Narayan Yadav,MADHUBANI,BJP,0,Graduate,115196945,0,115196945
2101,655,Hukum Singh,KAIRANA,BJP,2,Graduate Professional,29078847,2941671,26137176
2102,3033,Humera Akhtar,AMROHA,SP,0,12th Pass,14344567,50000,14294567
2103,2545,Hunashyal Ravi,BAGALKOT,JD(S),0,Graduate,9950000,812000,9138000
2104,2557,Hunsur K Chandrashekar,MYSORE,Democratic Prajakranthi Party Secularist,1,Post Graduate,4106000,0,4106000
2105,5933,Hussain Akbar Sayyed,MUMBAI SOUTH CENTRAL,Bahujan Mukti Party,0,5th Pass,8871653,480000,8391653
2106,7080,Hyder Ali.S,MAYILADUTHURAI,Manithaneya Makkal Katchi,1,10th Pass,11248827,0,11248827
2107,5571,I. Senthilkumar,PONDICHERRY,IND,2,8th Pass,41165,0,41165
2108,6183,Ibrahim Abbasi,JHANJHARPUR,IND,0,5th Pass,555764,0,555764
2109,7927,"Ibrahim Syed	",MAHBUBNAGAR,IND,7,12th Pass,310625000,56406000,254219000
2110,2466,Idrish Mohammad,RAJSAMAND,Jago Party,0,8th Pass,2682000,0,2682000
2111,2391,Iftekar Qureshi,JAIPUR,AIFB,0,Literate,52100,0,52100
2112,2402,Ijyaraj Singh,KOTA,INC,0,Post Graduate,280354736,0,280354736
2113,4808,Iliyas Bhai Machar,RATLAM,Minorities Democratic Party,0,8th Pass,1213500,700000,513500
2114,1874,Illyas,MALAPPURAM,BSP,0,10th Pass,988156,44000,944156
2115,2184,Imamsab. Toragal.,DHARWAD,IND,0,10th Pass,80000,0,80000
2116,4972,Imamuddin Husain Husain,FARRUKHABAD,IND,0,10th Pass,2560296,0,2560296
2117,2996,Imamuddin Khan,RAJGARH,IND,0,Graduate,1882500,70000,1812500
2118,4368,Imanuyel Hemram,MALDAHA UTTAR,Jharkhand Disom Party,0,10th Pass,64000,0,64000
2119,2895,Imarti Devi,BHIND,INC,0,12th Pass,12751000,1989540,10761460
2120,7397,"Imdad Shariff, A.",VELLORE,AAP,0,Post Graduate,23968,0,23968
2121,4081,Imran,KHAJURAHO,Peace Party,0,Graduate,391000,0,391000
2122,559,Imran Ali,KARAKAT,IND,0,Graduate,7845,0,7845
2123,5039,Imran Bin Zafar,KANNAUJ,AAP,0,Graduate,1514000,250000,1264000
2124,684,Imran Masood,SAHARANPUR,INC,5,12th Pass,47166093,2012262,45153831
2125,4623,Imrram Pasha,RAIPUR,Aazadi Ka Antim Aandolan Dal,0,12th Pass,217878947,0,217878947
2126,3824,Imtiaz Ahmed Mollah,MALDAHA DAKSHIN,SDPI,0,12th Pass,74000,57000,17000
2127,3374,Imtiyaz Peerzade,PUNE,BSP,0,Graduate,83320451,7500000,75820451
2128,1309,Inder Singh,NORTH WEST DELHI,Asankhya Samaj Party,0,10th Pass,2437000,0,2437000
2129,1573,Inder Singh Uikey,MANDLA,Ambedkarite Party of India,0,12th Pass,195000,0,195000
2130,4468,Inderaj Singh Saini,BANKA,IND,0,10th Pass,11918305,2000000,9918305
2131,1046,Inderjit Singh,GURGAON,BJP,0,Graduate Professional,250698763,0,250698763
2132,3484,Indira Oinam,INNER MANIPUR,IND,0,Graduate,948604,0,948604
2133,390,Indra Deo Choudhary,GAYA,Bahujan Mukti Party,0,10th Pass,507000,10000,497000
2134,4471,Indradeo Kumar Singh,BHAGALPUR,IND,0,Graduate Professional,3312913,0,3312913
2135,740,Indrajeet Kumar,SIDHI,INC,0,Graduate,62690091,2494561,60195530
2136,2315,Indrasingh Jat,CHURU,CPI(M),0,Post Graduate,8543953,0,8543953
2137,2655,Indu Singh,BUXAR,CPI(ML)L,0,Graduate Professional,10215879,0,10215879
2138,542,Ingle Krushanarao Ganpatrao,BULDHANA,NCP,0,Graduate,63065868,25092634,37973234
2139,7514,"Iniyavan, R.",THENI,IND,1,12th Pass,152000,31456,120544
2140,6462,Injam Venkata Swamy,PEDDAPALLE,Mahajana Socialist Party,0,Post Graduate,50000,0,50000
2141,7515,"Innasimuthu, M.S.",THENI,IND,0,8th Pass,480639,0,480639
2142,290,Innocent,CHALAKUDY,IND,0,8th Pass,54474761,1303000,53171761
2143,7841,Iqbal Ali Zafar,MEDAK,Majlis Bachao Tahreek,0,Graduate Professional,3330000,450000,2880000
2144,1637,Iqra Chaudhry,MEERUT,IND,0,Not Given,400000,0,400000
2145,3776,Irappa Bharamappa Madar,DHARWAD,BSP,0,10th Pass,585029,80000,505029
2146,2187,Irashadbegum. Adhoni.,DHARWAD,IND,0,10th Pass,36000,0,36000
2147,2930,Irfan Khan,DAMOH,IND,2,8th Pass,161000,0,161000
2148,6525,Irfanshah Habibshah Suharavardi,PORBANDAR,SP,0,10th Pass,50000,0,50000
2149,3062,Irshad Ali Ansari,AONLA,Peace Party,0,Post Graduate,2979192,0,2979192
2150,7079,Irulappan.V,MAYILADUTHURAI,SP,0,Post Graduate,10526000,0,10526000
2151,4779,Isamuddin Saiyyed,KHANDWA,Samata Party,1,Literate,16436850,0,16436850
2152,551,Ishabela Kujur,ALIPURDUARS,Rashtriya Janadhikar Suraksha Party,0,Graduate,88500,0,88500
2153,5838,Ishwar Dayaram More,JALGAON,Bahujan Mukti Party,2,Graduate,5390000,0,5390000
2154,2543,Ishwar Lahanu Nandagawali,BHANDARA-GONDIYA,IND,0,10th Pass,111000,0,111000
2155,1020,Ishwar Singh,AMBALA,IND,0,5th Pass,6084400,37741,6046659
2156,4861,Ismail Hussain,BARPETA,INC,0,Post Graduate,18415063,0,18415063
2157,3737,Ismail Khan Saif Ali,BANGALORE CENTRAL,AITC,0,12th Pass,97238300,0,97238300
2158,281,Ismail P.,MALAPPURAM,Welfare Party Of India,0,Post Graduate,9524919,0,9524919
2159,2144,Ismail Zabi Ullah,BIDAR,IND,0,Graduate,76000,0,76000
2160,4802,Ismile,MANDSOUR,IND,0,5th Pass,30000,0,30000
2161,1308,Istak Khan,WEST DELHI,IND,0,5th Pass,300000,0,300000
2162,6013,Iswar Chandra Das,BARDHAMAN PURBA,CPI(M),2,Post Graduate,2916023,128681,2787342
2163,1057,Ivoryna Shylla,SHILLONG,IND,0,10th Pass,23050000,0,23050000
2164,2910,J C Barai,BHOPAL,SUCI(C),0,10th Pass,3397000,0,3397000
2165,2516,J Nataraju,BANGALORE RURAL,IND,0,10th Pass,1912959,330000,1582959
2166,347,J Sudhakaran,THIRUVANANTHAPURAM,BSP,0,Post Graduate,40695000,2000000,38695000
2167,6849,J. Constandine Ravindran,CHENNAI CENTRAL,DMDK,1,Post Graduate,8690436,2610881,6079555
2168,5589,J. Dhandapani,PONDICHERRY,IND,1,Post Graduate,2802323,270000,2532323
2169,6847,J. Prabhakar,CHENNAI CENTRAL,AAP,0,10th Pass,5085238,135000,4950238
2170,1092,J. T.Prakash,BANGALORE RURAL,IND,0,Graduate,4854168,0,4854168
2171,7423,J.Laxmi,TIRUPPUR,CPI(ML) Red Star,0,8th Pass,3788740,1181573,2607167
2172,7491,J.Manikandeswaran,MADURAI,IND,0,Post Graduate,488000,40000,448000
2173,6444,J.Ramulu,SECUNDERABAD,Revolutionary Socialist Party,0,Post Graduate,404000,0,404000
2174,6931,J.S. Mahalingam,CHENNAI SOUTH,IND,0,Graduate Professional,142321,0,142321
2175,6463,J.V. Raju,PEDDAPALLE,New India Party,0,12th Pass,150000,0,150000
2176,6591,Jadav Ambalal Kanabhai,VADODARA,JD(U),0,Graduate Professional,1535000,60000,1475000
2177,7272,Jadav Mustakbhai Rehmanbhai,AMRELI,IND,0,Literate,107000,0,107000
2178,4902,Jadeja Kandhalbhai Sarmanbhai,PORBANDAR,NCP,9,8th Pass,283945804,4641521,279304283
2179,3509,Jadhav Chunnilal Mohan,HINGOLI,BSP,0,Graduate Professional,8401100,0,8401100
2180,777,Jadhav Prataprao Ganpatrao,BULDHANA,SHS,2,12th Pass,36033147,684092,35349055
2181,5164,Jadhav Pushpa Shantilal,AURANGABAD,Ambedkar National Congress,0,Illiterate,294744,0,294744
2182,3621,Jadhav Sanjay (Bandu) Haribhau,PARBHANI,SHS,7,10th Pass,31016711,5976851,25039860
2183,3572,Jadhav Sunil Gunda,MADHA,IND,0,8th Pass,255987,0,255987
2184,5964,Jadhav Vishnu Ramdas,NASHIK,IND,0,5th Pass,663219,0,663219
2185,5209,Jafar Bapuji Pathan,DHULE,IND,0,Literate,1415000,0,1415000
2186,970,Jag Mohan Singh Bakshi,CHANDNI CHOWK,Atulya Bharat Party,0,12th Pass,60404560,4500000,55904560
2187,2654,Jagadanand Singh,BUXAR,RJD,0,Graduate Professional,20142620,0,20142620
2188,6972,"Jagadeeswaran, S.",COIMBATORE,Ulzaipali Makkal Katchy,0,10th Pass,161000,15000,146000
2189,7713,Jagan Nath Bajwa,JALANDHAR,IND,0,5th Pass,676376,109763,566613
2190,3245,Jagannath Das,BALASORE,IND,0,Graduate,396000,0,396000
2191,1359,Jagannath Tiwari,EAST DELHI,IND,0,12th Pass,1476456,43236,1433220
2192,2815,Jagarnath Mahto,GIRIDIH,JMM,4,10th Pass,5992366,454475,5537891
2193,3224,Jagat Mohan Naik,KEONJHAR,BSP,0,10th Pass,170700,10000,160700
2194,7374,"Jagathrakshakan, S. Thiru",SRIPERUMBUDUR,DMK,0,10th Pass,780453455,47551938,732901517
2195,4579,Jagatsinh Laljibhai Vasava,BARDOLI,JD(U),2,Graduate Professional,51129838,4451070,46678768
2196,2047,Jagbir,SONIPAT,IND,0,8th Pass,415316,0,415316
2197,665,Jagbir Singh,MUZAFFARNAGAR,IND,0,Graduate Professional,19380034,1100000,18280034
2198,207,Jagbir Singh Malik,SONIPAT,INC,0,Graduate Professional,69917201,2154569,67762632
2199,2036,Jagbir Singh Rana,KARNAL,IND,0,Post Graduate,54297291,2759783,51537508
2200,5217,Jagdane Ramesh Soma,DHULE,Maharashtra Parivartan Sena (T),0,Literate,150000,0,150000
2201,7815,Jagdeep Singh,BATHINDA,IND,0,Post Graduate,2710473,1084798,1625675
2202,7816,Jagdeep Singh Gehri,BATHINDA,IND,0,10th Pass,160000,0,160000
2203,2963,Jagdeesh Kumar Patel,KHAJURAHO,Apna Dal,0,12th Pass,11500,0,11500
2204,5165,Jagdip Vishwanath Shinde,AURANGABAD,IND,0,Graduate Professional,21000,0,21000
2205,2002,Jagdish,SIRSA,IND,0,Graduate,759500,0,759500
2206,2035,Jagdish,KARNAL,IND,0,Illiterate,4778000,60000,4718000
2207,3410,Jagdish,AJMER,BSP,0,10th Pass,3157459,0,3157459
2208,3467,Jagdish,PALI,Bahujan Mukti Party,0,5th Pass,1311000,0,1311000
2209,217,Jagdish Bhagwan Kadu,WARDHA,IND,0,Graduate Professional,15288413,3305000,11983413
2210,6777,Jagdish Chandra Bashu,KHAGARIA,CPI(M),0,12th Pass,7069526,237000,6832526
2211,2305,Jagdish Kumar,BIKANER,IND,0,8th Pass,608500,0,608500
2212,3896,Jagdish Kumar,UDHAMPUR,Jai Maha Bharath Party,0,5th Pass,880000,0,880000
2213,5802,Jagdish Narayan Shukla,SITAPUR,AITC,0,Others,5241100,0,5241100
2214,2356,Jagdish Prasad,JAIPUR RURAL,Lok Dal,0,Literate,423000,0,423000
2215,5078,Jagdish Prasad Bairwa,ALWAR,IND,0,10th Pass,2659200,0,2659200
2216,5771,Jagdish Prasad Gautam,MOHANLALGANJ,Manavtawadi Samaj Party,0,Graduate,10289500,0,10289500
2217,4670,Jagdish Prasad Nirala,JANJGIR-CHAMPA,IND,0,8th Pass,175177,0,175177
2218,6125,Jagdish Rai Sharma,BATHINDA,Nav Bharat Democratic Party,1,Post Graduate,9563000,362000,9201000
2219,3184,Jagdish Saran Sagar,RAMPUR,IND,0,5th Pass,1705000,0,1705000
2220,734,Jagdish Singh,SATNA,AAP,2,Graduate,58152000,630000,57522000
2221,683,Jagdish Singh Rana,SAHARANPUR,BSP,0,Graduate,72148732,4290563,67858169
2222,3418,Jagdish Singh Rawat,AJMER,IND,0,5th Pass,520000,0,520000
2223,5310,Jagdishbhai Amrabhai Vegad,BHAVNAGAR,IND,0,5th Pass,36500,0,36500
2224,1375,Jagjeet Singh,CHANDNI CHOWK,Bharatiya Gaon Taj Dal,0,10th Pass,353200,0,353200
2225,5139,Jagmohan,TONK-SAWAI MADHOPUR,National Peoples Party,0,Graduate,6059284,0,6059284
2226,3178,Jagmohan,RAMPUR,IND,0,8th Pass,3212000,0,3212000
2227,6734,Jagmohan Singh Verma,SITAPUR,AIFB,0,Doctorate,4562000,0,4562000
2228,6512,Jagrala Imran Mahemud,PATAN,IND,0,8th Pass,4219599,1914236,2305363
2229,3363,Jagtap Laxman Murlidhar,MAVAL,IND,0,8th Pass,87461,0,87461
2230,3358,Jagtap Laxman Pandurang,MAVAL,Peasants And Workers Party of India,3,10th Pass,63729286,2417066,61312220
2231,3364,Jagtap Laxman Sitaram,MAVAL,IND,0,5th Pass,2210100,0,2210100
2232,3571,Jagtap Nitin Maruti,MADHA,IND,0,8th Pass,470000,180000,290000
2233,5923,Jaheda Mohammad Haneef Shaikh,MUMBAI SOUTH,IND,0,8th Pass,5200000,0,5200000
2234,6926,Jahir Hussain. M,CHENNAI SOUTH,AAP,0,10th Pass,15040363,1332793,13707570
2235,208,Jai Karan,ROHTAK,SUCI(C),0,Post Graduate,15703701,0,15703701
2236,7765,Jai Parkash Jain,LUDHIANA,IND,0,10th Pass,1034092,0,1034092
2237,5767,Jai Prakash,MISRIKH,SP,0,Graduate,35092803,1085766,34007037
2238,492,Jai Prakash Agarwal,NORTH EAST DELHI,INC,0,Graduate,83974848,0,83974848
2239,159,Jai Prakash Das,JAMUI,CPI(ML)L,0,8th Pass,143450,0,143450
2240,4118,Jai Prakash Nair,DURG,CPI(ML)L,0,12th Pass,299500,195000,104500
2241,2740,Jai Prakash Yadav,PATALIPUTRA,IND,0,Graduate Professional,1434000,0,1434000
2242,1352,Jai Ram Lal,EAST DELHI,JKNPP,0,10th Pass,4827000,15000,4812000
2243,4739,Jai Shankar Jha,GODDA,AAP,0,Post Graduate,2890000,187000,2703000
2244,2046,Jai Singh,SONIPAT,AAP,0,Post Graduate,246912638,12140161,234772477
2245,2058,Jai Singh,ROHTAK,IND,0,10th Pass,18187000,200000,17987000
2246,2938,Jaibhansingh Pawaiya,GUNA,BJP,1,Others,8860522,72000,8788522
2247,1249,Jaideo Choudhary,KODARMA,SP,2,10th Pass,4620269,28831,4591438
2248,5595,Jain Manish Ishwarlal,RAVER,NCP,7,Graduate,1515146765,606612400,908534365
2249,5615,Jain Manish Satish,RAVER,IND,1,10th Pass,24568000,698490,23869510
2250,5635,Jain Surendrakumar K.,THANE,Akhil Bharatiya Jan Sangh,0,10th Pass,4063705,0,4063705
2251,2507,Jain Wilson,THIRUVANANTHAPURAM,IND,0,Graduate,100000,0,100000
2252,6759,Jainath,DARBHANGA,Bahujan Mukti Party,0,10th Pass,3295482,0,3295482
2253,421,Jaipal Bhatti,SIRSA,IND,0,5th Pass,2300000,0,2300000
2254,7924,Jaipal Reddy Sudini,MAHBUBNAGAR,INC,0,Post Graduate,99602120,4600000,95002120
2255,3136,Jaipal Singh Saini,MORADABAD,SHS,0,12th Pass,36898000,40000,36858000
2256,4467,Jaiprakash Narayan Yadav,BANKA,RJD,2,Post Graduate,27846274,791539,27054735
2257,6315,Jaishankar.P.,CUDDALORE,IND,0,5th Pass,805979,900000,0
2258,4506,Jait Ram Khande,BILASPUR,IND,0,5th Pass,10058052,0,10058052
2259,4006,Jaitun Tuti,KHUNTI,IND,0,10th Pass,100000,0,100000
2260,4964,Jaiveer Singh,FARRUKHABAD,BSP,1,12th Pass,108959677,12165446,96794231
2261,1658,Jaivindra Kumar,BAGHPAT,IND,0,Graduate,244000,0,244000
2262,7866,Jajula Bhaskar,MALKAJGIRI,Shramajeevi Party,0,Graduate,2611000,0,2611000
2263,6505,Jakasiji Jogaji Thakor,PATAN,Bahujan Mukti Party,0,8th Pass,1181531,335000,846531
2264,1595,Jalasram Nagwanshi,CHHINDWARA,IND,0,12th Pass,268000,0,268000
2265,2817,Jaleshwar Mahato,GIRIDIH,JD(U),1,Graduate,24314128,1184627,23129501
2266,472,Jalley Sonam,ARUNACHAL WEST,PPA,0,10th Pass,4680000,0,4680000
2267,4763,Jameela Bee,INDORE,IND,0,5th Pass,986237,0,986237
2268,1939,James Joseph,IDUKKI,IND,0,10th Pass,375000,67000,308000
2269,1948,James Joseph P,KOTTAYAM,IND,0,12th Pass,10508400,0,10508400
2270,2789,Jamuna Mandavi,KANKER,Chhattisgarh Swabhiman Manch,0,Graduate,3321000,1065000,2256000
2271,7582,Janagar Raja,TENKASI,IND,0,Graduate Professional,2790001,450000,2340001
2272,6770,Janak Roy,JHANJHARPUR,IND,0,Literate,75000,0,75000
2273,1536,Janardan Mishra,REWA,IND,0,Graduate,151000,0,151000
2274,738,Janardan Mishra,REWA,BJP,0,Graduate Professional,10156568,106977,10049591
2275,2610,Janardhana Poojary,DAKSHINA KANNADA,INC,0,Graduate,5242284,0,5242284
2276,1086,Janardhana Swamy,CHITRADURGA,BJP,0,Post Graduate,19210602,0,19210602
2277,6870,Janarthanan .J,CHENNAI NORTH,BSP,0,Graduate Professional,4940000,0,4940000
2278,7904,Janiabhai C. Khulat,DADRA & NAGAR HAVELI,NCP,0,8th Pass,3873077,4950,3868127
2279,31,Jannat Jahan-Ul-Haq (Naina),CHANDIGARH,BSP,0,Graduate,11100000,500000,10600000
2280,3185,Jannat Nisha,RAMPUR,All India Minorities Front,0,Not Given,160344,0,160344
2281,6408,Jannu Mahendar,WARANGAL,IND,0,Post Graduate,101000,0,101000
2282,5315,Jardosh Darshnaben Vikrambhai,SURAT,BJP,0,Graduate,18038444,2020458,16017986
2283,7092,Jarina Begam. N,MAYILADUTHURAI,IND,0,8th Pass,710000,0,710000
2284,3557,Jaripatke Dnyanoba Sopanrao,LATUR,IND,0,Graduate,200000,0,200000
2285,499,Jarnail Singh,WEST DELHI,AAP,0,Post Graduate,11542391,222000,11320391
2286,7703,Jarnail Singh,JALANDHAR,Bharti Jan Suraksha Party,0,Graduate Professional,30000,0,30000
2287,7784,Jarnail Singh,FARIDKOT,Nav Bharat Democratic Party,1,Illiterate,210124,0,210124
2288,1297,Jarnail Singh S/O Gurbax Singh,WEST DELHI,IND,0,8th Pass,5955021,0,5955021
2289,2276,Jarnail Singh S/O Rajinder Singh,WEST DELHI,IND,0,10th Pass,2457012,0,2457012
2290,7693,Jasbir Singh,KHADOOR SAHIB,IND,0,10th Pass,700000,0,700000
2291,890,Jasmer Singh,CHANDIGARH,IND,0,10th Pass,5355500,290000,5065500
2292,1914,Jasminsha,THRISSUR,IND,2,Others,569648,0,569648
2293,7814,Jaspal Singh,BATHINDA,IND,0,10th Pass,2900000,0,2900000
2294,7807,Jasraj Singh Longia,BATHINDA,AAP,0,Graduate,3121648,0,3121648
2295,7790,Jasveer Singh,FARIDKOT,IND,0,Post Graduate,34921,0,34921
2296,1031,Jasvinder,KURUKSHETRA,IND,0,5th Pass,1730088,0,1730088
2297,2293,Jasvinder Singh,GANGANAGAR,Jai Maha Bharath Party,0,Graduate,3192000,0,3192000
2298,2048,Jaswant,SONIPAT,IND,0,10th Pass,612000,108000,504000
2299,2478,Jaswant Singh,BARMER,IND,0,Graduate,120424990,0,120424990
2300,7828,Jaswant Singh,SANGRUR,Bahujan Mukti Party,0,8th Pass,1218000,0,1218000
2301,4943,Jaswant Singh,AKBARPUR,Bahujan Mukti Party,0,12th Pass,4063662,0,4063662
2302,6115,Jaswant Singh Mann,ANANDPUR SAHIB,Shiromani Akali Dal (Amritsar)(Simranjit Sing,0,Post Graduate,175798500,3300000,172498500
2303,7727,Jaswinder Singh,HOSHIARPUR,SHS,0,5th Pass,1977048,0,1977048
2304,1048,Jaswinder Singh,KARNAL,INLD,0,10th Pass,46436884,2562000,43874884
2305,7764,Jaswinder Singh Bains,LUDHIANA,IND,0,10th Pass,40000,0,40000
2306,4654,Jata Shankar Pandey,KORBA,IND,0,8th Pass,21288,0,21288
2307,2768,Jauhar Azad,PATNA SAHIB,Janta Dal Rashtravadi,0,12th Pass,560500,360000,200500
2308,3780,Javaraiah,HASSAN,IND,0,10th Pass,50000,0,50000
2309,2832,Javed Islam,HAZARIBAGH,CPI(ML)L,0,Graduate,2117600,50000,2067600
2310,3092,Javed Khan,BAREILLY,IND,3,Literate,135000,0,135000
2311,2399,Javed Khan,JHALAWAR-BARAN,Bharatiya Yuva Shakti,0,12th Pass,50200,0,50200
2312,7019,Jawahar J.,KANNIYAKUMARI,BSP,0,Post Graduate,655813,30000,625813
2313,6733,Jawahar Lal,RAE BARELI,Nehru Janhit Congress,0,10th Pass,6909506,74944,6834562
2314,5166,Jawaharlal Laxman Bhagure,AURANGABAD,IND,0,10th Pass,448217,0,448217
2315,4501,Jay Narayan Yadav,SUPAUL,CPI(ML)L,2,Graduate,4748598,45000,4703598
2316,5556,Jay Prakash,FIROZABAD,SHS,0,Graduate,590800,0,590800
2317,773,Jay Prakash Patel,HOSHANGABAD,GGP,0,10th Pass,3411000,400000,3011000
2318,688,Jaya Prada Nahata,BIJNOR,RLD,0,12th Pass,226399859,3931582,222468277
2319,6213,Jaya Vindhyala,HYDERABAD,Socialist Party (India),0,Post Graduate,1850000,500000,1350000
2320,2562,Jayachandra,MANDYA,Bahujan Mukti Party,0,10th Pass,1006729,0,1006729
2321,324,Jayachandran Sarasamma,ALAPPUZHA,IND,1,Post Graduate,1587262,600000,987262
2322,7361,Jayakumar. M,TIRUVALLUR,INC,0,Graduate Professional,25910841,2336172,23574669
2323,4422,Jayant Choudhary,MATHURA,RLD,0,Post Graduate,136934546,21586003,115348543
2324,4699,Jayant Pandey,DHANBAD,AIFB,0,Post Graduate,92500,0,92500
2325,2979,Jayant Singh Tomar,MORENA,Loktantrik Samajwadi Party,0,Post Graduate,3368500,0,3368500
2326,2835,Jayant Sinha,HAZARIBAGH,BJP,0,Post Graduate,556754579,86380600,470373979
2327,2259,Jayanta Mallick,SILCHAR,IND,1,Graduate,777174,43000,734174
2328,7395,Jayaprakash,VELLORE,BSP,0,Graduate Professional,1550000,0,1550000
2329,2233,Jayaprakash Hegde,UDUPI CHIKMAGALUR,INC,0,Graduate Professional,90305073,16640811,73664262
2330,3768,Jayaprakasha Yadav,CHIKKBALLAPUR,IND,0,10th Pass,51000,0,51000
2331,6313,Jayasankar.C.R,CUDDALORE,DMDK,0,Post Graduate,355033000,267451000,87582000
2332,3444,Jayda,JODHPUR,IND,0,Illiterate,200000,0,200000
2333,4580,Jayeshbhai Ambalalbhai Patel,BHARUCH,INC,0,Graduate Professional,33426809,0,33426809
2334,6665,Jayram,JALAUN,Bhartiya Shakti Chetna Party,0,Literate,2212000,0,2212000
2335,1254,Jayram Indwar,LOHARDAGA,BSP,0,12th Pass,1965000,0,1965000
2336,3540,Jeevan Alias C.A.Patil,KOLHAPUR,IND,0,Graduate,500000,0,500000
2337,4655,Jeevan Lal Rautel,KORBA,IND,0,8th Pass,2836042,0,2836042
2338,7558,Jegan. P,THOOTHUKKUDI,DMK,2,Post Graduate,92068468,6531204,85537264
2339,6985,"Jerlld Amalajothi, I.",COIMBATORE,IND,0,10th Pass,943000,0,943000
2340,7959,Jerripothula Srinivas,KHAMMAM,IND,0,10th Pass,170000,0,170000
2341,6572,Jethabhai Manjibhai Patel,SURENDRANAGAR,AAP,0,5th Pass,8406405,218601,8187804
2342,3445,Jetharam Meghwal,JODHPUR,IND,0,8th Pass,765000,25000,740000
2343,3878,Jethlia Santoshbapu Mitthulal,BEED,IND,0,Post Graduate,970125,0,970125
2344,5167,Jevrikar Indrakumar Dnyanoba,AURANGABAD,BSP,0,Graduate,13071000,2200000,10871000
2345,7093,Jeyaprakash. B,MAYILADUTHURAI,IND,0,12th Pass,255043,0,255043
2346,7553,Jeyasingh Thiyagaraj Natterjee.J,THOOTHUKKUDI,AIADMK,0,Post Graduate,9822294,0,9822294
2347,7342,Jhala Rajendrasinh,JAMNAGAR,AAP,0,Graduate,4870529,797500,4073029
2348,1171,Jhina Hikaka,KORAPUT,BJD,0,Graduate,8800000,0,8800000
2349,3282,Jibesh Kishore Sundaray,CUTTACK,AITC,1,10th Pass,12814048,0,12814048
2350,1915,Jiju Cheenikkal,THRISSUR,IND,0,10th Pass,226394,400000,0
2351,3268,Jimuta Prasad Mishra,DHENKANAL,AAP,0,Post Graduate,3657868,0,3657868
2352,4678,Jinendra Ghritlahare,DURG,IND,0,12th Pass,3376000,50000,3326000
2353,4550,Jinna Ramadevi,PEDDAPALLE,IND,0,8th Pass,60000,0,60000
2354,533,Jinti Gogoi,KALIABOR,AAP,0,Graduate,42000,0,42000
2355,7829,Jit Singh,SANGRUR,CPI(ML) Red Star,0,5th Pass,291000,0,291000
2356,33,Jitan Ram Manjhi,GAYA,JD(U),0,Graduate,2360142,13109,2347033
2357,137,Jiten Gogoi,KALIABOR,IND,1,8th Pass,14407099,2700000,11707099
2358,1136,Jitendra Aadkuji Raut,BHANDARA-GONDIYA,Akhil Bhartiya Manavta Paksh,1,Graduate,76820,0,76820
2359,6541,Jitendra Bhurabhai Chauhan,RAJKOT,Republican Party of India,0,5th Pass,175000,160000,15000
2360,2497,Jitendra Choudhury,TRIPURA EAST,CPI(M),0,12th Pass,11322979,2030773,9292206
2361,5927,Jitendra Kamabhai Kataria,MUMBAI SOUTH,IND,0,Graduate,73000,0,73000
2362,2823,Jitendra Kumar,GIRIDIH,SP,0,Graduate,8029500,4000000,4029500
2363,4005,Jitendra Manki Alias Jitendra Prasad Manki,KHUNTI,IND,0,Graduate,6120000,65000,6055000
2364,4851,Jitendra Nath Halder,MURSHIDABAD,BSP,0,8th Pass,551000,0,551000
2365,4219,Jitendra Singh,ALWAR,INC,0,Graduate,111824330,4781367,107042963
2366,3058,Jitendra Singh,AONLA,Naitik Party,0,Post Graduate,1008091,0,1008091
2367,1817,Jitendra Subhash Nerle,CHIKKODI,IND,0,10th Pass,45500,0,45500
2368,5333,Jitesh Babubhai Rathod,JAMNAGAR,IND,0,10th Pass,69000,0,69000
2369,4121,Jivan Bharati,JANJGIR-CHAMPA,IND,0,8th Pass,828000,0,828000
2370,6529,Jivanbhai Devajibhai Parmar,RAJKOT,BSP,2,8th Pass,4327977,174500,4153477
2371,1310,Jodhraj Paharia,NORTH WEST DELHI,IND,0,Illiterate,7221810,0,7221810
2372,7552,Joel. S,THOOTHUKKUDI,MDMK,4,Graduate Professional,15241542,26008,15215534
2373,245,Joganati Datta,TRIPURA WEST,IND,0,8th Pass,165000,0,165000
2374,3558,Jogdand Fakira Vaijnath,LATUR,IND,0,Graduate,27000,0,27000
2375,1555,Jogendra Singh,SHAHDOL,Bahujan Mukti Party,0,8th Pass,180411,0,180411
2376,4947,Jogendra Singh,ETAH,Mahan Dal,0,Graduate,4125422,0,4125422
2377,6132,Joginder Singh,FARIDKOT,INC,0,8th Pass,33499042,883983,32615059
2378,7822,Joginder Singh Aulakh,SANGRUR,CPI(M),0,Post Graduate,42690574,458196,42232378
2379,7791,Joginder Singh S/O Kesar Singh,FARIDKOT,IND,0,Graduate,4696076,0,4696076
2380,2883,John Miran Munda,SINGHBHUM,AIFB,3,12th Pass,600000,450000,150000
2381,7020,John Thangam D.,KANNIYAKUMARI,AIADMK,3,Graduate,61593668,1080000,60513668
2382,4452,Jonjonali Baruah,NOWGONG,INC,0,Graduate,41306996,9937766,31369230
2383,1260,Jorawar Ram,PALAMAU,JD(U),2,12th Pass,16525000,205000,16320000
2384,2858,Josai Mardi,JAMSHEDPUR,Rashtriya Deshaj Party,0,Graduate Professional,1246500,0,1246500
2385,7039,Jose Bilbin J.,KANNIYAKUMARI,IND,0,Graduate Professional,1660000,0,1660000
2386,11,Jose K Mani,KOTTAYAM,Kerala Congress (M),0,Post Graduate,26236371,0,26236371
2387,4133,Joseph Bara,RAIGARH,IND,0,12th Pass,2235000,75000,2160000
2388,6948,Joseph Gunasekar,CHENNAI SOUTH,IND,0,Graduate Professional,2325000,0,2325000
2389,1774,Joseph Munda,ALIPURDUARS,INC,0,Graduate,2312000,550000,1762000
2390,507,Joseph Toppo,TEZPUR,AGP,0,10th Pass,3289490,22904,3266586
2391,6527,Joshi Harish Liladhar,PORBANDAR,IND,0,8th Pass,56000,0,56000
2392,4159,Joshil Murmu,DUMKA,IND,0,Graduate,30672,0,30672
2393,7441,Jothi.P,TIRUCHIRAPPALLI,SP,0,Not Given,40391000,2050000,38341000
2394,7042,"Jothimani, S.",KARUR,INC,0,Post Graduate,4293910,258500,4035410
2395,7835,Joti Devaji Ansuia,SANGRUR,IND,0,12th Pass,21000,0,21000
2396,6025,Joy Banerjee,BIRBHUM,BJP,0,Graduate,551537,0,551537
2397,2270,Joy Ram Engleng,AUTONOMOUS DISTRICT,BJP,0,10th Pass,22032158,5096806,16935352
2398,1944,Joyce George,IDUKKI,IND,0,10th Pass,1034810,0,1034810
2399,804,Jual Oram,SUNDARGARH,BJP,1,Others,24202170,0,24202170
2400,881,Jugal Kishore,JAMMU,BJP,0,10th Pass,26824308,300000,26524308
2401,1927,Juno John Baby,ERNAKULAM,IND,0,Others,934581,0,934581
2402,798,Justin Lugun,SUNDARGARH,SUCI(C),0,10th Pass,8092,0,8092
2403,702,Jyothish Perumpulickal,MAVELIKKARA,SDPI,0,12th Pass,101500,5400,96100
2404,4752,Jyoti Dhurve,BETUL,BJP,2,Post Graduate,26232000,1000000,25232000
2405,784,Jyoti Gajanan Makode,AMRAVATI,Ambedkarite Party of India,0,10th Pass,139000,0,139000
2406,7704,Jyoti Mann,JALANDHAR,AAP,0,Graduate,152000,0,152000
2407,2514,Jyoti Sanjay Dewkar,AMRAVATI,IND,0,10th Pass,216572,0,216572
2408,4792,Jyoti Sukhlal Gore,KHARGONE,CPI,1,8th Pass,1820400,0,1820400
2409,4173,Jyotin Soren,RAJMAHAL,CPI(M),1,Graduate,1901675,90000,1811675
2410,2933,Jyotiraditya M. Scindia,GUNA,INC,0,Post Graduate,330888751,795000,330093751
2411,2515,K A Mohan,BANGALORE RURAL,Kamarajar Deseeya Congress,0,5th Pass,1733000,0,1733000
2412,294,K Ambujakshan,CHALAKUDY,Welfare Party Of India,1,Post Graduate,2134142,82000,2052142
2413,1098,K Arkesh,CHIKKBALLAPUR,AAP,0,Post Graduate,30067157,750000,29317157
2414,1905,K Biju,ALATHUR,IND,3,8th Pass,73500,0,73500
2415,1930,K C Karthikeyan,ERNAKULAM,BSP,0,10th Pass,5180540,700000,4480540
2416,327,K C Venugopal,ALAPPUZHA,INC,0,Post Graduate,12856075,456010,12400065
2417,126,K H Muniyappa,KOLAR,INC,0,Graduate Professional,184663000,27863000,156800000
2418,1804,K K Ashokan,KASARAGOD,IND,0,10th Pass,5351775,517000,4834775
2419,293,K M Noordeen,CHALAKUDY,AAP,0,Graduate,158604311,0,158604311
2420,3801,K M Ranganathreddy,KOPPAL,SP,1,Graduate Professional,5500000,0,5500000
2421,1104,K Narendra Babu,KOLAR,IND,0,Post Graduate,200000,0,200000
2422,1868,K P Ratheesh,KOZHIKODE,AAP,0,Others,737252,45000,692252
2423,1337,K P Sankaran Menon,NEW DELHI,IND,0,Doctorate,182208649,0,182208649
2424,2157,K Raghavendra,BELLARY,Pyramid Party of India,1,10th Pass,20000,0,20000
2425,2625,K S Swamy,CHIKKBALLAPUR,IND,0,Graduate,1192500,0,1192500
2426,1903,K S Velayudhan,ALATHUR,IND,0,10th Pass,1211050,0,1211050
2427,1839,K Shivram,BIJAPUR,JD(S),0,Post Graduate,26203570,0,26203570
2428,177,K Somashekar,RAICHUR,SUCI(C),0,Graduate,3539,0,3539
2429,257,K Sudhakaran,KANNUR,INC,2,Post Graduate,21659467,1969997,19689470
2430,2278,K Sudhakaran (Kollon House),KANNUR,IND,0,Post Graduate,1898622,756505,1142117
2431,2279,K Sudhakaran (Sreeshylam),KANNUR,IND,0,12th Pass,414862,82500,332362
2432,2208,K Syed Zabiulla,DAVANAGERE,IND,0,12th Pass,627000,0,627000
2433,1083,K Yadava Shetty,DAKSHINA KANNADA,CPI(M),0,12th Pass,2135040,145000,1990040
2434,4034,K. Arasan,VILUPPURAM,IND,0,Illiterate,630000,0,630000
2435,334,K. Bhaskaran,KOLLAM,IND,1,Graduate,6313287,108453,6204834
2436,3934,K. Kamaraj,KALLAKURICHI,AIADMK,0,Post Graduate,35459256,544099,34915157
2437,3774,K. Kushala Bellare,DAKSHINA KANNADA,IND,0,Not Given,16329916,6500000,9829916
2438,6933,K. Mani,CHENNAI SOUTH,JD(U),0,5th Pass,2723000,0,2723000
2439,5570,K. Manjini,PONDICHERRY,IND,0,5th Pass,70000,0,70000
2440,4035,K. Muthayian,VILUPPURAM,DMK,0,Post Graduate,74251826,22432121,51819705
2441,4076,K. P. Kamte,GWALIOR,Bharatiya Rashtriya Mazdoor Dal,0,Illiterate,4500,0,4500
2442,5574,K. Ramadass,PONDICHERRY,IND,0,8th Pass,54823,0,54823
2443,3764,K. S. Srinivasmurthy,CHAMARAJANAGAR,CPI(ML) Red Star,0,Graduate,323207,0,323207
2444,3932,K. Sekar,KALLAKURICHI,IND,0,10th Pass,52000,0,52000
2445,830,K. Shyambabu Subudhi,BERHAMPUR,IND,0,12th Pass,16000000,0,16000000
2446,822,K. Shyambabu Subudhi,ASKA,IND,0,10th Pass,1660000,0,1660000
2447,6436,K. Srinivasulu,SECUNDERABAD,Jai Samaikyandhra Party,0,Post Graduate,2680000,2800000,0
2448,473,K. V. Pusa,NAGALAND,INC,0,Graduate,15500000,0,15500000
2449,3957,K.Balasubramanian,CUDDALORE,CPI,0,Graduate,5998936,0,5998936
2450,5473,K.Desingu,VILUPPURAM,IND,0,8th Pass,395000,0,395000
2451,6295,K.Elumalai,ARANI,IND,0,10th Pass,490500,0,490500
2452,852,K.G. Sreedhar,SHIMOGA,AAP,0,Graduate,22283800,147575,22136225
2453,900,K.G.Das,ANDAMAN & NICOBAR ISLANDS,CPI(M),0,12th Pass,4221392,0,4221392
2454,3791,K.H.Madhusoodan,KOLAR,IND,0,12th Pass,235000,0,235000
2455,6456,K.Jaya Rao,PEDDAPALLE,IND,2,10th Pass,755000,0,755000
2456,7712,K.K. Sabharwal,JALANDHAR,IND,0,10th Pass,570508,0,570508
2457,3840,K.K.Ramesh,MADURAI,IND,0,Post Graduate,315000,0,315000
2458,3838,K.Kalaimani,SIVAGANGA,Makkal Manadu Katchi,0,8th Pass,447413,200000,247413
2459,4283,K.Kaliyamurthy,VILUPPURAM,BSP,1,10th Pass,1150000,0,1150000
2460,6399,K.Madan Mohan Rao,ZAHIRABAD,TDP,0,Post Graduate,291223038,36884884,254338154
2461,3811,K.Mahadevappa,MANDYA,Bharatiya Dr. B.R.Ambedkar Janta Party,0,Graduate Professional,500,0,500
2462,6373,K.Mohammed Yasin,KALLAKURICHI,AAP,0,Others,2457180,312000,2145180
2463,6303,K.Moorthy,ARANI,IND,1,12th Pass,112000,0,112000
2464,3730,K.Murthy,BANGALORE CENTRAL,IND,0,10th Pass,80000,0,80000
2465,2607,K.N. Somashekar,DAKSHINA KANNADA,IND,0,Graduate,13036000,1915500,11120500
2466,276,K.Narayanan Master,PONNANI,BJP,1,12th Pass,10368303,1657088,8711215
2467,300,K.P. Sreesan,THRISSUR,BJP,1,12th Pass,4653270,0,4653270
2468,6911,K.R.Ramaswamy@Traffic Ramaswamy,CHENNAI SOUTH,IND,0,Others,29530,0,29530
2469,4330,K.Raja,MADURAI,Desiya Forward Bloc,2,8th Pass,6137145,1353026,4784119
2470,5464,K.Rajamanickam,VILUPPURAM,IND,0,12th Pass,212500,0,212500
2471,5475,K.Rani,VILUPPURAM,INC,0,Post Graduate,41275211,8973429,32301782
2472,6857,K.Raveendran,CHENNAI CENTRAL,IND,0,Graduate Professional,266500,0,266500
2473,7739,K.S Makhan,ANANDPUR SAHIB,BSP,0,10th Pass,17598896,0,17598896
2474,6433,K.Sai Krishna Mohan Rao,SECUNDERABAD,Indian Christian Secular Party,0,Post Graduate,3227500,258000,2969500
2475,7536,K.Samuvelraj,VIRUDHUNAGAR,CPI(M),1,12th Pass,711701,74000,637701
2476,7426,K.Senthilkumar,TIRUPPUR,IND,0,5th Pass,44100,0,44100
2477,3812,K.Shivananda,MANDYA,Hindustan Janta Party,0,10th Pass,260000,0,260000
2478,299,K.Sivaraman,THRISSUR,CPI(ML) Red star,1,10th Pass,3658000,0,3658000
2479,7538,K.Solairaj,VIRUDHUNAGAR,IND,0,10th Pass,51700,0,51700
2480,5471,K.Srinivasan,VILUPPURAM,IND,0,Literate,253000,0,253000
2481,4302,K.Subbarayan,TIRUPPUR,CPI,0,10th Pass,6836109,0,6836109
2482,7492,K.Thangapandi,MADURAI,IND,0,Illiterate,101000,0,101000
2483,2559,K.Udayakumar,MANDYA,IND,0,10th Pass,906000,0,906000
2484,5467,K.Umasankar,VILUPPURAM,DMDK,0,Post Graduate,11251249,1291251,9959998
2485,6,K.V. Thomas,ERNAKULAM,INC,0,Post Graduate,11848550,522352,11326198
2486,2573,K.V.Srinivas Kalkere,TUMKUR,IND,0,Graduate,90600,30000,60600
2487,4289,K.Vellaiyan,KALLAKURICHI,IND,0,5th Pass,2575000,295000,2280000
2488,6374,K.Vetrivel,KALLAKURICHI,IND,0,12th Pass,1003333,931833,71500
2489,77,Kabindra Purkayastha,SILCHAR,BJP,0,Post Graduate,6236945,130502,6106443
2490,5294,Kachhadiya Naranbhai Bhikhabhai,AMRELI,BJP,2,12th Pass,34164801,4971590,29193211
2491,5991,Kadam Ramesh Ramchandra,RAIGAD,Peasants And Workers Party of India,0,Graduate,15220472,0,15220472
2492,3669,Kadam Sagar Uttamrao,SATARA,IND,1,Graduate,150,0,150
2493,7353,Kadari Ibrahim Saiyad Husen,JUNAGADH,SP,0,5th Pass,75000,0,75000
2494,1721,Kadeem,GAUTAM BUDHHA NAGAR,IND,0,5th Pass,20300,0,20300
2495,1707,Kadir Khan Jaiswal,GAUTAM BUDHHA NAGAR,IND,0,8th Pass,1461000,0,1461000
2496,226,Kadir Rana,MUZAFFARNAGAR,BSP,5,Literate,135202262,24105110,111097152
2497,7922,Kadire Krishna,MAHBUBNAGAR,BSP,0,Doctorate,390000,100000,290000
2498,6405,Kadiyam Srihari,WARANGAL,TRS,6,Post Graduate,13495000,0,13495000
2499,5609,Kadri Saniya Saiyed Ali,RAVER,IND,3,Others,5500000,2000000,3500000
2500,3735,Kadugudi Sonnappa,BANGALORE CENTRAL,RPI(A),0,10th Pass,4083633,546581,3537052
2501,4018,Kafilur Rahman,RANCHI,IND,0,Graduate Professional,920000,0,920000
2502,7326,Kagada Rameshbhai Punabhai,BHAVNAGAR,IND,0,5th Pass,30500,0,30500
2503,5168,Kailas Chandrabhan Dhengde,AURANGABAD,IND,0,10th Pass,17200,0,17200
2504,5830,Kailas Sakharam More,DINDORI,IND,0,10th Pass,2320084,0,2320084
2505,4201,Kailash Awasya,KHARGONE,AAP,2,Post Graduate,1687286,0,1687286
2506,2384,Kailash Chand Saini,JAIPUR,Hindustan Janta Party,0,8th Pass,16758886,0,16758886
2507,5789,Kailash Kumar,RAE BARELI,Hindustan Krantikari Dal,0,Graduate Professional,9914000,0,9914000
2508,6059,Kailash Naskar,SREERAMPUR,IND,0,Graduate,191646,0,191646
2509,4790,Kailash Patel,KHARGONE,IND,0,12th Pass,5843000,0,5843000
2510,5539,Kailash Prasad Nishad,HAMIRPUR,Eklavya Samaj Party,0,12th Pass,70000,0,70000
2511,1176,Kailash Sabara,KORAPUT,Samata Kranti Dal,0,Graduate Professional,16000,0,16000
2512,4809,Kailash Vasuniya,RATLAM,Bahujan Mukti Party,0,Graduate,96342,0,96342
2513,5800,Kaiser Jahan,SITAPUR,BSP,0,10th Pass,15591045,0,15591045
2514,3341,Kajale Pradip Mahadev,PARBHANI,IND,1,12th Pass,744277,0,744277
2515,3398,Kakade Kisan Yashwant,AHMEDNAGAR,BSP,0,10th Pass,403500,0,403500
2516,1790,Kakali Majumdar (Roy),DARJEELING,BSP,0,10th Pass,2895875,711396,2184479
2517,7619,Kakarwal Pratapsing Mahajan,JALNA,IND,0,Graduate,1671107,69052,1602055
2518,3600,Kakasaheb Baburao Rathod,OSMANABAD,IND,0,10th Pass,50000,100000,0
2519,7104,"Kala, M.",NILGIRIS,BSP,0,Post Graduate,196000,0,196000
2520,5678,Kalaivanan.M,NAMAKKAL,JD(S),0,Graduate Professional,1158000,0,1158000
2521,3267,Kalakar Naik,DHENKANAL,Ambedkarite Party of India,0,12th Pass,2140000,0,2140000
2522,3256,Kalandi Mallick,JAJPUR,AAP,0,12th Pass,225518,0,225518
2523,6968,"Kalapirar Kuppusamy, C.",COIMBATORE,CPI(ML) Red Star,0,8th Pass,2000,0,2000
2524,5312,Kalara Ramsingbhai Nanjibhai,DAHOD,JD(U),0,12th Pass,11051107,0,11051107
2525,3876,Kale Bajirao Shankar,BEED,IND,0,10th Pass,755000,0,755000
2526,3851,Kale Krishna Bhanudas,BEED,Bharipa Bahujan Mahasangh,0,Graduate Professional,936000,52000,884000
2527,829,Kali Charana Nayak,ASKA,IND,0,5th Pass,255213,0,255213
2528,2864,Kalicharan Munda,KHUNTI,INC,0,12th Pass,4069525,31895,4037630
2529,6009,Kalicharan Sardar,BARDHAMAN PURBA,SUCI(C),1,Graduate,10590,0,10590
2530,807,Kalikesh Narayan Singh Deo,BOLANGIR,BJD,3,Graduate,87955818,24410449,63545369
2531,5926,Kalim Khurshid Baig Mirza,MUMBAI SOUTH,The Lok Party of India,0,5th Pass,170000,0,170000
2532,5586,Kaliyamurthy,PONDICHERRY,IND,0,10th Pass,72814,30000,42814
2533,2132,Kallalinga,BIDAR,IND,0,Graduate,6241000,830000,5411000
2534,4175,Kallushing Kumre,BETUL,GGP,0,12th Pass,612000,20000,592000
2535,7955,Kalthi Ramulamma,KHAMMAM,IND,0,5th Pass,160000,0,160000
2536,7956,Kalthi Venkateswarlu,KHAMMAM,IND,0,Others,50000,0,50000
2537,6830,Kalvakuntla Chandrashekar Rao,MEDAK,TRS,2,Graduate,151582464,78753620,72828844
2538,6496,Kalvakuntla Kavitha,NIZAMABAD,TRS,8,Graduate Professional,61955750,3213119,58742631
2539,6465,Kalvala Sanjeev,PEDDAPALLE,RPI,0,Graduate Professional,4731000,2200000,2531000
2540,6464,Kalvala Shankar,PEDDAPALLE,Pyramid Party of India,0,Graduate,670000,0,670000
2541,6058,Kalyan Banerjee,SREERAMPUR,AITC,1,Graduate Professional,88512676,8582543,79930133
2542,4627,Kamaaluddin,RAIPUR,IND,0,8th Pass,441000,0,441000
2543,85,Kamakhya Prasad Tasa,JORHAT,BJP,0,Post Graduate,1694785,0,1694785
2544,1757,Kamal,BIJNOR,IND,0,5th Pass,1606593,0,1606593
2545,1275,Kamal Chand Arya,FARIDABAD,Bahujan Mukti Party,0,Graduate Professional,36090683,0,36090683
2546,2267,Kamal Das,SILCHAR,IND,0,5th Pass,900802,0,900802
2547,4129,Kamal Dev,KORBA,Bhartiya Shakti Chetna Party,0,8th Pass,322410,27508,294902
2548,162,Kamal Kanti Debnath,TRIPURA WEST,IND,0,10th Pass,2569416,414150,2155266
2549,3094,Kamal Kishor Engineer,BAREILLY,IND,0,Graduate,2967000,500000,2467000
2550,1772,Kamal Krishna Bairagi,COOCHBEHAR,Rashtriya Janadhikar Suraksha Party,0,10th Pass,138800,0,138800
2551,4249,Kamal Kumar Dhobi,TONK-SAWAI MADHOPUR,IND,0,Literate,70000,0,70000
2552,2359,Kamal Kumar Gaur,JAIPUR RURAL,IND,0,12th Pass,10180000,3002800,7177200
2553,766,Kamal Nath,CHHINDWARA,INC,0,Graduate,2069080434,51172087,2017908347
2554,4180,Kamal Singh,DEWAS,Prajatantrik Samadhan Party,0,Post Graduate,2604000,0,2604000
2555,4241,Kamal Singh,KARAULI-DHOLPUR,AITC,0,8th Pass,637000,0,637000
2556,7710,Kamal Thapar,JALANDHAR,IND,0,10th Pass,333850,0,333850
2557,4859,Kamal Uddin,BARPETA,IND,0,Literate,152836,0,152836
2558,5491,Kamala Prasad Rawat,BARABANKI,BSP,0,Graduate,80724161,7129071,73595090
2559,7531,Kamalavel Selvan,VIRUDHUNAGAR,BSP,1,Graduate Professional,1529881,46496,1483385
2560,5343,Kamalbhai Matang,KACHCHH,BSP,0,12th Pass,2376000,0,2376000
2561,102,Kamalbhan Singh,SURGUJA,BJP,0,Post Graduate,24773173,2995985,21777188
2562,3130,Kamar Alam,MORADABAD,Indian Bahujan Samajwadi Party,0,12th Pass,1784350,0,1784350
2563,7027,Kamaraj G.,KANNIYAKUMARI,IND,0,Graduate Professional,2871000,0,2871000
2564,7026,Kamaraj K.,KANNIYAKUMARI,IND,0,10th Pass,2323400,300000,2023400
2565,5427,Kamaraj M,TIRUVANNAMALAI,IND,0,5th Pass,507000,0,507000
2566,6360,Kamaraj. R,KALLAKURICHI,IND,0,10th Pass,268440,0,268440
2567,3828,Kamarujjaman Khandekar,MURSHIDABAD,SUCI(C),0,12th Pass,777500,0,777500
2568,5904,Kamat Gurudas Vasant,MUMBAI NORTH WEST,INC,0,Graduate Professional,488871453,0,488871453
2569,544,Kamble Bhanudas Chokoba,AKOLA,BSP,0,12th Pass,4607000,0,4607000
2570,3497,Kamble Chandrakant Tukaram,HATKANANGLE,BSP,0,10th Pass,30000,0,30000
2571,3534,Kamble Dayanand Vasant,KOLHAPUR,Bahujan Mukti Party,0,Graduate Professional,189918,10000,179918
2572,3546,Kamble Deepak Arvind,LATUR,BSP,0,12th Pass,3326994,0,3326994
2573,3555,Kamble Milind Haribhau,LATUR,IND,0,10th Pass,1000,0,1000
2574,3539,Kamble Sukumar Dattu,KOLHAPUR,IND,0,Post Graduate,275000,0,275000
2575,3503,Kamble Sukumar Dattu,HATKANANGLE,IND,0,Post Graduate,275000,0,275000
2576,2579,Kamble Uttam Bhagaji,YAVATMAL-WASHIM,Prabuddha Republican Party,0,Post Graduate,0,0,0
2577,487,Kameshwar Baitha,PALAMAU,AITC,48,10th Pass,1808000,0,1808000
2578,3977,Kameshwar Chaupal,SUPAUL,BJP,1,Post Graduate,41372252,12909,41359343
2579,1311,Kamini Kaur,NORTH WEST DELHI,IND,0,8th Pass,233096000,0,233096000
2580,6035,Kamini Mohan Sarkar,BOLPUR,BJP,0,Graduate,3675833,0,3675833
2581,231,Kamlesh,BULANDSHAHR,SP,1,5th Pass,7593541,0,7593541
2582,3009,Kamlesh Kumar,TIKAMGARH,INC,0,Doctorate,329992919,84598565,245394354
2583,4823,Kamlesh Sallam,VIDISHA,GGP,0,5th Pass,620000,0,620000
2584,2806,Kamleshwar Verma,RAJNANDGAON,INC,1,Graduate,21111998,236375,20875623
2585,2700,Kamleshwari Mandal,MUNGER,BSP,0,Others,3065084,0,3065084
2586,6024,Kamre Ilahi Mahammad,BIRBHUM,CPI(M),0,Post Graduate,19012391,56000,18956391
2587,5638,Kamrujjama Kutubali Meenai,THANE,Peace Party,0,Post Graduate,3923999,0,3923999
2588,7906,Kamuben K. Patel,DADRA & NAGAR HAVELI,IND,0,Illiterate,500,0,500
2589,3845,Kanabur Sadashiv  Sidamallappa,BAGALKOT,JD(U),0,Graduate Professional,15493504,2229492,13264012
2590,6977,"Kanagasabapathy, G.",COIMBATORE,IND,0,5th Pass,19500,0,19500
2591,6407,Kanakam Ramesh,WARANGAL,IND,0,Post Graduate,207100,0,207100
2592,6231,Kanakama Tirumala Rao,KHAMMAM,IND,0,Graduate,20000,0,20000
2593,5116,Kanchan Bai,KARAULI-DHOLPUR,IND,0,Illiterate,45000,0,45000
2594,641,Kanchan Kumari,KODARMA,IND,0,12th Pass,5980857,85000,5895857
2595,4293,Kandasamy R,SALEM,IND,0,10th Pass,31000,0,31000
2596,4524,Kandem Prabhakar,KARIMNAGAR,IND,0,Graduate,8600000,2000000,6600000
2597,6486,Kandem Prabhakar,NIZAMABAD,IND,0,Graduate,9525000,1500000,8025000
2598,6230,Kandula Ramu,KHAMMAM,IND,0,Others,20000,0,20000
2599,6710,Kanedi,MISRIKH,Bahujan Mukti Party,0,Literate,1615600,0,1615600
2600,5259,Kanhai Mandal,KATIHAR,IND,0,8th Pass,579677,0,579677
2601,2795,Kanhaiya Sahu,MAHASAMUND,BSP,0,Graduate,42374312,120000,42254312
2602,3473,Kanhaiyalal Pareek,PALI,IND,0,Graduate,5021340,2182277,2839063
2603,2350,Kanhaylal,SIKAR,IND,0,10th Pass,328500,0,328500
2604,7951,Kankanala Narayana,KHAMMAM,CPI,1,Post Graduate,16910510,100000,16810510
2605,7547,Kannan,VIRUDHUNAGAR,IND,0,5th Pass,555776,0,555776
2606,7565,Kannan,TENKASI,BSP,0,Post Graduate,286788,0,286788
2607,7357,"Kannan, A.S.",TIRUVALLUR,CPI,0,10th Pass,29177341,1600000,27577341
2608,7048,"Kannan, P.",KARUR,IND,0,8th Pass,3500,0,3500
2609,7047,"Kannan, S.",KARUR,IND,2,12th Pass,140340,0,140340
2610,7516,"Kannan, S.",THENI,IND,0,Graduate,2839263,300000,2539263
2611,7165,Kannathasan .R,RAMANATHAPURAM,IND,0,10th Pass,20000,0,20000
2612,1994,Kanta,KURUKSHETRA,Indian Bahujan Sandesh Party (Kanshiram),1,10th Pass,34224262,26405000,7819262
2613,7875,Kante Sayanna,MALKAJGIRI,IND,0,10th Pass,1807000,0,1807000
2614,6934,Kanthavel D,CHENNAI SOUTH,IND,0,8th Pass,246000,0,246000
2615,552,Kanti Singh,KARAKAT,RJD,4,Graduate,60390021,337826,60052195
2616,4205,Kantilal Bhuriya,RATLAM,INC,1,Graduate Professional,47510241,0,47510241
2617,6098,Kanwaljit Singh Sahota,AMRITSAR,IND,0,10th Pass,270085,0,270085
2618,654,Kanwar Hasan,KAIRANA,BSP,0,Post Graduate,37686620,245671,37440949
2619,3037,Kanwar Singh Tanwar,AMROHA,BJP,0,5th Pass,1788430770,4036151,1784394619
2620,386,Kapil Choudhary,GAYA,AITC,0,12th Pass,1606000,0,1606000
2621,7196,Kapil Kantilal Soni,MUMBAI NORTH,IND,0,Post Graduate,1484092,0,1484092
2622,5185,Kapil Moreshwar Patil,BHIWANDI,BJP,0,Graduate,363758831,10697367,353061464
2623,491,Kapil Sibal,CHANDNI CHOWK,INC,0,Graduate Professional,1144747216,0,1144747216
2624,6378,Kapilavai Dileep Kumar,BHONGIR,RLD,0,Post Graduate,49896406,0,49896406
2625,408,Kapoor Singh,AMBALA,BSP,0,Doctorate,32373100,3483000,28890100
2626,1300,Karam Chand Lathwal,WEST DELHI,Bhartiya Pragatisheel Congress,0,Post Graduate,28936843,0,28936843
2627,7834,Karam Singh,SANGRUR,IND,0,8th Pass,210000,0,210000
2628,5226,Karan Burman Gareeb,DHAR,Samata Samadhan Party,0,12th Pass,60727,35000,25727
2629,92,Karan Singh,ROHTAK,IND,0,10th Pass,12226000,162000,12064000
2630,210,Karan Singh,GURGAON,IND,0,Graduate,58279661,2735214,55544447
2631,7618,Karande Ganesh Navnathrao,JALNA,IND,0,Post Graduate,2040000,970000,1070000
2632,6415,Karankote Narender,SECUNDERABAD,AIFB,0,10th Pass,2005000,0,2005000
2633,2863,Karia Munda,KHUNTI,BJP,0,Post Graduate,7474796,0,7474796
2634,7825,Karnail Singh,SANGRUR,Shiromani Akali Dal (Amritsar)(Simranjit Sing,0,Graduate Professional,4581380,64000,4517380
2635,144,Karra Parasu Ramaiah,SASARAM,JD(U),1,Doctorate,24500404,1672000,22828404
2636,2010,Kartar Singh,HISAR,IND,0,Graduate,36950500,0,36950500
2637,7813,Kartar Singh,BATHINDA,IND,0,8th Pass,4985000,0,4985000
2638,2282,Kartar Singh Bains,GANGANAGAR,AITC,0,Post Graduate,3180703,0,3180703
2639,1610,Kartar Singh Bhadana,KAIRANA,RLD,1,8th Pass,334053064,2555000,331498064
2640,7526,"Karthigaisamy, P.",VIRUDHUNAGAR,CPI(ML) Red Star,1,5th Pass,1637904,0,1637904
2641,7474,Karthikarajan T,SIVAGANGA,IND,0,10th Pass,603600,0,603600
2642,7143,Karthikeyan. Pon,POLLACHI,IND,0,12th Pass,11346000,0,11346000
2643,7468,Karti P Chidambaram,SIVAGANGA,INC,0,Graduate Professional,596685048,92587423,504097625
2644,1488,Kartik Gajanan Kodape,CHANDRAPUR,IND,0,Others,190000,0,190000
2645,2828,Kartik Mahto,GIRIDIH,BSP,3,10th Pass,12176000,2000000,10176000
2646,3243,Kartikeswar Patra,BALASORE,AITC,1,Not Given,4365951,0,4365951
2647,3982,Karuna Shukla,BILASPUR,INC,0,Post Graduate,30261209,1673200,28588009
2648,7842,Karunakar R,MALKAJGIRI,BSP,0,Post Graduate,988500,92000,896500
2649,1806,Karunakaran Kalippurayil,KASARAGOD,IND,0,10th Pass,4514183,0,4514183
2650,7517,"Karuppiah, R.",THENI,IND,0,Literate,3946522,0,3946522
2651,5335,Kasambhai,JAMNAGAR,Rashtriya Komi Ekta Party,2,5th Pass,382500,40000,342500
2652,4868,Kashem Ali Akonda,DHUBRI,IND,0,12th Pass,7590000,2150000,5440000
2653,5987,Kashinath Laxman Kokera,PALGHAR,IND,0,8th Pass,2286452,400000,1886452
2654,4195,Kashinath Upadhyay,KHANDWA,IND,0,Graduate,3182000,0,3182000
2655,3005,Kashiram Patel,SAGAR,GGP,0,Graduate,100500,0,100500
2656,6128,Kashmir Singh,FARIDKOT,CPI,0,Graduate,902000,0,902000
2657,4871,Kasir Uddin Sk.,DHUBRI,IUML,0,12th Pass,2746500,16000,2730500
2658,7166,Kasirajan .N,RAMANATHAPURAM,IND,0,5th Pass,770000,1000000,0
2659,5314,Katara Singajibhai Jaljibhai,DAHOD,CPI(M),0,5th Pass,142606,0,142606
2660,1207,Kathavaraya,CHAMARAJANAGAR,Dr. Ambedkar Samajvadi Democratic Party,0,10th Pass,1315000,520000,795000
2661,7141,Kathiravan. K,POLLACHI,IND,0,Post Graduate,522,0,522
2662,7142,Kathiresan. L,POLLACHI,IND,0,Post Graduate,5377000,300000,5077000
2663,3687,Katore Mahadev Niwritti,SHIRUR,IND,0,Graduate,1052914,0,1052914
2664,5774,Kaushal Kishore,MOHANLALGANJ,BJP,2,Graduate,21128221,0,21128221
2665,2727,Kaushal Kumar Kaushalendra Sinha Alias Bharat Manas,NALANDA,IND,1,12th Pass,3049003,0,3049003
2666,5394,Kaushal Prasad,JANJGIR-CHAMPA,IND,0,Graduate,50000,0,50000
2667,2495,Kaushal Rai,SIKKIM,AAP,0,Post Graduate,192000,0,192000
2668,2725,Kaushlendra Kumar,NALANDA,JD(U),0,12th Pass,11815717,477000,11338717
2669,2532,Kavita Vinod Kumar Tibdiwal (Agrawal),NAGPUR,IND,0,Post Graduate,3694650,600000,3094650
2670,7939,Kavitha Rani Lunavath,MAHABUBABAD,Pyramid Party of India,0,10th Pass,4400000,800000,3600000
2671,7691,Kawaljit Singh,KHADOOR SAHIB,IND,0,10th Pass,132000,0,132000
2672,590,Kawaljit Singh,CHANDIGARH,CPI(ML)L,4,Graduate Professional,22000,0,22000
2673,4438,Kazi Nekib Ahmed,GAUHATI,Regional Democratic Secular Congress,0,Graduate,16650020,0,16650020
2674,6169,Kedar Kumar Keshav,DARBHANGA,SHS,0,Post Graduate,8366241,0,8366241
2675,2521,Kenchaiah,BANGALORE RURAL,IND,0,Not Given,510000,0,510000
2676,2916,Kesari Singh,BHOPAL,IND,0,Graduate,15325217,0,15325217
2677,7406,"Kesavan, M.",VELLORE,IND,0,8th Pass,831388,0,831388
2678,6880,Kesavan. L,CHENNAI NORTH,IND,0,8th Pass,27659000,1228000,26431000
2679,1768,Keshab Chandra Ray,COOCHBEHAR,INC,0,Graduate,6801343,0,6801343
2680,521,Keshab Gogoi,LAKHIMPUR,IND,0,Graduate,858000,0,858000
2681,1529,Keshav,SATNA,IND,0,Post Graduate,76250,0,76250
2682,1680,Keshav Choudhary,GHAZIABAD,IND,1,12th Pass,1000,0,1000
2683,7638,Keshavji L. Saradva,NAVSARI,IND,0,Graduate,56738000,650000,56088000
2684,1228,Keshwar Yadav,CHATRA,SP,16,5th Pass,3450487,300000,3150487
2685,6086,Kessur Goan,DAMAN & DIU,AAP,0,10th Pass,10910623,977000,9933623
2686,4656,Kewal Bharti Goswami,KORBA,SP,1,Post Graduate,6275000,0,6275000
2687,3698,Kewale Chaya Nagnath,SOLAPUR,IND,0,Literate,15000,0,15000
2688,5594,Khadase Raksha Nikhil,RAVER,BJP,0,Graduate,144222841,0,144222841
2689,7322,Khadrani Asimbhai Pirbhai,BHAVNAGAR,IND,0,12th Pass,151000,0,151000
2690,4366,Khagen Murmu,MALDAHA UTTAR,CPI(M),0,Graduate,5342394,291761,5050633
2691,5073,Khaim Chand,ALWAR,Bharatiya Yuva Shakti,0,8th Pass,7246800,0,7246800
2692,519,Khairul Islam,LAKHIMPUR,IND,0,10th Pass,413129,0,413129
2693,6419,Khaja Khalid Anwar,SECUNDERABAD,BSP,2,Literate,50000,0,50000
2694,4394,Khajan Singh,FIROZABAD,Lok Dal,0,12th Pass,351000,0,351000
2695,3043,Khajan Singh,AMROHA,Rashtriya Congress (Babu Jagjivanram),0,Literate,1025000,0,1025000
2696,5282,Khalifa Sansuddin Nasruddin,AHMEDABAD EAST,Akhil Bharatiya Congress Dal (Ambedkar),0,5th Pass,1156000,0,1156000
2697,3741,Khan Abdul Razack,BANGALORE SOUTH,BSP,0,10th Pass,3708254,0,3708254
2698,5917,Khan Abdus Salam Kasmi,MUMBAI SOUTH,BSP,0,Others,2351000,0,2351000
2699,5881,Khan Mohammed Ahmed,KALYAN,IND,5,10th Pass,200000,0,200000
2700,7232,Khan Shamim Banu,MUMBAI NORTH EAST,IND,0,5th Pass,3869918,0,3869918
2701,5945,Khan Siraj Ahmad Sarajun Hak,MUMBAI SOUTH CENTRAL,IND,7,5th Pass,1840000,0,1840000
2702,5498,Khanjan Lal,BARABANKI,IND,0,Post Graduate,32560591,0,32560591
2703,5980,Kharapade Ladakya Rupa,PALGHAR,CPI(M),0,12th Pass,2641309,0,2641309
2704,4878,Khargeswar Das,GAUHATI,IND,0,8th Pass,550800,0,550800
2705,2031,Khatab Singh Mor,KARNAL,Bhartiya Shakti Chetna Party,0,12th Pass,14880000,200000,14680000
2706,5597,Khatik Mohammad Haroon Abdul Kadir,RAVER,SP,2,Post Graduate,2218302,475000,1743302
2707,593,Khem Lal Bansal,CHANDIGARH,Inqalab Vikas Dal,0,10th Pass,76108195,900000,75208195
2708,236,Khem Raj Chetry,TEZPUR,CPI(M),0,12th Pass,300100,0,300100
2709,1280,Kheme Thakur,FARIDABAD,SP,1,Graduate,1267000,0,1267000
2710,2805,Khemraj Lodhi,RAJNANDGAON,IND,0,Graduate,9000000,100000,8900000
2711,5101,Khemraj Meena,DAUSA,Bharatiya Yuva Shakti,0,Graduate Professional,140095,0,140095
2712,2477,Khet Singh Rajpurohit,BARMER,IND,0,10th Pass,50046,0,50046
2713,2467,Khima Ram Salavi,RAJSAMAND,IND,1,8th Pass,1566000,85000,1481000
2714,3626,Khirid Simkumar Bhagwan,PUNE,IND,0,Post Graduate,26532579,0,26532579
2715,5385,Khitiz Kumar Sabharkar,DURG,Republican Paksha (Khoripa),0,Graduate Professional,31000,0,31000
2716,50,Khobragade Chandrabhan Jairam,RAMTEK,IND,0,10th Pass,37804,0,37804
2717,6526,Khokhani Lalitaben Mansukhbhai,PORBANDAR,IND,0,Literate,921436,0,921436
2718,5085,Khoob Raj Neeraj,ALWAR,Bahujan Mukti Party,1,12th Pass,11513535,700000,10813535
2719,4612,Khristi Adward Khushalbhai,KHEDA,IND,0,10th Pass,630000,0,630000
2720,5148,Khudus Samad,AURANGABAD,Bahujan Mukti Party,0,10th Pass,41890,0,41890
2721,759,Khuman Singh Armo,MANDLA,AAP,0,12th Pass,1178622,0,1178622
2722,6524,Khunti Bharatbhai Maldebhai,PORBANDAR,IND,1,8th Pass,810000,300000,510000
2723,4426,Khurshida Anowara Begum,BARPETA,SUCI(C),0,Post Graduate,4918640,369608,4549032
2724,2091,Khush Dil Sehgal (Kapoor),FARIDABAD,Akhil Bharatiya Hind Kranti Party,0,Post Graduate,3903000,45000,3858000
2725,248,Kim Gangte,OUTER MANIPUR,AITC,0,Post Graduate,10150000,0,10150000
2726,5530,Kiran,HAMIRPUR,IND,0,Graduate,1055000,0,1055000
2727,5788,Kiran Chaudhary,RAE BARELI,Bahujan Mukti Party,0,12th Pass,1036570,620000,416570
2728,1997,Kiran Pal,KURUKSHETRA,Bharatiya Inqalab Party,0,12th Pass,18260000,0,18260000
2729,1296,Kiran Pal Singh,SOUTH DELHI,IND,0,8th Pass,630000,0,630000
2730,1420,Kiran Prem Kumar Rodge (Patankar),RAMTEK,BSP,0,Literate,6074383,0,6074383
2731,782,Kirantai Dadarao Alias Kokubhau Kokate,AMRAVATI,IND,0,8th Pass,0,0,0
2732,5876,Kiratkar Dayanand Tulshiram,KALYAN,BSP,1,12th Pass,3768000,251108,3516892
2733,246,Kiren Rijiju,ARUNACHAL WEST,BJP,0,Graduate,12539868,475000,12064868
2734,4097,Kirip Chaliha,MANGALDOI,INC,0,Post Graduate,25799434,0,25799434
2735,7220,Kirit Somaiya,MUMBAI NORTH EAST,BJP,10,Doctorate,72156258,6593325,65562933
2736,5318,Kiritbhai Harjibhai Vasani,SURAT,Yuva Sarkar,0,5th Pass,1140550,0,1140550
2737,4234,Kirodi Lal,DAUSA,National Peoples Party,1,Graduate Professional,22522693,1170000,21352693
2738,7257,Kirtawade Vidhyadhar Bhimrao,THANE,BSP,0,10th Pass,721500,0,721500
2739,6166,Kirti Azad,DARBHANGA,BJP,4,Graduate,28531267,431860,28099407
2740,5503,Kirti Singh,DHAURAHRA,SHS,0,Post Graduate,27853253,0,27853253
2741,7755,Kishan Kumar Sharma,LUDHIANA,JKNPP,0,8th Pass,98000,0,98000
2742,5488,Kishan Lal,BARABANKI,SHS,0,5th Pass,425020,0,425020
2743,5086,Kishan Lal,ALWAR,IND,0,8th Pass,3061599,0,3061599
2744,3209,Kishan Lal,SHAHJAHANPUR,Lok Dal,0,8th Pass,140000,0,140000
2745,2959,Kishan Lal Kushwah,GWALIOR,Rashtriya Samanta Dal,0,8th Pass,3740000,0,3740000
2746,7899,Kishan Nathu Ghutiya,DADRA & NAGAR HAVELI,SHS,0,12th Pass,408417,0,408417
2747,4526,Kishan Nayak Banoth,KHAMMAM,IND,0,10th Pass,50000,0,50000
2748,4975,Kishan Pal Singh,FARRUKHABAD,IND,0,8th Pass,3393000,80000,3313000
2749,678,Kishan Pal Singh,GAUTAM BUDHHA NAGAR,AAP,0,10th Pass,14376352,592054,13784298
2750,6601,Kishanbhai Vestabhai Patel,VALSAD,INC,2,12th Pass,9272641,2857545,6415096
2751,5720,Kishor Bajpai,KANPUR,IND,0,10th Pass,323000,30000,293000
2752,4158,Kishor Kumar Murmu,DHANBAD,Bahujan Mukti Party,0,Others,1545450,0,1545450
2753,319,Kishor Rambhau Kinkar,WARDHA,Bahujan Mukti Party,1,Graduate,12132347,345000,11787347
2754,1932,Kishore,ERNAKULAM,IND,0,10th Pass,90000,0,90000
2755,5115,Kishore Kumar,KARAULI-DHOLPUR,IND,0,Literate,3104400,0,3104400
2756,439,Kismat Sharma,KARNAL,IND,0,10th Pass,1350000,540000,810000
2757,6978,"Kittusamy, P.",COIMBATORE,IND,0,5th Pass,80000,0,80000
2758,6438,Klhaja Sirajuddin,SECUNDERABAD,Majlis Markaz-e-Siyasee Party,0,Post Graduate,2000000,0,2000000
2759,13,Kodikunnil Suresh,MAVELIKKARA,INC,1,Graduate Professional,13251330,3439654,9811676
2760,3493,Kokare Shivaji Jaysingh,BARAMATI,IND,0,8th Pass,9381000,75000,9306000
2761,6881,Kolangi. M,CHENNAI NORTH,IND,0,Literate,2000,0,2000
2762,2616,Kolar Kesava,KOLAR,JD(S),7,Graduate,168319791,75522284,92797507
2763,7645,Koli Patel Somabhai Gandalal,SURENDRANAGAR,INC,0,5th Pass,79184058,0,79184058
2764,3489,Kolsepatil Baban Gangadhar,AHMEDNAGAR,IND,3,Graduate Professional,337159952,2379701,334780251
2765,4519,Komatireddy Rajgopal Reddy,BHONGIR,INC,0,Graduate,667095133,6813472,660281661
2766,4527,Kommu Ramesh,KHAMMAM,IND,0,Post Graduate,50000,0,50000
2767,6837,Kompally Prabhudas,MEDAK,RPI(A),0,10th Pass,1901000,270000,1631000
2768,7918,Konda Raghava Reddy,CHEVELLA,Yuvajana Sramika Rythu Congress Party,0,Graduate,16905000,2500000,14405000
2769,1013,Konda Vishweshwar Reddy,CHEVELLA,TRS,0,Post Graduate,5286230210,74111133,5212119077
2770,5144,Kori Lal,TONK-SAWAI MADHOPUR,IND,0,5th Pass,2019500,0,2019500
2771,6493,Kotapati Narsimham Naidu,NIZAMABAD,IND,0,Graduate Professional,16711873,6452871,10259002
2772,5434,Kothandapani B,TIRUVANNAMALAI,IND,0,10th Pass,300000,0,300000
2773,2618,Kotiganahalli Ramaiah,KOLAR,AAP,0,12th Pass,7724963,1285958,6439005
2774,7876,Koyalkar Bhoj Raj,MALKAJGIRI,IND,0,8th Pass,0,0,0
2775,5400,Kranti Kumar Chandrakar,RAIPUR,IND,0,Graduate Professional,3748061,0,3748061
2776,4132,Kripa Shankar Bhagat,RAIGARH,BSP,0,Post Graduate,3141334,0,3141334
2777,4638,Kriparam Sidar,RAIGARH,GGP,0,8th Pass,7745000,400000,7345000
2778,1593,Kripashankar Yadav,CHHINDWARA,IND,0,12th Pass,1106345,0,1106345
2779,4965,Krishan Kumar Dixit,FARRUKHABAD,RASHTRIYA VIKLANG PARTY,0,12th Pass,3433843,0,3433843
2780,2313,Krishan Kumar Saran,CHURU,AAP,0,Graduate,20295507,3900000,16395507
2781,1047,Krishan Pal,FARIDABAD,BJP,0,Graduate Professional,296440144,19707475,276732669
2782,1649,Krishan Pal,BAGHPAT,Naitik Party,1,12th Pass,4414465,0,4414465
2783,7667,Krishan Sharma,AMRITSAR,Nav Bharat Democratic Party,0,12th Pass,485500,780000,0
2784,6189,Krishana Kumari Yadav,KHAGARIA,RJD,4,Graduate,78352261,1850000,76502261
2785,1605,Krishanpal,KAIRANA,IND,0,Literate,10804500,0,10804500
2786,3112,Krishna Adhikari,KHERI,CPI(ML)L,5,10th Pass,5000,0,5000
2787,76,Krishna Das,KARIMGANJ,BJP,0,12th Pass,2794334,0,2794334
2788,2901,Krishna Devi,BHIND,AAP,0,Graduate,11415750,1325000,10090750
2789,3417,Krishna Kumar Dadhich,AJMER,IND,0,Graduate,100000,0,100000
2790,6168,Krishna Kumar Paswan,DARBHANGA,IND,0,Graduate,22000,0,22000
2791,5401,Krishna Nandan Singh,RAIPUR,IND,0,Post Graduate,2220153,0,2220153
2792,3206,Krishna Raj,SHAHJAHANPUR,BJP,0,Post Graduate,16506411,3612812,12893599
2793,2969,Krishna Sharan,KHAJURAHO,Brihattar Bharat Prajatantra Sewa Party,0,Graduate,1600500,0,1600500
2794,648,Krishna Singh,KODARMA,JD(U),1,Literate,518000,0,518000
2795,4174,Krishna Singh,RAJMAHAL,IUML,0,12th Pass,680000,2680000,0
2796,872,Krishna Tirath,NORTH WEST DELHI,INC,0,Graduate,56882796,0,56882796
2797,6324,Krishnamoorthy A,DINDIGUL,DMDK,0,Graduate Professional,11703000,0,11703000
2798,7508,"Krishnamoorthy, K.",THENI,CPI(ML) Red Star,0,8th Pass,320000,0,320000
2799,614,Krishnamurthy,MANDYA,RPI(A),0,12th Pass,6110000,100000,6010000
2800,2560,Krishnamurthy.M,MANDYA,BSP,0,Post Graduate,839000,0,839000
2801,1902,Krishnan Eranhikkal,ALATHUR,SDPI,0,12th Pass,903301,20000,883301
2802,7469,Krishnan S,SIVAGANGA,CPI,0,Graduate Professional,7153000,1656914,5496086
2803,3945,Krishnan.M,NAMAKKAL,IND,0,Graduate Professional,1000,0,1000
2804,304,Krishnankutty M.K.,ERNAKULAM,CPI(ML) Red star,0,10th Pass,879121,40000,839121
2805,1904,Krishnankutty V,ALATHUR,IND,0,10th Pass,146988,6000,140988
2806,7457,Krishnasamy Vandayar.T,THANJAVUR,INC,0,Graduate Professional,173643172,11034462,162608710
2807,7576,Krishnasamy.A.,TENKASI,IND,0,8th Pass,447500,0,447500
2808,942,Krupal Balaji Tumane,RAMTEK,SHS,1,Graduate,46564362,216000,46348362
2809,1385,Krushnarao Ingle,BULDHANA,IND,0,Literate,206100,35000,171100
2810,5322,Kshatriya Birjusinh Motisinh,GANDHINAGAR,IND,0,12th Pass,115000,0,115000
2811,3601,Kshirsagar Shivaji Jagannath,OSMANABAD,IND,0,Post Graduate,6142200,0,6142200
2812,3602,Kshirsagar Vijay Maruti,OSMANABAD,IND,0,Post Graduate,90000,47500,42500
2813,1787,Kshitish Chandra Mandal,JALPAIGURI,BSP,0,Graduate,550000,0,550000
2814,2168,Kuber Vasudev Subbaji,HAVERI,IND,0,12th Pass,2996700,0,2996700
2815,3712,Kulamani Samal,JAGATSINGHPUR,BJD,0,Graduate Professional,25158570,0,25158570
2816,793,Kulamani Urma,BARGARH,Paschimanchal Vikas Party,0,8th Pass,153000,0,153000
2817,1054,Kuldeep Bishnoi,HISAR,Haryana Janhit Congress (BL),1,Graduate,786595116,104464405,682130711
2818,7911,Kuldeep Kumar,JHANSI,IND,0,Graduate,4185617,0,4185617
2819,122,Kuldeep Rai Sharma,ANDAMAN & NICOBAR ISLANDS,INC,0,Graduate Professional,31594826,5034619,26560207
2820,2011,Kuldeep S/O Ishwar Singh,HISAR,IND,0,Graduate,1522160,0,1522160
2821,2012,Kuldeep S/O Karan Singh,HISAR,IND,0,8th Pass,225700,0,225700
2822,2015,Kuldeep S/O Madan Lal,HISAR,IND,0,5th Pass,1012562,48000,964562
2823,2013,Kuldeep S/O Narain Singh,HISAR,IND,0,5th Pass,55000,0,55000
2824,2014,Kuldeep S/O Pardumn,HISAR,IND,0,Post Graduate,260000,102000,158000
2825,2016,Kuldeep S/O Sajjan,HISAR,IND,0,12th Pass,6548165,137000,6411165
2826,4083,Kuldeep Singh,MORENA,IND,1,Graduate,856024,0,856024
2827,1035,Kuldeep Singh,KURUKSHETRA,RPI,0,10th Pass,53708428,0,53708428
2828,6120,Kuldeep Singh,BATHINDA,BSP,0,10th Pass,8095000,0,8095000
2829,2007,Kuldeep Singh S/O Shishpal,HISAR,Bahujan Mukti Party,0,Post Graduate,25500,0,25500
2830,7711,Kuldip Kumar,JALANDHAR,IND,0,10th Pass,0,0,0
2831,2166,Kulkarni Chandrashekharayya Gurulingayya,HAVERI,IND,0,Graduate,1725000,20000,1705000
2832,7772,Kulwant Singh,FATEHGARH SAHIB,SAD,0,10th Pass,1396118874,174538688,1221580186
2833,7762,Kulwinder Pal Singh,LUDHIANA,IND,0,Graduate Professional,1140000,0,1140000
2834,4144,Kumait Ram Sandil,SURGUJA,IND,0,Post Graduate,3610829,200829,3410000
2835,2855,Kumar Chandra Mardi,JAMSHEDPUR,AAP,2,8th Pass,3820000,0,3820000
2836,6445,Kumar Chowdary Yadav,SECUNDERABAD,Samaikyandhra Parirakshana Samithi,0,8th Pass,13312000,70000,13242000
2837,2752,Kumar Indra Bhushan,PATALIPUTRA,IND,2,Graduate,9122284,285000,8837284
2838,2770,Kumar Rajiv,PATNA SAHIB,IND,0,Post Graduate,0,0,0
2839,1351,Kumar Vivek Gautam,EAST DELHI,IND,0,Graduate,390500,1900000,0
2840,7455,Kumar.P S/O Palaniappan,TIRUCHIRAPPALLI,IND,0,Graduate,1090000,155000,935000
2841,6990,Kumaran.V,DHARMAPURI,IND,0,Doctorate,2850000,0,2850000
2842,6339,Kumarasamy K.K,ERODE,AAP,0,Graduate Professional,11661670,2200000,9461670
2843,6242,Kumari Rita,MADHUBANI,SHS,0,Graduate,2555000,0,2555000
2844,2296,Kumbha Ram,GANGANAGAR,IND,1,12th Pass,3550978,0,3550978
2845,925,Kumbhare Hansraj Gulab,CHANDRAPUR,BSP,0,Post Graduate,551500,0,551500
2846,5251,Kumkum Singh,BHAGALPUR,Bharat Vikas Morcha,1,Doctorate,825000,0,825000
2847,6209,Kummari Giri,CHEVELLA,Pyramid Party of India,0,10th Pass,290000,0,290000
2848,2222,Kunaje Manjunatha Gowda,SHIMOGA,BSP,0,Graduate,1413790,0,1413790
2849,2766,Kunal Singh,PATNA SAHIB,INC,0,12th Pass,51271000,750000,50521000
2850,2757,Kundan Prasad Singh,PATALIPUTRA,AAP,0,12th Pass,4833000,0,4833000
2851,7930,Kundarapu Ramesh,NALGONDA,BSP,0,5th Pass,311578,0,311578
2852,6832,Kundeti Ravi,MEDAK,IND,0,Post Graduate,1332000,0,1332000
2853,5271,Kunj Bihar Paswan,PURNIA,IND,0,Literate,1266625,83000,1183625
2854,4143,Kunj Bihari Paikra,SURGUJA,Bahujan Mukti Party,0,Graduate Professional,2337000,125000,2212000
2855,351,Kunnil Shajahan,THIRUVANANTHAPURAM,SDPI,3,Graduate,1105500,350000,755500
2856,345,Kunnukuzhi S Mani,THIRUVANANTHAPURAM,IND,0,10th Pass,5000040,0,5000040
2857,1764,Kunwar Bhartendra,BIJNOR,BJP,2,Post Graduate,24840646,0,24840646
2858,4271,Kunwar Devendra Singh Yadav,ETAH,SP,1,Doctorate,1249971797,77123717,1172848080
2859,5527,Kunwar Pushpendra Singh,HAMIRPUR,BJP,1,Post Graduate,71265181,2825539,68439642
2860,3050,Kunwar Sarvraj Singh,AONLA,SP,0,Graduate Professional,25118224,0,25118224
2861,3117,Kunwer Sarvesh Kumar,MORADABAD,BJP,4,10th Pass,72866898,600000,72266898
2862,5695,Kuppayee R,SALEM,IND,0,12th Pass,150000,0,150000
2863,6330,Kuppuraj C,DINDIGUL,IND,0,Post Graduate,2160000,0,2160000
2864,7154,Kuppuramu .D,RAMANATHAPURAM,BJP,0,Graduate Professional,24225393,0,24225393
2865,3531,Kurane Ajay Prakash,KOLHAPUR,BSP,0,Graduate,2255800,0,2255800
2866,2084,Kusheshwar Bhagat,GURGAON,IND,0,8th Pass,181000,0,181000
2867,2090,Kusum Kumari,FARIDABAD,All India Peoples Front,0,Post Graduate,75167,0,75167
2868,412,Kusum Sherwal,AMBALA,INLD,0,Doctorate,21378240,696974,20681266
2869,2261,Kutub Ahmed Mazumder,SILCHAR,AIUDF,0,Graduate,1249603,190679,1058924
2870,2547,Kutubuddin Kazi,BAGALKOT,AAP,0,10th Pass,3002000,200000,2802000
2871,6532,Kuvarjibhai Mohanbhai Bavaliya,RAJKOT,INC,1,Graduate Professional,20465581,137692,20327889
2872,5506,Kuwar Jitin Prasad,DHAURAHRA,INC,0,Post Graduate,101050407,0,101050407
2873,3819,L.P.Yadunandana,TUMKUR,IND,0,Graduate,340000,0,340000
2874,6914,La.Ganesan,CHENNAI SOUTH,BJP,0,12th Pass,307000,0,307000
2875,571,Labha Ram,JAMMU,IND,0,12th Pass,860000,230000,630000
2876,6143,Lachhman Singh S/O S.Gulzar Singh,FATEHGARH SAHIB,IND,0,5th Pass,100000,0,100000
2877,7778,Lachhman Singh S/O S.Saroop Singh,FATEHGARH SAHIB,IND,2,10th Pass,1592500,360000,1232500
2878,823,Ladu Kishore Swain,ASKA,BJD,0,Graduate,3488390,25000,3463390
2879,3081,Laiq Ahmad,BAREILLY,Naitik Party,0,Not Given,1645600,9400,1636200
2880,4120,Lakhan Lahare,JANJGIR-CHAMPA,IND,0,Post Graduate,2584567,0,2584567
2881,3020,Lakhan Lal,TIKAMGARH,IND,0,12th Pass,482600,70000,412600
2882,5392,Lakhan Lal Chauhan,JANJGIR-CHAMPA,Bahujan Mukti Party,0,10th Pass,1603217,0,1603217
2883,5379,Lakhan Lal Sahu S/O Nandram Sahu,BILASPUR,IND,0,5th Pass,2236151,0,2236151
2884,5378,Lakhan Lal Sahu S/O Santram Sahu,BILASPUR,IND,0,8th Pass,250000,0,250000
2885,5380,Lakhan Sahu S/O Mahindar Sahu,BILASPUR,IND,0,Literate,52500,0,52500
2886,5375,Lakhan Sahu S/O Manohar Lal,BILASPUR,IND,0,5th Pass,2218603,0,2218603
2887,4227,Lakhan Singh,BHARATPUR,Peoples Green Party,0,8th Pass,2879000,0,2879000
2888,2935,Lakhan Singh Baghel,GUNA,BSP,0,Graduate,19797009,550000,19247009
2889,106,Lakhanlal Sau S/O Kalyan Lal Sahu,BILASPUR,BJP,0,Post Graduate,8661133,306357,8354776
2890,7730,Lakhvir Singh,HOSHIARPUR,Democratic Bharatiya Samaj Party,0,8th Pass,235000,0,235000
2891,7776,Lakhvir Singh,FATEHGARH SAHIB,JKNPP,0,5th Pass,72500,0,72500
2892,7865,Lakhwinder Singh Malhi,PATIALA,IND,0,12th Pass,108340000,576000,107764000
2893,4239,Lakkhiram,KARAULI-DHOLPUR,INC,0,Post Graduate,2915000,0,2915000
2894,237,Lakshi Kanta Kurmi,TEZPUR,CPI(ML)L,0,8th Pass,106200,0,106200
2895,2799,Lakshman Masturiya,MAHASAMUND,AAP,0,Post Graduate,2242689,0,2242689
2896,5232,Lakshman Singh,VIDISHA,INC,0,Graduate,83783624,17068702,66714922
2897,7606,Lakshmanan @ Lakkan.A,TIRUNELVELI,IND,0,8th Pass,12061000,0,12061000
2898,5006,Lakshmi,FATEHPUR SIKRI,AAP,1,Graduate,886000,0,886000
2899,7539,Lakshmi Gandan,VIRUDHUNAGAR,IND,4,Graduate Professional,446386,21500,424886
2900,1180,Lakshmi Hebbalkar,BELGAUM,INC,0,Post Graduate,83015088,2579238,80435850
2901,1330,Lakshmi Narayan,NEW DELHI,Bharatiya Bahujan Party,0,8th Pass,8202800,0,8202800
2902,6251,Lal Bahadur Sada,SAMASTIPUR,CPI(M),6,10th Pass,2077500,0,2077500
2903,1548,Lal Bahadur Singh,SIDHI,Samata Samadhan Party,0,10th Pass,312000,0,312000
2904,2760,Lal Bahadur Singh Patel,PATNA SAHIB,Krantikari Vikas Dal,1,10th Pass,830000,0,830000
2905,870,Lal Chand,BHIWANI-MAHENDRAGARH,Republican Backward Congress,0,Graduate,11484000,0,11484000
2906,755,Lal Das,JABALPUR,GGP,0,10th Pass,8070000,130000,7940000
2907,4012,Lal Jotindra Dev,RANCHI,Akhil Bhartiya Jharkhand Party,0,Post Graduate,7216000,0,7216000
2908,4596,Lal Krishna Advani,GANDHINAGAR,BJP,1,Graduate Professional,75915276,0,75915276
2909,482,Lal Say Kumar Bhagat,LOHARDAGA,CPI(ML)L,0,12th Pass,1319000,0,1319000
2910,4933,Lal Singh Tomar,AKBARPUR,SP,6,Post Graduate,42832429,12923479,29908950
2911,1562,Lala Kol,SHAHDOL,IND,0,8th Pass,130100,2000,128100
2912,4813,Lalchand,UJJAIN,IND,0,12th Pass,5915000,0,5915000
2913,1258,Laldev Ram,PALAMAU,Bahujan Mukti Party,0,12th Pass,7293888,0,7293888
2914,3695,Lalit Babar,SOLAPUR,AAP,0,Graduate,3798836,0,3798836
2915,1614,Lalit Chauhan,MUZAFFARNAGAR,JD(U),0,12th Pass,685000,0,685000
2916,5848,Lalit Gaurishankar Sharma,JALGAON,IND,0,10th Pass,1425150,150000,1275150
2917,866,Lalit Kumar,BHIWANI-MAHENDRAGARH,AAP,0,Graduate Professional,8922356,4625841,4296515
2918,5402,Lalit Kumar Patel,RAIPUR,IND,0,Graduate Professional,50000,0,50000
2919,2099,Lalit Mittal,FARIDABAD,IND,0,Post Graduate,4295126,0,4295126
2920,2246,Lalit Mohon Suklabaidya,KARIMGANJ,INC,2,Post Graduate,11328972,0,11328972
2921,3029,Lalit Singha,DARJEELING,Bahujan Mukti Party,0,8th Pass,269500,0,269500
2922,1967,Lalitha Malayalappuzha,PATHANAMTHITTA,IND,0,10th Pass,110000,0,110000
2923,7414,"Lalitha, K.",VELLORE,IND,0,10th Pass,470000,0,470000
2924,2657,Lallan Rup Narayan Pathak,BUXAR,IND,0,Doctorate,7750000,0,7750000
2925,2943,Lalli Ram Rai,GUNA,IND,0,Illiterate,131000,0,131000
2926,2730,Lallu Ram,NALANDA,Bahujan Mukti Party,0,Literate,61000,0,61000
2927,1164,Lambodar Kanhar,KANDHAMAL,IND,2,Graduate Professional,1303200,38000,1265200
2928,1010,Lamlalmoi@ Momoi Gangte,OUTER MANIPUR,CPI(ML)L,0,Graduate,800000,0,800000
2929,536,Lamminlien Gangte,OUTER MANIPUR,JD(U),0,Illiterate,5177000,0,5177000
2930,2721,Lata Sinha,NALANDA,IND,0,Post Graduate,2330367,64000,2266367
2931,7643,Lataben Ashokkumar Dwivedi,NAVSARI,IND,0,10th Pass,1794000,75000,1719000
2932,1138,Lawrencia Lakra,SUNDARGARH,IND,0,12th Pass,1500,0,1500
2933,2098,Laxman,FARIDABAD,IND,0,Not Given,127600,0,127600
2934,2463,Laxman,RAJSAMAND,Jai Maha Bharath Party,0,5th Pass,397073,18000,379073
2935,3486,Laxman Bhanudas Sonale,AHMEDNAGAR,IND,0,Graduate,3309077,0,3309077
2936,2452,Laxman Bhil,UDAIPUR,BSP,0,5th Pass,277900,0,277900
2937,7949,Laxman Bukya,MAHABUBABAD,IND,0,5th Pass,2360000,0,2360000
2938,2887,Laxman Giluwa,SINGHBHUM,BJP,4,12th Pass,8094301,108145,7986156
2939,4126,Laxman Lal Kaiwart,KORBA,Chhattisgarhiya Party,0,12th Pass,127580,0,127580
2940,6599,Laxmanbhai Chhaganbhai Vadia,VALSAD,CPI(ML)L,1,5th Pass,1104125,0,1104125
2941,4388,Laxmi,FIROZABAD,Bhartiya Shakti Chetna Party,0,Graduate,710078,20000,690078
2942,4393,Laxmi Narayan,FIROZABAD,Rashtriya Janwadi Party (Krantikari),0,Graduate,2658630,1571154,1087476
2943,3001,Laxmi Narayan Yadav,SAGAR,BJP,1,Post Graduate,23962099,956348,23005751
2944,5108,Laxmikant,KARAULI-DHOLPUR,IND,0,Graduate,51000,0,51000
2945,2454,Laxmilal Gameti,UDAIPUR,Socialist Party (India),0,Literate,255700,0,255700
2946,1583,Laxminarayan Dehariya,BALAGHAT,Bahujan Mukti Party,1,12th Pass,1710000,0,1710000
2947,7950,Laxminarayana Borra,MAHABUBABAD,IND,0,5th Pass,10000,0,10000
2948,5507,Lekhraj,DHAURAHRA,AITC,0,Graduate,335000,0,335000
2949,7485,Lenin M,SIVAGANGA,IND,0,12th Pass,148120,0,148120
2950,6219,Lenkala Prabhakar Reddy,KARIMNAGAR,Pyramid Party of India,0,Graduate,60000,0,60000
2951,1137,Lily Prema Kujur,SUNDARGARH,Bahujan Mukti Party,0,12th Pass,161000,0,161000
2952,4532,Lingala Ravi Kumar,KHAMMAM,IND,0,10th Pass,650000,0,650000
2953,7566,Lingam.P,TENKASI,CPI,1,Graduate,1407450,341191,1066259
2954,786,Lingaraj Pradhan,BARGARH,AAP,0,Post Graduate,2470000,0,2470000
2955,1174,Lingaraj Sabara@Gomango,KORAPUT,IND,0,Post Graduate,5462041,1123000,4339041
2956,3910,Lodhi Seema Kaushik,RAJNANDGAON,SP,0,8th Pass,10720000,1240000,9480000
2957,6928,Loganathan,CHENNAI SOUTH,IND,0,5th Pass,205500,0,205500
2958,5453,Loganathan P,TIRUVANNAMALAI,IND,0,10th Pass,180000,0,180000
2959,1436,Lokhande Ganesh Haibatrao,RAMTEK,IND,0,Graduate Professional,548000,600,547400
2960,3405,Lokhande Sadashiv Kisan,SHIRDI,SHS,1,10th Pass,38294539,1497168,36797371
2961,3995,Loknath Mahto,HAZARIBAGH,AJSUP,1,12th Pass,23139387,236074,22903313
2962,3095,Lotan Singh,BAREILLY,IND,5,10th Pass,1470000,0,1470000
2963,7720,Love Kishor,JALANDHAR,IND,0,Literate,48450,0,48450
2964,1710,Lt Col Sp Singh,GAUTAM BUDHHA NAGAR,Nav Bharat Democratic Party,0,Graduate,17777227,0,17777227
2965,7894,Lubna Sarwath,HYDERABAD,AAP,0,Doctorate,65500,0,65500
2966,1325,Lukman Khan,NEW DELHI,IND,2,5th Pass,3786699,0,3786699
2967,961,M .K Raghavan,KOZHIKODE,INC,0,Graduate,6164901,1558128,4606773
2968,7897,M A Habeeb,HYDERABAD,IND,1,10th Pass,141000,0,141000
2969,3831,M Ahamed Shahjahan,SALEM,IND,0,Post Graduate,4100000,0,4100000
2970,1889,M B Rajesh,PALAKKAD,CPI(M),11,Graduate Professional,4676316,700680,3975636
2971,3926,M C Mittal Jai Gurudeo Tatdhari,BHOPAL,IND,0,12th Pass,8070000,569170,7500830
2972,2234,M D Mainuddin Khan Alias Asfiya,UDUPI CHIKMAGALUR,IND,0,8th Pass,163000,0,163000
2973,724,M G Purushothaman,CHALAKUDY,BSP,0,Others,296000,78000,218000
2974,960,M I Shanavas,WAYANAD,INC,0,Post Graduate,27122055,7711000,19411055
2975,1009,M Khamchinpau Zou,OUTER MANIPUR,AAP,0,Post Graduate,1010616,0,1010616
2976,330,M M Paulose,ALAPPUZHA,IND,0,10th Pass,7322508,0,7322508
2977,1867,M Raghavan,KOZHIKODE,IND,0,10th Pass,20493829,0,20493829
2978,1206,M Shivanna,CHAMARAJANAGAR,JD(S),3,Graduate Professional,31402152,7852000,23550152
2979,402,M Veerappa Moily,CHIKKBALLAPUR,INC,0,Graduate Professional,137366682,39433827,97932855
2980,7487,M Venkatesan,MADURAI,IND,0,Post Graduate,2213164,620397,1592767
2981,6932,M. Arumugam,CHENNAI SOUTH,IND,0,8th Pass,374000,0,374000
2982,2489,M. Baby,KOLLAM,IND,0,10th Pass,1871596,0,1871596
2983,5572,M. Chittibabu,PONDICHERRY,IND,0,Graduate,7745000,0,7745000
2984,5862,M. Javed A. Wahab,JALNA,IND,0,12th Pass,10510000,0,10510000
2985,6950,M. Jayaraman,CHENNAI SOUTH,IND,0,Graduate,634836,0,634836
2986,4344,M. Karunakaran,TIRUCHIRAPPALLI,Lok Satta Party,0,Post Graduate,7319600,0,7319600
2987,2591,M. Kumbhaiah,CHITRADURGA,JD(U),0,Graduate Professional,38291000,4950000,33341000
2988,5584,M. Marie Uthriyanathan,PONDICHERRY,Samata Party,3,8th Pass,454250,478409,0
2989,6859,M. Mohamed Rasik,CHENNAI CENTRAL,IND,0,Graduate,100000,0,100000
2990,6855,M. Murugan,CHENNAI CENTRAL,IND,0,Graduate Professional,954117,0,954117
2991,1916,M. N. Kutty,THRISSUR,IND,0,10th Pass,4251600,120000,4131600
2992,6854,M. Prabakaran,CHENNAI CENTRAL,IND,0,10th Pass,6366720,215000,6151720
2993,4063,M. Ramadass,PONDICHERRY,IND,0,Doctorate,8094600,604861,7489739
2994,666,M. Shahid,MEERUT,BSP,0,5th Pass,1989984945,103807610,1886177335
2995,3830,M. Venkatesan,VILUPPURAM,CPI(ML)L,0,Graduate,781450,32500,748950
2996,337,M.A. Baby,KOLLAM,CPI(M),2,Graduate,6430619,625000,5805619
2997,6434,M.Anjan Kumar Yadav,SECUNDERABAD,INC,0,Graduate,18630800,2835000,15795800
2998,4044,M.Badhusha,TIRUCHIRAPPALLI,IND,0,Literate,815000,0,815000
2999,3958,M.Chandrakasi,CHIDAMBARAM,AIADMK,0,Graduate,7243646,2020472,5223174
3000,6299,M.Durairaj,ARANI,IND,0,Post Graduate,350000,0,350000
3001,4332,M.Gopalakrishnan,MADURAI,IND,6,10th Pass,3798200,1040000,2758200
3002,6289,M.K.Vishnu Prasad,ARANI,INC,1,Graduate Professional,110571761,23691877,86879884
3003,4328,M.Kamacis,MADURAI,AAP,0,Graduate Professional,4494623,966227,3528396
3004,5477,M.Kathirvel,VILUPPURAM,IND,0,5th Pass,1501500,0,1501500
3005,1043,M.Lalmanzuala,MIZORAM,AAP,0,Graduate,63800000,0,63800000
3006,4849,M.M. Abdul Bari,MURSHIDABAD,IUML,0,Others,444293,0,444293
3007,1203,M.Mahesh Alias Harsha,HASSAN,IND,0,10th Pass,37777,0,37777
3008,7490,M.Meenakshisundaram,MADURAI,IND,0,Post Graduate,4235311,80000,4155311
3009,4331,M.Mohammed Ali,MADURAI,Samata Party,0,5th Pass,245086,0,245086
3010,3951,M.Mohandass,TIRUCHIRAPPALLI,IND,0,Graduate,21687000,2745000,18942000
3011,3790,M.Muniyappa,KOLAR,IND,0,8th Pass,2060000,0,2060000
3012,6302,M.Munusamy,ARANI,IND,0,8th Pass,296000,0,296000
3013,7878,M.Nageswara Rao,MALKAJGIRI,IND,0,Post Graduate,6469266,0,6469266
3014,125,M.P. Sayed Mohammaed Koya,LAKSHADWEEP,BJP,0,Graduate,14073985,0,14073985
3015,6370,M.P.Mannan,KALLAKURICHI,IND,0,Post Graduate,567061,0,567061
3016,2519,M.P.Munawer Shariff,BANGALORE RURAL,IND,0,Others,25000,0,25000
3017,4306,M.Palanisamy,TIRUPPUR,IND,0,10th Pass,7050442,1000000,6050442
3018,3966,M.Pushparayan,THOOTHUKKUDI,AAP,380,Literate,8775806,0,8775806
3019,7435,M.Rajendran,TIRUPPUR,IND,0,12th Pass,300000,0,300000
3020,2227,M.S. Mainuddin,SHIMOGA,IND,0,10th Pass,160000,0,160000
3021,3793,M.S.Narayanaswamy,KOLAR,IND,0,10th Pass,1000,0,1000
3022,3837,M.Saravanan,SIVAGANGA,IND,0,12th Pass,3870000,0,3870000
3023,7537,M.Satheesh,VIRUDHUNAGAR,IND,0,Graduate,206911,0,206911
3024,7419,M.Senthilnathan,TIRUPPUR,DMK,0,Post Graduate,203278896,127959469,75319427
3025,958,M.T. Ramesh,PATHANAMTHITTA,BJP,0,Graduate,1039808,0,1039808
3026,7885,M.T.Varughese,MALKAJGIRI,IND,0,8th Pass,11230422,303440,10926982
3027,5476,M.Umashankar,VILUPPURAM,IND,0,Literate,30000,0,30000
3028,4059,M.V. Omalingam,PONDICHERRY,AIADMK,0,Others,26412176,21600000,4812176
3029,5336,Maadam Poonamben Hematbhai,JAMNAGAR,BJP,0,Graduate,174372249,62824615,111547634
3030,2134,Machendar,BIDAR,IND,0,Post Graduate,11000000,550000,10450000
3031,1058,Machindra Kadapure,CHIKKODI,BSP,0,Illiterate,101000,0,101000
3032,5329,Madam Vikrambhai Arjanbhai,JAMNAGAR,INC,0,Graduate,25946450,1816432,24130018
3033,7823,Madan Bhatti,SANGRUR,BSP,0,10th Pass,6166306,326000,5840306
3034,3071,Madan Lal,BADAUN,National Party,0,10th Pass,1447000,0,1447000
3035,5403,Madan Lal Sahu,RAIPUR,CPI(ML) Red Star,0,Graduate,2176006,460586,1715420
3036,575,Madan Lal Sharma,JAMMU,INC,0,10th Pass,18843802,384929,18458873
3037,4704,Madan Mohan Ram,DHANBAD,BSP,6,10th Pass,672000,0,672000
3038,2951,Madan Mohan Singh Tomar,GWALIOR,Bhartiya Jan Yug Party,0,12th Pass,4795500,8704,4786796
3039,4098,Madhab Rajbangshi,MANGALDOI,AGP,0,Graduate Professional,6779962,5480000,1299962
3040,3218,Madhaba Sardar,KEONJHAR,INC,0,Post Graduate,1757015,99665,1657350
3041,7551,"Madhavan, P.",VIRUDHUNAGAR,IND,0,5th Pass,2105703,0,2105703
3042,7466,Madhavan.T,THANJAVUR,IND,0,Not Given,441000,106842,334158
3043,7387,"Madhavaraj, K.V. Thiru.",SRIPERUMBUDUR,IND,1,12th Pass,95307,2225,93082
3044,7296,Madhu Nirupaben Natvarlal,BANASKANTHA,IND,0,Graduate Professional,254630,0,254630
3045,3709,"Madhu Sudan Yadav,",BHUBANESWAR,BSP,0,Graduate,2050000,1440,2048560
3046,2264,Madhu Sudhan Das,SILCHAR,IND,0,12th Pass,72053,0,72053
3047,6499,Madhu Yaskhi Goud,NIZAMABAD,INC,0,Post Graduate,301357021,5098943,296258078
3048,3863,Madhukar Baburao Kambale,SANGLI,IND,0,8th Pass,742800,0,742800
3049,5098,Madhuri Pushker,BHARATPUR,IND,0,12th Pass,7863409,0,7863409
3050,5818,Madhusudan Bag,ARAMBAG,BJP,0,Post Graduate,5472260,1341710,4130550
3051,1816,Magadum Ismail Magadum,CHIKKODI,IND,1,10th Pass,2027500,600000,1427500
3052,7577,Magesh.S.,TENKASI,IND,0,Graduate,20000,0,20000
3053,498,Mahabal Mishra,WEST DELHI,INC,1,12th Pass,388226286,8691614,379534672
3054,36,Mahabali Singh,KARAKAT,JD(U),5,8th Pass,33437255,0,33437255
3055,2337,Mahabeer Prasad Kumawat,JHUNJHUNU,IND,0,10th Pass,1516293,0,1516293
3056,3383,Mahadeo Jagannath Jankar,BARAMATI,Rashtriya Samaj Paksha,0,Others,6874700,0,6874700
3057,2112,Mahadev Bhimsha,GULBARGA,BSP,1,Graduate,9222545,825000,8397545
3058,5245,Mahadev Kumar,BHAGALPUR,IND,1,10th Pass,2182100,185000,1997100
3059,2871,Mahadev Ravinath Pahan,KHUNTI,Rashtriya Deshaj Party,0,12th Pass,2137028,0,2137028
3060,3744,Mahadeva Swamy. B. M,BANGALORE SOUTH,Bharatiya Dr. B.R.Ambedkar Janta Party,0,12th Pass,812200,586200,226000
3061,3495,Mahadik Prahlad Dagadu,BARAMATI,IND,0,12th Pass,20105000,355000,19750000
3062,7535,Mahalingam,VIRUDHUNAGAR,Desiya Forward Bloc,0,5th Pass,2906722,810000,2096722
3063,3283,Mahameghabahan Aira Kharabela Swain,CUTTACK,Aama Odisha Party,0,Post Graduate,3225000,0,3225000
3064,5070,Mahant Chand Nath Yogi,ALWAR,BJP,0,Graduate,199653,0,199653
3065,3923,Mahant Gopal Das Baba Shahab,BHOPAL,IND,0,Literate,108000,0,108000
3066,4915,Maharaj Singh Dhangar,AGRA,SP,0,5th Pass,25798815,1095365,24703450
3067,5056,Maharam Singh,MATHURA,Bahujan Mukti Party,0,Post Graduate,24535,0,24535
3068,1576,Mahatalal Barkade,MANDLA,National Peoples Party,0,8th Pass,208000,0,208000
3069,1560,Mahaveer Parshad Manjhi,SHAHDOL,IND,0,8th Pass,4568000,0,4568000
3070,2069,Mahavir Singh,BHIWANI-MAHENDRAGARH,IND,0,12th Pass,130100,0,130100
3071,3969,Mahboob Alam Ansari,BANKA,Bharatiya Momin Front,0,Post Graduate,8071913,0,8071913
3072,5218,Mahemood Bhaijaan,DHULE,Awami Vikas Party,0,Graduate Professional,964000,235000,729000
3073,2086,Mahender Jat,GURGAON,IND,0,Graduate Professional,10206000,400000,9806000
3074,2794,Mahendra Gawade,KANKER,IND,0,12th Pass,306413,0,306413
3075,3435,Mahendra K. Choudhary,JALORE,IND,0,12th Pass,26113500,0,26113500
3076,3998,Mahendra Kishor Mehta,HAZARIBAGH,IND,0,10th Pass,1035500,0,1035500
3077,2405,Mahendra Kumar,KOTA,IND,0,10th Pass,259127,0,259127
3078,2940,Mahendra Kumar,GUNA,IND,1,Graduate,1760000,320000,1440000
3079,6723,Mahendra Kumar,MOHANLALGANJ,Awami Samta Party,0,12th Pass,114000,0,114000
3080,4223,Mahendra Kumar,BHARATPUR,BSP,0,10th Pass,21762465,1275000,20487465
3081,3006,Mahendra Kumar Choudhary,SAGAR,Bahujan Mukti Party,0,Post Graduate,146079,0,146079
3082,1788,Mahendra Kumar Roy,JALPAIGURI,CPI(M),0,Graduate,10695976,0,10695976
3083,4737,Mahendra Murmu,GODDA,Jharkhand Vikas Dal,0,Post Graduate,1658000,0,1658000
3084,483,Mahendra Oraon,LOHARDAGA,IND,0,12th Pass,2180000,20000,2160000
3085,1795,Mahendra Prasad Lama,DARJEELING,IND,0,Doctorate,34438296,3900024,30538272
3086,2919,Mahendra Pratap Singh,DAMOH,INC,0,Post Graduate,28167705,100395,28067310
3087,1251,Mahendra Ravidas,KODARMA,Bahujan Mukti Party,0,Graduate,889868,133210,756658
3088,5932,Mahendra Tulshiram Bhingardive,MUMBAI SOUTH CENTRAL,IND,0,Graduate,12615000,618747,11996253
3089,7056,"Mahendran, T.",KARUR,IND,0,12th Pass,584794,0,584794
3090,6895,Mahendran. K.P.P.,CHENNAI NORTH,IND,0,10th Pass,481953,0,481953
3091,7148,Mahendran. M,POLLACHI,IND,0,Literate,13000,9000,4000
3092,7137,Mahendran.C,POLLACHI,AIADMK,0,Post Graduate,231430367,18128825,213301542
3093,3078,Mahendrapal,BADAUN,Bhartiya Shakti Chetna Party,0,10th Pass,4300000,0,4300000
3094,3048,Mahesh,AMROHA,RPI(A),0,12th Pass,340000,0,340000
3095,1718,Mahesh,GAUTAM BUDHHA NAGAR,IND,0,Graduate Professional,3101000,0,3101000
3096,5492,Mahesh,BARABANKI,IND,0,Post Graduate,4430000,0,4430000
3097,3722,Mahesh Basappa Nandihal,BAGALKOT,Karunaadu Party,1,Graduate,2340300,434000,1906300
3098,3469,Mahesh Bhandari,PALI,AAP,0,Post Graduate,176779000,14241000,162538000
3099,2965,Mahesh Chandra,KHAJURAHO,Rashtriya Samanta Dal,0,Others,3472884,0,3472884
3100,98,Mahesh Chandra Mohanty,ASKA,BJP,0,Graduate,2702481,1021000,1681481
3101,769,Mahesh Dubey,CHHINDWARA,AAP,0,Graduate,500000,0,500000
3102,67,Mahesh Giri,EAST DELHI,BJP,1,10th Pass,5216375,400000,4816375
3103,4137,Mahesh Harpaal,RAIPUR,Shakti Sena (Bharat Desh),0,10th Pass,500000,0,500000
3104,7254,Mahesh Jaysing Pawara,NANDURBAR,IND,0,Graduate,300000,0,300000
3105,2375,Mahesh Joshi,JAIPUR,INC,0,Doctorate,29252918,4781745,24471173
3106,5778,Mahesh Kumar,MOHANLALGANJ,IND,1,Illiterate,788930,0,788930
3107,2407,Mahesh Kumar Raniwal,KOTA,AARAKSHAN VIRODHI PARTY,0,8th Pass,281100,0,281100
3108,4107,Mahesh Mandal,KATIHAR,Bahujan Mukti Party,3,Doctorate,1821376,0,1821376
3109,2735,Mahesh Paswan,NALANDA,Bharat Bhrashtachar Mitao Party,1,Graduate,1930000,0,1930000
3110,5057,Mahesh Pratap Sharma,MATHURA,Rashtriya Vikas Party,0,Graduate Professional,18881596,0,18881596
3111,60,Mahesh Sharma,GAUTAM BUDHHA NAGAR,BJP,0,Graduate Professional,473797545,40905738,432891807
3112,1232,Mahesh Singh Yadav,CHATRA,JD(U),0,Graduate,44079939,3281756,40798183
3113,5907,Mahesh Waman Manjrekar,MUMBAI NORTH WEST,MNS,0,12th Pass,58319993,25240470,33079523
3114,6247,Maheshwar Hazari,SAMASTIPUR,JD(U),0,Graduate,21464499,6941446,14523053
3115,1524,Mahgoo,SATNA,Dalit Vikas Party(Bharat),0,Graduate,3027000,0,3027000
3116,4566,Mahida Mahendrasinh Sahebsinh,ANAND,SP,0,12th Pass,4085000,0,4085000
3117,2202,Mahima J Patel,DAVANAGERE,JD(S),0,Graduate Professional,29683292,1245000,28438292
3118,442,Mahinder Pal,KARNAL,IND,0,5th Pass,8401000,8000000,401000
3119,7696,Mahinder Singh Hamira,KHADOOR SAHIB,IND,1,5th Pass,2525000,0,2525000
3120,7633,Mahmad Azam Haiderkhan Pathan,MAHESANA,IND,1,8th Pass,2522354,0,2522354
3121,7831,Mahmood Ahmed Thind,SANGRUR,IUML,0,Graduate Professional,2930897,400000,2530897
3122,2037,Mahmood Hassan,KARNAL,IND,0,8th Pass,1622345,640000,982345
3123,6397,Mahmood Mohiuddin,ZAHIRABAD,Yuvajana Sramika Rythu Congress Party,1,8th Pass,40351658,11150000,29201658
3124,6577,Majethiya Samratbhai Jerambhai,SURENDRANAGAR,Hindustan Janta Party,0,Literate,2758000,0,2758000
3125,7808,Makhan Lal,BATHINDA,Bahujan Samaj Party (Ambedkar),0,8th Pass,91000,0,91000
3126,4243,Makkhan,TONK-SAWAI MADHOPUR,IND,9,10th Pass,45453872,12102619,33351253
3127,6775,Makkhan Sah,KHAGARIA,Samajwadi Janata Party (Rashtriya),0,Graduate,6470304,0,6470304
3128,5970,Maksud Iliyas Khan,NASHIK,IND,1,10th Pass,134285,530000,0
3129,7634,Maksud Mirza,NAVSARI,INC,0,10th Pass,570000,0,570000
3130,5290,Makwana Ishwarbahi Dhanabhai,AHMEDABAD WEST,INC,1,Graduate,9355477,550000,8805477
3131,6579,Makwana Ukabhai Amrabhai,SURENDRANAGAR,IND,0,Graduate Professional,690000,0,690000
3132,7649,Makwana Vasharambhai Karshanbhai,SURENDRANAGAR,IND,0,Post Graduate,129000,0,129000
3133,6649,Mala Devi,DHAURAHRA,VANCHITSAMAJ INSAAF PARTY,0,12th Pass,597500,0,597500
3134,2160,Malagi Shivakumar Giriyappa,BELLARY,AAP,0,Post Graduate,8580500,0,8580500
3135,2471,Malam Singh,BARMER,BSP,0,Post Graduate,1752238,530000,1222238
3136,6437,Malathi Latha Eppa,SECUNDERABAD,Jantantra Party,0,Post Graduate,4227860,2423000,1804860
3137,4613,Malek Sabirhusen Ismaelbhai,KHEDA,IND,0,8th Pass,75000,0,75000
3138,4617,Malek Sadikhusen Mahmadhusen,KHEDA,IND,0,8th Pass,165000,0,165000
3139,7627,Malek Yakubmiya Nabimiya,KHEDA,IND,0,10th Pass,1038000,0,1038000
3140,5824,Mali Sharad Sahebrao,DINDORI,BSP,0,12th Pass,210000,0,210000
3141,6495,Malik Mohtasim Ali Khan,NIZAMABAD,Welfare Party Of India,0,Post Graduate,1975000,0,1975000
3142,2790,Malik Ram Thakur,KANKER,Ambedkarite Party of India,0,10th Pass,2397500,805000,1592500
3143,4977,Malikhan Singh,FARRUKHABAD,IND,0,Graduate Professional,1322500,0,1322500
3144,1568,Malkhan Patel,JABALPUR,IND,0,Not Given,1738000,0,1738000
3145,7697,Mallesh Yadav Barla,KARIMNAGAR,IND,0,Graduate,1020000,120000,900000
3146,2517,Mallesha,BANGALORE RURAL,IND,0,12th Pass,407000,500000,0
3147,358,Mallikarjun Kharge,GULBARGA,INC,0,Graduate Professional,102220880,7410154,94810726
3148,1763,Malook Nagar,BIJNOR,BSP,0,Graduate,2896200000,33733000,2862467000
3149,441,Mam Chand,KARNAL,CPI,0,Illiterate,37120000,2100000,35020000
3150,7352,Mamad Haji Bolim,JAMNAGAR,IND,1,Literate,440000,0,440000
3151,7518,Mamallan Tha. Kanagamuthu,THENI,IND,0,Doctorate,8341084,0,8341084
3152,4772,Mamata Bhati,INDORE,Rashtriya Ahinsa Manch,0,8th Pass,251000,0,251000
3153,3237,Mamata Kundu,BALASORE,AAP,0,Graduate,15105000,4500000,10605000
3154,7549,"Mammathan, M.",VIRUDHUNAGAR,IND,0,8th Pass,607100,89100,518000
3155,4228,Mamraj,BHARATPUR,IND,0,10th Pass,2274195,505006,1769189
3156,387,Mamta Kumari,GAYA,SP,0,12th Pass,4195976,5454,4190522
3157,435,Mamta Rani,HISAR,"Rashtrawadi Parivartan Party (L.B,)",0,8th Pass,3922079,138000,3784079
3158,6016,Mamtaz Sanghamita,BARDHAMAN-DURGAPUR,AITC,0,Post Graduate,107680000,0,107680000
3159,142,Mamun Imdadul Haque Chawdhury,LAKHIMPUR,AIUDF,0,Post Graduate,567483,0,567483
3160,2880,Man Singh Mardi,RANCHI,Jharkhand Party (Naren),0,12th Pass,40000,0,40000
3161,1566,Manak Lal Gontiya,JABALPUR,Ambedkarite Party of India,0,8th Pass,220000,0,220000
3162,2692,Mananjay Kumar,JAHANABAD,IND,0,Graduate,3527000,0,3527000
3163,3434,Manara Ram,JALORE,IND,0,Illiterate,35000,0,35000
3164,4830,Manas Chakraborty,BALURGHAT,CPI(ML) Red Star,0,10th Pass,30500,0,30500
3165,3313,Manas Kumar Behera,JAGATSINGHPUR,IND,0,Post Graduate,7105375,163500,6941875
3166,3352,Manas Ranjan Mishra,BHUBANESWAR,IND,0,Post Graduate,38090100,0,38090100
3167,6061,Manasa Sen,SREERAMPUR,Welfare Party Of India,0,Post Graduate,174000,0,174000
3168,3271,Manasi Swain,DHENKANAL,SUCI(C),3,Post Graduate,453116,950000,0
3169,468,Manbodh Baghel,BASTAR,BSP,0,Graduate Professional,1405000,0,1405000
3170,3633,Manchak Trimbakrao Karale,PUNE,IND,0,Literate,1575000,0,1575000
3171,7747,Mandeep Singh Bittu,ANANDPUR SAHIB,IND,0,Post Graduate,247000,0,247000
3172,2095,Mandheer Singh Maan,FARIDABAD,IND,0,10th Pass,40072745,0,40072745
3173,3506,Mane Arvind Bhiva,HATKANANGLE,IND,0,12th Pass,557300,400000,157300
3174,2990,Maneesh Kumar Rawat,MORENA,Jai Maha Bharath Party,0,Graduate Professional,511000,0,511000
3175,7044,"Maneeshankar, M.G.",KARUR,Rashtriya Samaj Paksha,0,Graduate Professional,50000,650000,0
3176,3154,Maneka Sanjay Gandhi,PILIBHIT,BJP,1,12th Pass,374132826,219202,373913624
3177,6725,Mangal Sain,RAE BARELI,IND,0,Not Given,30000,0,30000
3178,7787,Mangat Ram Manga,FARIDKOT,SHS,0,Not Given,160000,0,160000
3179,437,Mange Ram,HISAR,BSP,0,12th Pass,14755486,0,14755486
3180,419,Mange Ram,SIRSA,BSP,0,Graduate,6507759,0,6507759
3181,661,Mange Ram Kashyap,MUZAFFARNAGAR,Majdoor Kisan Union Party,0,Graduate Professional,2663000,0,2663000
3182,7242,Mangesh Madhukar Humne,MUMBAI NORTH WEST,Bahujan Mukti Party,0,Graduate Professional,4048000,0,4048000
3183,2435,Mangi Lal Solanki,CHITTORGARH,Bahujan Mukti Party,0,10th Pass,11050206,70800,10979406
3184,2474,Mangilal,BARMER,AAP,0,Post Graduate,11414442,556105,10858337
3185,2298,Mangilal Nayak,BIKANER,National Unionist Zamindara Party,0,Graduate,1060000,0,1060000
3186,4204,Mangilal Urf Kranti Parivartan,MANDSOUR,BSP,0,Post Graduate,234900,0,234900
3187,1542,Mangleshwar Bhaiya,REWA,Naya Daur Party,0,12th Pass,760000,0,760000
3188,6181,Mangni Lal Mandal,JHANJHARPUR,RJD,3,Post Graduate,76950805,1654819,75295986
3189,5842,Mango Pundlik Pagare,JALGAON,Rashtravadi Janata Party,0,Doctorate,55000,30000,25000
3190,5075,Mangu Ram Sain,ALWAR,Akhil Bharatiya Congress Dal (Ambedkar),0,12th Pass,72000,0,72000
3191,249,Mani Charenamei,OUTER MANIPUR,IND,0,Graduate,11422552,1108000,10314552
3192,7076,Mani Shankar Aiyar,MAYILADUTHURAI,INC,0,Post Graduate,84319020,4526676,79792344
3193,7127,"Mani, P.",PERAMBALUR,IND,0,10th Pass,2163000,0,2163000
3194,7520,"Mani, S.V.",THENI,IND,0,8th Pass,956543,112054,844489
3195,7066,Mani.G.K,KRISHNAGIRI,Pattali Makkal Katchi,11,Graduate,4704309,0,4704309
3196,7529,Manickam Tagore,VIRUDHUNAGAR,INC,1,Graduate Professional,17292470,4953498,12338972
3197,7057,"Manickavasagam, A.",KARUR,IND,0,Graduate,8874100,0,8874100
3198,4991,Manik,FATEHPUR SIKRI,Lok Dal,0,10th Pass,372000,0,372000
3199,5376,Manik Dahariya,BILASPUR,IND,0,8th Pass,251500,150000,101500
3200,7034,Manikandan I.,KANNIYAKUMARI,IND,1,12th Pass,2000,0,2000
3201,5444,Manikkavel M R,TIRUVANNAMALAI,JD(S),0,10th Pass,1030000,0,1030000
3202,3856,Manikrao Madhavrao Bavne,BEED,SP,0,Post Graduate,39351000,80000,39271000
3203,4703,Manilal Mahto,DHANBAD,IND,0,12th Pass,750860,0,750860
3204,6176,Manilal Sahu,JHANJHARPUR,BSP,0,5th Pass,3001000,0,3001000
3205,7413,"Manimaran, M.",VELLORE,IND,0,8th Pass,0,0,0
3206,2897,Manish Katroliya,BHIND,BSP,0,Post Graduate,3179334,0,3179334
3207,396,Manish Kumar,NAWADA,IND,2,Graduate,1798755,428000,1370755
3208,1414,Manish Vinayakrao Telrandhe,WARDHA,IND,1,Graduate,4316000,162000,4154000
3209,6337,Manivannan N,DINDIGUL,IND,0,Post Graduate,920000,70000,850000
3210,7177,Manivasagam,RAMANATHAPURAM,IND,0,Graduate,900000,0,900000
3211,1917,Maniyangattil Sukumaran,THRISSUR,IND,0,Literate,281000,0,281000
3212,7718,Manjeet Kaur W/O Sukhdev Singh,JALANDHAR,IND,0,5th Pass,3857563,1826097,2031466
3213,2004,Manjeet Singh,SIRSA,IND,0,5th Pass,710000,0,710000
3214,1353,Manjeet Singh,EAST DELHI,IND,0,Graduate Professional,143000,60000,83000
3215,7719,Manjit Kaur W/O Sukhwinder Singh,JALANDHAR,IND,0,Graduate,2582974,0,2582974
3216,28,Manju Chhibber,EAST DELHI,RPI(A),0,Graduate,31380000,0,31380000
3217,3142,Manju Devi,NAGINA,Lok Dal,0,10th Pass,266013,0,266013
3218,2680,Manju Devi,JAHANABAD,Krantikari Vikas Dal,1,Literate,1110000,0,1110000
3219,1245,Manju Kumari,KODARMA,AITC,0,Post Graduate,2598000,0,2598000
3220,2611,Manju. A.,HASSAN,INC,0,Graduate Professional,165271740,1131586,164140154
3221,3777,Manjunatha,HASSAN,Bharatiya Dr. B.R.Ambedkar Janta Party,0,5th Pass,150000,0,150000
3222,2235,Manjunatha G,UDUPI CHIKMAGALUR,IND,0,12th Pass,0,0,0
3223,4836,Manjur Alahi Munshi,MALDAHA DAKSHIN,IND,0,10th Pass,4835000,0,4835000
3224,7578,"Manmathan,M.",TENKASI,IND,0,8th Pass,607100,89100,518000
3225,3986,Mannu Lal Parganiha,DURG,Chhattisgarh Swabhiman Manch,0,8th Pass,3912484,0,3912484
3226,4761,Manohar Ahiriya,DEWAS,IND,0,12th Pass,985000,0,985000
3227,1119,Manohar Baliram Sonone,AMRAVATI,IND,1,12th Pass,5006000,1705000,3301000
3228,4025,Manohar Sinku,SINGHBHUM,BSP,0,Graduate,2228000,0,2228000
3229,1779,Manohar Tirkey,ALIPURDUARS,Revolutionary Socialist Party,0,10th Pass,10594756,0,10594756
3230,4178,Manohar Untwal,DEWAS,BJP,0,12th Pass,6336490,1448086,4888404
3231,1093,Manohar.H.Ayyannavar,BANGALORE NORTH,IND,0,Graduate Professional,12862871,0,12862871
3232,1805,Manoharan K,KASARAGOD,IND,2,Graduate,171100,0,171100
3233,7138,Manoharan.M,POLLACHI,BSP,0,Graduate Professional,2602000,0,2602000
3234,835,Manoj Choudhury,BERHAMPUR,AITC,0,10th Pass,163000,0,163000
3235,1270,Manoj Kumar,ROHTAK,BSP,0,12th Pass,13590000,0,13590000
3236,1261,Manoj Kumar,PALAMAU,RJD,1,Graduate,8357000,2350000,6007000
3237,1252,Manoj Kumar,KODARMA,IND,0,Post Graduate,8410000,10000,8400000
3238,2052,Manoj Kumar,SONIPAT,IND,0,Graduate Professional,5915698,685000,5230698
3239,7840,Manoj Kumar,SANGRUR,IND,0,Graduate Professional,3406000,0,3406000
3240,5541,Manoj Kumar,JALAUN,Bharatiya Republican Paksha,0,8th Pass,105000,0,105000
3241,629,Manoj Kumar Manjhi,JAMUI,IND,0,12th Pass,121000,150000,0
3242,7797,Manoj Kumar Monga,FIROZPUR,IND,0,Not Given,377500,0,377500
3243,6047,Manoj Kumar Pandey,HOWRAH,INC,2,Graduate,4421059,0,4421059
3244,4740,Manoj Kumar Ray,GODDA,IND,0,10th Pass,50500,0,50500
3245,4405,Manoj Kumar Soni,HATHRAS,BSP,0,Post Graduate,130780329,3900000,126880329
3246,4825,Manoj Kumar Yadav,VIDISHA,SP,0,Post Graduate,3545837,740000,2805837
3247,5111,Manoj Rajoria,KARAULI-DHOLPUR,BJP,0,12th Pass,28636113,3277324,25358789
3248,5730,Manoj Singh,LUCKNOW,IND,1,Post Graduate,27343000,0,27343000
3249,66,Manoj Tiwari,NORTH EAST DELHI,BJP,0,Post Graduate,199483924,34645630,164838294
3250,2085,Manoj Yadav,GURGAON,IND,0,12th Pass,3298000,1450000,1848000
3251,239,Manorom Gogoi,JORHAT,AAP,0,Post Graduate,6659665,1647593,5012072
3252,5265,Manowar Alam,KISHANGANJ,Janta Dal Rashtravadi,0,12th Pass,465813,215,465598
3253,7777,Manpreet Singh,FATEHGARH SAHIB,IND,0,10th Pass,150000,0,150000
3254,7750,Manpreet Singh Ayali,LUDHIANA,SAD,0,12th Pass,191314896,5122189,186192707
3255,7801,Manpreet Singh Badal S/O Gurdas Singh,BATHINDA,INC,0,Graduate Professional,421140137,42757722,378382415
3256,6118,Manpreet Singh Badal S/O Gurdev Singh,BATHINDA,IND,0,10th Pass,740000,0,740000
3257,4732,Manraj,GODDA,BSP,0,Post Graduate,22084558,0,22084558
3258,2442,Manshankar Ninama,BANSWARA,BJP,0,8th Pass,4040285,870146,3170139
3259,6713,Mansharam Gautam,MISRIKH,CPI(ML)L,0,8th Pass,1756000,0,1756000
3260,799,Mansid Ekka,SUNDARGARH,IND,2,12th Pass,630000,280000,350000
3261,7648,Mansinh Shivubha Zala,SURENDRANAGAR,IND,0,5th Pass,801500,0,801500
3262,4492,Mansoor Alam,PURNIA,SP,0,12th Pass,7196656,600000,6596656
3263,6523,Mansukh Sundaraji Dhokai,PORBANDAR,AAP,0,Graduate,11801815,0,11801815
3264,4581,Mansukhbhai Dhanjibhai Vasava,BHARUCH,BJP,0,Post Graduate,6571062,639000,5932062
3265,6613,Mansuri Mukhatyar Mohammad,PANCHMAHAL,IND,2,10th Pass,698000,0,698000
3266,4716,Mantosh Kumar Mandal,DHANBAD,Amra Bangalee,0,Post Graduate,2025930,0,2025930
3267,530,Mantu Saikia,KALIABOR,IND,0,10th Pass,5575521,6168003,0
3268,3367,Manuel Sabino D'Souza,MAVAL,IND,0,Graduate,647000,0,647000
3269,7936,Manupuri Daya Sagar,NALGONDA,Pyramid Party of India,0,Graduate,1189058,0,1189058
3270,5599,Manyar Shai. Sajid Shai. Kadar,RAVER,Minorities Democratic Party,0,Graduate,42000,0,42000
3271,1962,Manzoor Thengana,PATHANAMTHITTA,SDPI,1,Others,43900000,0,43900000
3272,174,Maraganna Hunnur,BIJAPUR,IND,0,Graduate,375000,0,375000
3273,7006,Maragatham K,KANCHEEPURAM,AIADMK,0,12th Pass,18949050,4468600,14480450
3274,7014,Maragatham M,KANCHEEPURAM,IND,0,8th Pass,122000,0,122000
3275,46,Maratha Virender Verma,KARNAL,BSP,0,Graduate Professional,96600000,0,96600000
3276,6844,Maredu Gopal,NAGARKURNOOL,Yuvajana Sramika Rythu Congress Party,0,Graduate,5455000,950000,4505000
3277,7521,"Mariappan, S.K.",THENI,IND,2,Graduate,240000,32000,208000
3278,7961,Marikanti Vasudasu,KHAMMAM,IND,0,12th Pass,4000000,150000,3850000
3279,7548,Marimuthu,VIRUDHUNAGAR,IND,0,10th Pass,280000,0,280000
3280,6896,Marimuthu. P,CHENNAI NORTH,IND,0,5th Pass,3861000,120000,3741000
3281,6897,Mariraj. T.R,CHENNAI NORTH,IND,0,8th Pass,35000,0,35000
3282,860,Marpalli Ramiah Vasudeva,DAKSHINA KANNADA,AAP,0,Post Graduate,15692369,0,15692369
3283,4555,Marri Durgesh,ZAHIRABAD,RPI(A),0,Illiterate,144000,0,144000
3284,4545,Marri Nehemiah,NALGONDA,IND,0,12th Pass,564168,0,564168
3285,5943,Martis Clifard Lorence,MUMBAI SOUTH CENTRAL,IND,0,Graduate Professional,7515805,126000,7389805
3286,7320,Maru Manharbhai Valjibhai,BHAVNAGAR,IND,0,10th Pass,148000,0,148000
3287,7041,"Maruthaiveeran, V.",KARUR,BSP,0,Illiterate,21000,0,21000
3288,7128,"Marutharaj, P.",PERAMBALUR,IND,0,8th Pass,930000,180000,750000
3289,2123,Maruti,RAICHUR,National Development Party,0,Graduate Professional,50000,0,50000
3290,2189,Maruti Ramappa Hanasi,DHARWAD,IND,0,Graduate,2243000,230000,2013000
3291,7149,Mary Stella. M,POLLACHI,IND,0,8th Pass,6658000,2625000,4033000
3292,7377,"Masilamani, R. (Dr).",SRIPERUMBUDUR,MDMK,0,Post Graduate,20199073,0,20199073
3293,5698,Mass Ganesh A,SALEM,Thrinamool Tamil Nadu Congress,0,10th Pass,275100,0,275100
3294,3086,Massarrat Warsi,BAREILLY,CPI,0,12th Pass,983000,0,983000
3295,2483,Master Bhaira Ram Meghwal,BARMER,IND,0,Graduate,20000,0,20000
3296,3920,Master Sajid Siddiqui,BHOPAL,SDPI,0,Graduate Professional,3148467,0,3148467
3297,2059,Master Sher Singh,BHIWANI-MAHENDRAGARH,CPI(M),0,Graduate Professional,12962284,500926,12461358
3298,3826,Masudul Islam,MURSHIDABAD,SDPI,0,8th Pass,1046590,0,1046590
3299,7221,Matchindra Hanumantrao Chate,MUMBAI NORTH EAST,BSP,1,Graduate Professional,48299405,5348951,42950454
3300,5827,Mate Bharat Kisan,DINDORI,Bahujan Mukti Party,0,Post Graduate,4920887,1001402,3919485
3301,218,Mate Manohar Alias Mama,BHANDARA-GONDIYA,IND,0,8th Pass,191077,0,191077
3302,1963,Mathew Parey,PATHANAMTHITTA,IND,0,Graduate Professional,200000,0,200000
3303,308,Mathew T Thomas,KOTTAYAM,JD(S),4,Graduate Professional,10379737,649181,9730556
3304,5553,Maulana Mohammad,JHANSI,Peace Party,0,Others,5108500,250000,4858500
3305,4370,Mausam Noor,MALDAHA UTTAR,INC,0,Graduate Professional,9778222,28534,9749688
3306,2605,Maxim Pinto,DAKSHINA KANNADA,IND,0,10th Pass,25265000,5500000,19765000
3307,5909,Mayank Ramesh Gandhi,MUMBAI NORTH WEST,AAP,0,Graduate,31416461,18016075,13400386
3308,6344,Mayilsamy K,ERODE,IND,0,Graduate,365500,20000,345500
3309,984,Md Afaq,CHANDNI CHOWK,Jai Maha Bharath Party,0,5th Pass,4374000,0,4374000
3310,5267,Md Akhtar Ali,PURNIA,IND,0,Literate,110551,0,110551
3311,5233,Md Aslam Beg,ARARIA,Janta Dal Rashtravadi,1,12th Pass,15000,63733,0
3312,4841,Md Ezaruddin,MALDAHA DAKSHIN,Jamat-E-Seratul Mustakim,0,Post Graduate,542142,0,542142
3313,4839,Md Faruque Hossain,MALDAHA DAKSHIN,IUML,0,Post Graduate,3143672,424909,2718763
3314,1253,Md Jalil Ansari,KODARMA,National Loktantrik Party,0,Illiterate,541600,0,541600
3315,6210,Md Osman,HYDERABAD,IND,2,5th Pass,977524,0,977524
3316,4113,Md Shahid Akhtar,PURNIA,Bahujan Mukti Party,0,Graduate,5457339,0,5457339
3317,5270,Md Shamsher Alam,PURNIA,JMM,1,12th Pass,6135336,300000,5835336
3318,6161,Md Tanveer Hasan,BEGUSARAI,RJD,1,Doctorate,10956399,600000,10356399
3319,4521,Md Yunus Miya,CHEVELLA,Marxist Communist Party of India (United),0,Illiterate,537000,0,537000
3320,6164,Md. Ali Ashraf Fatmi,DARBHANGA,RJD,0,Post Graduate,16036505,0,16036505
3321,1140,Md. Ali Hussain,SAMBALPUR,IND,0,12th Pass,9030000,4420000,4610000
3322,2914,Md. Ateek,BHOPAL,Prajatantrik Samadhan Party,0,Post Graduate,663000,0,663000
3323,560,Md. Dilbas Ansari,KARAKAT,IND,0,Post Graduate,70000,0,70000
3324,4865,Md. Dilir Khan,BARPETA,IND,0,Graduate,187306,0,187306
3325,6177,Md. Faiyaz Khan,JHANJHARPUR,Janta Dal Rashtravadi,0,Post Graduate,26805000,0,26805000
3326,3989,Md. Ginnatulla Sk,JANGIPUR,Jamat-E-Seratul Mustakim,0,Post Graduate,190721,0,190721
3327,6018,Md. Harun,BARDHAMAN-DURGAPUR,BSP,0,8th Pass,26000,0,26000
3328,3330,Md. Iliyas Md. Amir Maniyar,PARBHANI,Bharipa Bahujan Mahasangh,0,Graduate,15000,82800,0
3329,5258,Md. Iqbal Ahmad,KATIHAR,Samajwadi Janata Party (Rashtriya),2,Others,2827500,0,2827500
3330,2684,Md. Istiyak,JAHANABAD,AITC,2,Graduate Professional,9481904,0,9481904
3331,4738,Md. Jenul,GODDA,Bahujan Mukti Party,1,Graduate Professional,3280000,0,3280000
3332,4375,Md. Khodabox Sekh,MURSHIDABAD,Welfare Party Of India,0,Graduate,1915000,0,1915000
3333,4359,Md. Moazzem Hossain,MALDAHA DAKSHIN,AITC,0,Post Graduate,8580219,0,8580219
3334,4374,Md. Najmul Hoque,MURSHIDABAD,AIUDF,0,Post Graduate,1267080,0,1267080
3335,4365,Md. Najrul Islam,MALDAHA DAKSHIN,AIUDF,0,Others,1225345,0,1225345
3336,4741,Md. Noor Hassan,GODDA,Samata Party,3,Graduate,203000,0,203000
3337,3825,Md. Nurul Islam,MALDAHA UTTAR,Welfare Party Of India,0,Graduate Professional,12148752,0,12148752
3338,3821,Md. Sahabuddin,JANGIPUR,SDPI,2,Post Graduate,1407507,30000,1377507
3339,4380,Md. Salim,RAIGANJ,CPI(M),0,Post Graduate,7868013,0,7868013
3340,6056,Md. Shanawaz,SREERAMPUR,SUCI(C),0,Post Graduate,6172295,300000,5872295
3341,5257,Md. Tariq Anwar,KATIHAR,IND,0,12th Pass,113000,0,113000
3342,4431,Md. Zakir Hussain,GAUHATI,IND,0,12th Pass,1823905,0,1823905
3343,4709,Md. Zubair,DHANBAD,All India Minorities Front,0,Graduate,659395,0,659395
3344,4485,Md.Naushad,KISHANGANJ,BSP,0,8th Pass,370000,316000,54000
3345,3289,Md.Samim Aktar,KENDRAPARA,AAP,0,Graduate Professional,850000,0,850000
3346,7333,Meda Jagdishbhai Manilal,DAHOD,Bharatiya National Janta Dal,0,8th Pass,67000,0,67000
3347,4528,Medarametla Rama Rao,KHAMMAM,Pyramid Party of India,0,12th Pass,680000,0,680000
3348,7227,Medha Patkar,MUMBAI NORTH EAST,AAP,9,Post Graduate,209226,0,209226
3349,6642,Medi Lal,BARABANKI,Bahujan Mukti Party,0,12th Pass,161000,0,161000
3350,2647,Meena,ARRAH,JD(U),0,Graduate,90737486,6915766,83821720
3351,4807,Meena Devid,RATLAM,IND,0,12th Pass,418377,0,418377
3352,5773,Meena Rawat,MOHANLALGANJ,Naitik Party,0,12th Pass,50000,0,50000
3353,1326,Meena Singla,NEW DELHI,Poorvanchal Rashtriya Congress,0,Graduate,13840344,517041,13323303
3354,4202,Meenakshi Natarajan,MANDSOUR,INC,1,Post Graduate,4682146,234415,4447731
3355,4801,Meenakshi Pande,MANDSOUR,IND,0,8th Pass,100548,0,100548
3356,7509,"Meenakshi Sundaram, G.K.",THENI,SP,0,12th Pass,6504269,892475,5611794
3357,7573,Meenashisundaravadivel.T.,TENKASI,CPI(ML) Red Star,2,10th Pass,5000,0,5000
3358,5912,Meera Ashish Sanyal,MUMBAI SOUTH,AAP,0,Post Graduate,509461553,13849761,495611792
3359,6722,Meera Devi,MOHANLALGANJ,Mahila Swabhiman Party,0,Graduate,611600,0,611600
3360,7679,Meesala Raji Reddy,KARIMNAGAR,Yuvajana Sramika Rythu Congress Party,0,5th Pass,3150000,0,3150000
3361,1175,Meganada Sabar,KORAPUT,CPI(ML)L,0,10th Pass,200000,0,200000
3362,7482,Megaraj Mallar,SIVAGANGA,IND,0,8th Pass,0,0,0
3363,4319,Megh Singh,FATEHPUR SIKRI,Peace Party,0,12th Pass,6930000,412000,6518000
3364,946,Meghe Sagar Dattatraya,WARDHA,INC,0,Graduate,340138817,118145553,221993264
3365,2447,Meghraj Tawar,UDAIPUR,CPI,0,10th Pass,1405000,0,1405000
3366,1073,Mehaboobsab Pathan,HAVERI,IND,0,5th Pass,8300000,150000,8150000
3367,879,Mehar Manav Bhagat,JAMMU,Bharatiya Bahujan Party,0,Graduate Professional,32000,0,32000
3368,4477,Mehboob Alam,KATIHAR,CPI(ML)L,11,12th Pass,1215962,0,1215962
3369,3927,Mehboob Khan,BHOPAL,IND,0,Graduate,6959000,525000,6434000
3370,4146,Mehbooba Mufti,ANANTNAG,JKPDP,1,Graduate Professional,5200000,0,5200000
3371,7212,Meher A. Mallick,MUMBAI NORTH CENTRAL,Bahujan Mukti Party,0,Post Graduate,13859021,40000,13819021
3372,3447,Mehmooda Begam Abbasi,JODHPUR,IND,0,Literate,1795520,0,1795520
3373,5326,Mehta Rahul Chimanlal,GANDHINAGAR,IND,0,Post Graduate,48200000,0,48200000
3374,5325,Mehta Rituraj Gautamchand,GANDHINAGAR,AAP,0,Graduate,257990872,185565236,72425636
3375,4583,Mehta Yashvantray Odhavjibhai,BHAVNAGAR,IND,0,Post Graduate,3013000,0,3013000
3376,5291,Mehulbhai Himatbhai Sukhadia,AMRELI,IND,0,Graduate Professional,3147975,518262,2629713
3377,362,Meira Kumar,SASARAM,INC,0,Post Graduate,384751309,0,384751309
3378,6826,Meka Subba Rao,MEDAK,IND,0,Graduate,710000,25000,685000
3379,7350,Mekani Amadbhai Noormamdbhai,JAMNAGAR,IND,0,Literate,2461000,0,2461000
3380,220,Meshram Dnyaneshwar Tukaram,YAVATMAL-WASHIM,IND,0,Graduate,133000,39060,93940
3381,7948,Metla Papaiah,MAHABUBABAD,IND,0,Graduate Professional,4470000,0,4470000
3382,7262,Mev Atikbhai Abdulrahim,AHMEDABAD EAST,IND,0,10th Pass,1290000,150000,1140000
3383,7265,Mevada Jayantibhai Jethalal,AHMEDABAD WEST,AAP,0,Graduate Professional,84742785,16546028,68196757
3384,426,Mewa Singh,SIRSA,IND,0,5th Pass,5696200,0,5696200
3385,3211,Mewaram,SHAHJAHANPUR,Naitik Party,0,12th Pass,2116552,0,2116552
3386,3538,Mhamane Anil Subhash,KOLHAPUR,IND,1,Post Graduate,4920000,1282195,3637805
3387,5864,Mhaske Dilip Datta,JALNA,AAP,0,Post Graduate,766000,0,766000
3388,6423,Michael Daniel Ovelz,SECUNDERABAD,IND,0,Graduate,0,0,0
3389,4846,Milan Das,MALDAHA UTTAR,SP,0,12th Pass,5502108,1201557,4300551
3390,7198,Milind Shankar Repe,MUMBAI NORTH,IND,0,Graduate,13498923,0,13498923
3391,3690,Milindraje Digambar Bhosale,SHIRUR,IND,0,10th Pass,3274,0,3274
3392,6781,Mina Devi,MADHEPURA,IND,0,Literate,18581662,400000,18181662
3393,4797,Minakshi Chouhan,MANDSOUR,IND,0,12th Pass,65000,0,65000
3394,7205,Minakshi Mukund Jadhav,MUMBAI NORTH CENTRAL,IND,0,5th Pass,21300,0,21300
3395,4372,Minara Khatun,MALDAHA UTTAR,Hindustan Krantikari Dal,0,10th Pass,1172926,0,1172926
3396,6062,Minati Sarkar,ULUBERIA,SUCI(C),0,Post Graduate,275942,0,275942
3397,2739,Minendra Kumar Singh,PATALIPUTRA,IND,0,Others,1867902,0,1867902
3398,5566,Mirja Mukarram Baig,FIROZABAD,IND,0,8th Pass,1000,0,1000
3399,2820,Mirnal Kanti Dev,GIRIDIH,Socialist Party (Lohia),0,12th Pass,331000,0,331000
3400,7615,Mirza Afsar Beg,JALNA,Welfare Party Of India,0,5th Pass,1756142,0,1756142
3401,4148,Mirza Mehboob Beg,ANANTNAG,JKNC,0,Graduate Professional,10710000,0,10710000
3402,6808,Mirza Sajad Hussain Beigh,SRINAGAR,IND,0,8th Pass,60000,0,60000
3403,2130,Mirza Shafee Baig,BIDAR,IND,0,8th Pass,0,0,0
3404,1458,Mirza Vahed Beg Ahmadbeg,BHANDARA-GONDIYA,IND,0,12th Pass,1513581,0,1513581
3405,2746,Misha Bharti,PATALIPUTRA,RJD,1,Graduate Professional,47634901,0,47634901
3406,2503,Miss Patal Kanya Jamatia,TRIPURA EAST,IND,0,Post Graduate,30000,0,30000
3407,1242,Mister Alam Asrafee,CHATRA,Rashtriya Jankranti Morcha,0,Graduate,911000,0,911000
3408,6586,Mistry Madhusadan Devram,VADODARA,INC,1,Post Graduate,31759626,480000,31279626
3409,2843,Mithalesh Kumar Mahto,HAZARIBAGH,AAP,1,Doctorate,8251000,0,8251000
3410,3208,Mithilesh Kumar,SHAHJAHANPUR,SP,0,Graduate,28206768,7242790,20963978
3411,6254,Mithilesh Kumar Rajak,SAMASTIPUR,IND,0,Graduate,2540933,25000,2515933
3412,5239,Mithilesh Kumar Singh,BANKA,National Loktantrik Party,0,10th Pass,1986983,0,1986983
3413,531,Mithual Kumar,KALIABOR,AIFB,0,8th Pass,1630000,0,1630000
3414,1982,Mittu Mujavar,NORTH GOA,IND,0,12th Pass,6871000,1121500,5749500
3415,4308,Mo Tamajid,FARRUKHABAD,Peace Party,0,5th Pass,350000,0,350000
3416,2390,Mo. Hafiz Khan Varasi,JAIPUR,IND,0,8th Pass,75000,0,75000
3417,2437,Mo. Imtiyaz,CHITTORGARH,IND,0,8th Pass,1756000,0,1756000
3418,5221,Mo. Ismile Jumman,DHULE,IND,1,5th Pass,79000,0,79000
3419,6622,Mo. Sageer,BANDA,Peace Party,0,10th Pass,3594500,0,3594500
3420,2842,Mo. Shanul Haque,HAZARIBAGH,IUML,0,12th Pass,194500,0,194500
3421,2846,Mobin Khan,JAMSHEDPUR,IND,0,12th Pass,2865000,117000,2748000
3422,3729,Modi Saifulla,BANGALORE CENTRAL,IND,0,5th Pass,285000,0,285000
3423,1756,Mohamad Adeeb,BIJNOR,Rashtrawadi Samaj Party,0,Post Graduate,26241383,0,26241383
3424,7373,"Mohamed Abbas, S. Thiru",SRIPERUMBUDUR,BSP,0,Graduate,200000,0,200000
3425,7157,Mohamed Jaleel .S,RAMANATHAPURAM,DMK,0,Graduate Professional,294761445,47707836,247053609
3426,6898,Mohamed Majasuddin,CHENNAI NORTH,IND,0,8th Pass,3709219,3800000,0
3427,7522,"Mohamed Miakhan, P.",THENI,IND,0,5th Pass,1064000,0,1064000
3428,7591,Mohamed Mubarak.V.M.S,TIRUNELVELI,SDPI,1,Graduate,660000,0,660000
3429,4776,Mohamed Tanvir,INDORE,IND,0,5th Pass,10000,0,10000
3430,7192,Mohammad Akhtar Mehboob Shaikh,MUMBAI NORTH,Prabuddha Republican Party,0,8th Pass,2515000,0,2515000
3431,4850,Mohammad Ali,MURSHIDABAD,AITC,1,Post Graduate,16756495,0,16756495
3432,2323,Mohammad Ali Khan,CHURU,Bahujan Sangharshh Dal,0,Literate,3107000,1394000,1713000
3433,5281,Mohammad Amanullah,SUPAUL,IUML,0,Graduate,1000,0,1000
3434,6747,Mohammad Amir Khan,UNNAO,IND,0,8th Pass,110500,0,110500
3435,6194,Mohammad Arshad Hussain,MADHEPURA,Peace Party,0,Others,1442500,0,1442500
3436,7616,Mohammad Asad Shaikh Ahemad,JALNA,Minorities Democratic Party,0,8th Pass,4523000,442455,4080545
3437,3085,Mohammad Aslam,BAREILLY,Peace Party,0,Graduate Professional,720729,0,720729
3438,6727,Mohammad Asraf,RAE BARELI,VANCHITSAMAJ INSAAF PARTY,0,Post Graduate,15897212,650000,15247212
3439,4488,Mohammad Asrarul Haque,KISHANGANJ,INC,2,Post Graduate,4616629,0,4616629
3440,4487,Mohammad Gulab Siddiqui,KISHANGANJ,Loktantrik Janata Party (Secular),0,8th Pass,296809,0,296809
3441,4108,Mohammad Hamid Mobarak,KATIHAR,AITC,0,Graduate,2677359,0,2677359
3442,3008,Mohammad Hanif Qurashi,SAGAR,IND,1,Literate,2850500,0,2850500
3443,4775,Mohammad Imtiyaz Khan,INDORE,IND,0,Graduate,338000,0,338000
3444,1017,Mohammad Jahid Husain,NAWADA,AITC,0,Graduate,1657448,0,1657448
3445,6159,Mohammad Javed,BEGUSARAI,IND,0,Literate,139052,0,139052
3446,5511,Mohammad Javed,FATEHPUR,Nav Bharat Democratic Party,0,12th Pass,6539000,700000,5839000
3447,7759,Mohammad Maksood Ansari,LUDHIANA,Bahujan Mukti Party,0,Literate,10400000,2950000,7450000
3448,6813,Mohammad Maqbool Malik,SRINAGAR,JKNPP,0,10th Pass,20000,600000,0
3449,1759,Mohammad Moosa,BIJNOR,Peace Party,0,Graduate,8740204,0,8740204
3450,6820,Mohammad Shafi Guroo,SRINAGAR,IND,0,8th Pass,30550000,500000,30050000
3451,991,Mohammad Shakeel Saifi,EAST DELHI,BSP,1,Literate,29743591,458360,29285231
3452,4689,Mohammad Shrif,ANANTNAG,BSP,0,Graduate Professional,2327215,0,2327215
3453,6798,Mohammad Sirajuddin Sekh,HOWRAH,Gareeb Aadmi Party,0,8th Pass,3753226,0,3753226
3454,4111,Mohammad Wasiqur Rahman,KISHANGANJ,IUML,2,12th Pass,4830500,166000,4664500
3455,4687,Mohammad Yaqoob Rather,ANANTNAG,All Jammu and Kashmir Republican Party,0,8th Pass,11450000,500000,10950000
3456,7698,Mohammed Amjad Mohiuddin,KARIMNAGAR,IND,1,Graduate,670000,0,670000
3457,4251,Mohammed Azharuddin,TONK-SAWAI MADHOPUR,INC,0,Graduate,97334682,9901034,87433648
3458,21,Mohammed Faizal.P.P,LAKSHADWEEP,NCP,3,Post Graduate,538119,0,538119
3459,1350,Mohammed Naeem,EAST DELHI,IND,1,10th Pass,2314000,59000,2255000
3460,3740,Mohammed Qutbuddin,BANGALORE NORTH,IND,0,10th Pass,465000,0,465000
3461,7211,Mohammed Rafik Hussain Shaikh,MUMBAI NORTH CENTRAL,National Loktantrik Party,0,5th Pass,1660000,0,1660000
3462,3755,Mohammed Rafiq,BIDAR,IND,0,5th Pass,50000,0,50000
3463,6429,Mohammed Rizwan Hussain,SECUNDERABAD,IND,0,10th Pass,154500,0,154500
3464,662,Mohammed Yamin,MUZAFFARNAGAR,AAP,0,10th Pass,13243000,0,13243000
3465,5982,Mohan Barku Guhe,PALGHAR,Bharipa Bahujan Mahasangh,0,Graduate Professional,600000,1100000,0
3466,7241,Mohan Galvankar,MUMBAI NORTH WEST,The Lok Party of India,0,Graduate Professional,41055000,0,41055000
3467,1291,Mohan Kanuga,SOUTH DELHI,JKNPP,0,Post Graduate,7839000,0,7839000
3468,1609,Mohan Lal,KAIRANA,IND,0,12th Pass,9741331,0,9741331
3469,4658,Mohan Lal Bargahi,KORBA,IND,0,10th Pass,9142637,0,9142637
3470,2413,Mohan Lal Mahawar,KOTA,IND,0,12th Pass,9702000,0,9702000
3471,2801,Mohan Lal Patel,MAHASAMUND,Bhartiya Shakti Chetna Party,0,10th Pass,4383500,0,4383500
3472,353,Mohan Marotrao Karemore,NAGPUR,IND,0,10th Pass,6008449,200000,5808449
3473,1059,Mohan Motannavar,CHIKKODI,IND,0,Graduate,1119300,90000,1029300
3474,4423,Mohan Shyam,MATHURA,Gareeb Aadmi Party,0,Graduate Professional,18066000,6000000,12066000
3475,1825,Mohan Yallappa More,BELGAUM,IND,0,10th Pass,1267950,0,1267950
3476,7102,Mohan. G,NAGAPATTINAM,IND,0,Graduate Professional,191618,52500,139118
3477,4032,Mohan.P.S,DHARMAPURI,AIADMK,0,Graduate Professional,16814138,1200000,15614138
3478,7602,Mohan.T,TIRUNELVELI,IND,0,Graduate,435000,0,435000
3479,2585,Mohana Dasari,CHITRADURGA,AAP,0,Graduate,1549000,63538863,0
3480,1958,Mohanan D,ALAPPUZHA,AAP,0,Post Graduate,21114000,600000,20514000
3481,2251,Mohananda Das,KARIMGANJ,IND,0,10th Pass,600000,0,600000
3482,6531,Mohanbhai Kalyanjibhai Kundariya,RAJKOT,BJP,0,8th Pass,39512950,2335530,37177420
3483,7533,Mohanraj,VIRUDHUNAGAR,Jebamani janatha,0,Graduate,23380000,1550000,21830000
3484,6982,"Mohanraj, K.",COIMBATORE,IND,0,8th Pass,80000,0,80000
3485,7554,Mohanraj. A,THOOTHUKKUDI,CPI,2,Graduate Professional,8475249,1294500,7180749
3486,4874,Mohar Uddin Mondal,DHUBRI,IND,0,Graduate Professional,4332581,9000,4323581
3487,6422,Mohd Abubakar Parwaiz Siddiqui,SECUNDERABAD,IND,0,12th Pass,1015000,0,1015000
3488,1004,Mohd Arif Siddique,NORTH EAST DELHI,AITC,0,Illiterate,330000,0,330000
3489,3895,Mohd Arshad Malik,UDHAMPUR,JKPDP,0,10th Pass,7042892,0,7042892
3490,3198,Mohd Aslam Urf Pasha,SAMBHAL,RPI(A),0,Literate,6443300,0,6443300
3491,1001,Mohd Hasnan Khan,NORTH EAST DELHI,JKNPP,0,5th Pass,3700000,0,3700000
3492,6435,Mohd Imtiaz Hussain,SECUNDERABAD,IUML,0,Post Graduate,4650000,0,4650000
3493,977,Mohd Mursaleem,CHANDNI CHOWK,Peace Party,0,12th Pass,470700,0,470700
3494,3168,Mohd Naeem Ansari,PILIBHIT,IND,0,Graduate,355000,0,355000
3495,1360,Mohd Naseer,EAST DELHI,Peace Party,0,8th Pass,4398632,0,4398632
3496,5731,Mohd Sarwar Malik,LUCKNOW,AITC,0,12th Pass,97019722,13308087,83711635
3497,1367,Mohd Shahid Siddiqui,EAST DELHI,AITC,0,12th Pass,40044000,2010000,38034000
3498,4692,Mohd Yousif Ganie,ANANTNAG,Ambedkar Samaj Party,0,Graduate,2020000,0,2020000
3499,3118,Mohd Zafar Iqbal,MORADABAD,Akhil Bharatiya Muslim League (Secular),0,Graduate,1725000,0,1725000
3500,882,Mohd. Abbas Khan,JAMMU,IND,0,Graduate Professional,218316,261000,0
3501,1563,Mohd. Adil,JABALPUR,IUML,0,12th Pass,183325,0,183325
3502,751,Mohd. Aftab Alam,JABALPUR,BSP,1,Post Graduate,4282755,14000000,0
3503,945,Mohd. Alim Patel Mohd. Wahid,WARDHA,AAP,0,Post Graduate,2882200,0,2882200
3504,1750,Mohd. Firoz Aftab,SAHARANPUR,IND,1,Graduate Professional,6305818,0,6305818
3505,1371,Mohd. Hasnain,NORTH EAST DELHI,IND,2,10th Pass,30000,0,30000
3506,885,Mohd. Imtiaz,JAMMU,IND,0,Graduate,0,0,0
3507,1551,Mohd. Jahangeer Ansari,SIDHI,IND,0,Not Given,56300,0,56300
3508,3054,Mohd. Jarrar,AONLA,Bhartiya Naujawan Inklav Party,0,8th Pass,5305000,0,5305000
3509,1439,Mohd. Javed Mohd Mustak,NAGPUR,Democratic Secular Party,0,12th Pass,160500,250000,0
3510,3321,Mohd. Maroof Ab. Rauf,NANDED,IND,0,12th Pass,568655,112000,456655
3511,1276,Mohd. Mukim,FARIDABAD,National Loktantrik Party,0,10th Pass,3999000,80000,3919000
3512,7757,Mohd. Naseem Ansari,LUDHIANA,New All India Congress Party,0,12th Pass,107600,0,107600
3513,1717,Mohd. Sabir Ansari,GAUTAM BUDHHA NAGAR,AITC,0,5th Pass,681600,0,681600
3514,1801,Mohd. Sabir Rahi,ALIGARH,AAP,0,10th Pass,15227199,0,15227199
3515,1632,Mohd. Sajid Saifi,MEERUT,Bahujan Mukti Party,1,5th Pass,341178,0,341178
3516,1621,Mohd. Yamin,MUZAFFARNAGAR,All India Ravidas Samata Party,0,Illiterate,12000,0,12000
3517,5726,Mohd.Ateek,KANPUR,Rashtrawadi Samaj Party,0,Literate,420000,0,420000
3518,5728,Mohd.Nasir Khan,KANPUR,Peace Party,1,12th Pass,4335000,0,4335000
3519,1633,Mohd.Usman Ghazi,MEERUT,Rashtriya Apna Dal,0,12th Pass,1005000,0,1005000
3520,4873,Mohendra Chandra Roy,DHUBRI,IND,0,8th Pass,161205,0,161205
3521,7854,Mohinder Pal Singh,PATIALA,Shiromani Akali Dal (Amritsar)(Simranjit Sing,0,Post Graduate,16742266,10232000,6510266
3522,7673,Mohinder Singh,AMRITSAR,IND,0,Illiterate,200000,0,200000
3523,7724,Mohinder Singh Kaypee,HOSHIARPUR,INC,0,Post Graduate,70907443,3769400,67138043
3524,3565,Mohite Patil Vijaysinh Shankarrao,MADHA,NCP,1,10th Pass,170253390,9774791,160478599
3525,3994,Mohite-Patil Pratapsinh Shankarrao,MADHA,IND,1,Graduate,262989287,23367636,239621651
3526,5170,Mohmmad Kismatwala Kasim Kismatwala,AURANGABAD,Gareeb Aadmi Party,0,8th Pass,635000,0,635000
3527,5937,Moin Sohil Sayyad,MUMBAI SOUTH CENTRAL,IND,0,5th Pass,270000,0,270000
3528,5405,Moinudin Tanvar,RAIPUR,IND,0,5th Pass,400000,0,400000
3529,3478,Moirangthem Nara,INNER MANIPUR,CPI,0,Graduate Professional,1867499,2785815,0
3530,7963,Mokalla Ramesh,KHAMMAM,IND,0,Illiterate,50000,0,50000
3531,2658,Mokaram Hussain,BUXAR,Suheldev Bhartiya Samaj Party,0,10th Pass,2115487,0,2115487
3532,6511,Molapiya Abdulkudus Abdulmajid,PATAN,IND,0,5th Pass,189000,0,189000
3533,4373,Monatan Hembram,MALDAHA UTTAR,Bahujan Mukti Party,0,Graduate,48000,0,48000
3534,504,Moni Kumar Subba,TEZPUR,IND,2,8th Pass,3067535137,1400740132,1666795005
3535,2667,Monibur Rahman,BUXAR,Janta Dal Rashtravadi,0,12th Pass,3130000,0,3130000
3536,4866,Monirul Hussain,DHUBRI,IND,0,12th Pass,453385,0,453385
3537,4357,Monirul Islam,JANGIPUR,Welfare Party Of India,1,Graduate,539830,0,539830
3538,7179,Mookaiya .S,RAMANATHAPURAM,IND,0,5th Pass,73867,0,73867
3539,3436,Moola Ram,JALORE,IND,0,10th Pass,5430617,0,5430617
3540,2604,Moose Kunhi,DAKSHINA KANNADA,BSP,0,5th Pass,667631,152465,515166
3541,1636,Morarji Nagma Arvind,MEERUT,INC,0,Graduate,117912089,2978643,114933446
3542,1469,Moreshwar Ramaji Meshram,BHANDARA-GONDIYA,IND,0,Graduate,15858255,695510,15162745
3543,5305,Morya Sukhramsinh Nakliram,BHARUCH,BSP,0,Graduate,11548000,0,11548000
3544,6202,Mosali Chinnaiah,ADILABAD,IND,0,12th Pass,3167000,40000,3127000
3545,6453,Motam Ravinder,PEDDAPALLE,IND,0,Illiterate,900000,0,900000
3546,5891,Mote Chandrakant Rambhaji,KALYAN,IND,0,10th Pass,5536065,325500,5210565
3547,7788,Moti Lal,FARIDKOT,Bharatiya Sant Mat Party,0,8th Pass,194500,0,194500
3548,3907,Moti Lal Sahu S/O Bajaraha Ram Sahu,MAHASAMUND,IND,0,12th Pass,7759000,0,7759000
3549,4065,Moti Lal Sahu S/O Sone Lal Sahu,MAHASAMUND,IND,0,8th Pass,1354000,0,1354000
3550,7310,Movliyabhai Nopariyabhai Gamit,BARDOLI,BSP,0,8th Pass,735588,0,735588
3551,75,Mrinal Kumar Saikia,KALIABOR,BJP,0,Post Graduate,3360000,50000,3310000
3552,6051,Mrityunjay Sarkar,HOWRAH,IND,0,8th Pass,138652,100000,38652
3553,3949,Mu.Anbhalagan,TIRUCHIRAPPALLI,DMK,10,Post Graduate,78217356,12964048,65253308
3554,186,Mu.Venkatesh Simha Bhovi,BANGALORE NORTH,IND,0,Not Given,9945000,0,9945000
3555,7962,Mudige Nageswara Rao,KHAMMAM,IND,0,Not Given,50000,0,50000
3556,581,Muhammed Hamdullah Sayeed,LAKSHADWEEP,INC,0,Graduate Professional,40192946,358156,39834790
3557,1870,Muhammed Riyas,KOZHIKODE,IND,0,10th Pass,441500,0,441500
3558,709,Muhammed Sharafudheen,IDUKKI,SDPI,0,Graduate,415000,280000,135000
3559,4409,Muhar Singh,KANNAUJ,IND,0,10th Pass,6401000,60000,6341000
3560,7664,Mukesh,GURDASPUR,IND,0,Post Graduate,300000,0,300000
3561,5125,Mukesh,TONK-SAWAI MADHOPUR,AAP,0,Post Graduate,4035502,0,4035502
3562,1603,Mukesh Babu Ahirwar,HOSHANGABAD,IND,0,10th Pass,1260000,0,1260000
3563,228,Mukesh Kumar,MEERUT,IND,0,Graduate Professional,2150500,1200000,950500
3564,5047,Mukesh Kumar,MAINPURI,IND,0,Graduate,7441200,0,7441200
3565,999,Mukesh Kumar Arora,NORTH EAST DELHI,IND,0,Graduate,13688864,3970000,9718864
3566,2908,Mukesh Kumar Bansal,BHOPAL,Samta Vikas Party,0,10th Pass,36300,0,36300
3567,5050,Mukesh Kumar Shakya,MAINPURI,IND,0,Graduate,3377738,0,3377738
3568,2096,Mukesh Kumar Singh,FARIDABAD,IND,0,12th Pass,1928506,0,1928506
3569,4105,Mukesh Kumar Sinha,BANKA,Bhartiya Ekta Manch Party,0,Doctorate,6905132,2588967,4316165
3570,4310,Mukesh Rajput,FARRUKHABAD,BJP,0,Graduate Professional,26178100,151603,26026497
3571,4979,Mukesh Rajput,FARRUKHABAD,IND,0,10th Pass,725000,0,725000
3572,4963,Mukesh Singh,ETAWAH,Peace Party,0,Doctorate,1467329,0,1467329
3573,5317,Mukeshbhai Lavjibhai Ambaliya,SURAT,IND,0,Literate,555566,87500,468066
3574,6008,Mukul Biswas,BARDHAMAN PURBA,BSP,0,Post Graduate,2121435,0,2121435
3575,2755,Mukul Kumar Sharma,PATALIPUTRA,Sankhyanupati Bhagidari Party,1,10th Pass,2212400,0,2212400
3576,3414,Mukul Mishra,AJMER,Akhil Bharat Hindu Mahasabha,0,12th Pass,51000,0,51000
3577,229,Mukul Upadhyay,GHAZIABAD,BSP,0,10th Pass,167355710,18751971,148603739
3578,936,Mukul Wasnik,RAMTEK,INC,2,Post Graduate,16119417,0,16119417
3579,94,Mul Chand,GURGAON,IND,0,10th Pass,33392000,750000,32642000
3580,3460,Mularam,NAGAUR,IND,0,Literate,3470000,0,3470000
3581,5045,Mulayam Singh Yadav,MAINPURI,SP,0,Post Graduate,159671544,0,159671544
3582,260,Mullappally Ramachandran,VADAKARA,INC,0,Post Graduate,9225000,2160000,7065000
3583,7462,Mummoorthi.S@S.M.Moorthy,THANJAVUR,Namadhu Makkal Katchi,2,Graduate,8005000,1800000,6205000
3584,3849,Munde Gopinathrao Pandurang,BEED,BJP,3,Graduate Professional,380072890,335729817,44343073
3585,7579,Muneeswaran,TENKASI,IND,0,8th Pass,613900,223600,390300
3586,3160,Munesh Singh,PILIBHIT,IND,0,8th Pass,5279115,0,5279115
3587,7332,Munia Kamalsinh Chhaganbhai,DAHOD,AAP,0,Post Graduate,9612321,1709159,7903162
3588,7067,Muniraj.K,KRISHNAGIRI,Ulzaipali Makkal Katchy,0,5th Pass,172000,0,172000
3589,4679,Munna Chandrakar,DURG,BSP,0,8th Pass,4547946,45000,4502946
3590,2382,Munna Dass Dabodia,JAIPUR,IND,0,12th Pass,3312954,60000,3252954
3591,5003,Munna Lal,FATEHPUR SIKRI,Rashtriya mahan Gantantra Party,0,10th Pass,2971600,0,2971600
3592,2709,Munna Prasad,NALANDA,IND,0,10th Pass,350000,0,350000
3593,3466,Munni,PALI,INC,0,10th Pass,17225722,1297049,15928673
3594,4268,Munni Devi,AKBARPUR,IND,0,10th Pass,768692,0,768692
3595,4708,Munshi Hembram,DHANBAD,IND,0,Literate,2653000,482,2652518
3596,3067,Munshi Lal,BADAUN,IND,0,12th Pass,832251,50000,782251
3597,7089,Munusamy.V,MAYILADUTHURAI,IND,0,5th Pass,110000,0,110000
3598,3911,Murad Bhai,RAJNANDGAON,IND,0,10th Pass,12400000,120000,12280000
3599,5687,Murali.V,NAMAKKAL,IND,0,Graduate,1425800,0,1425800
3600,6850,Muralikrishnan (A) Samaran,CHENNAI CENTRAL,BSP,1,12th Pass,5635750,1037250,4598500
3601,7870,Murari.T.N,MALKAJGIRI,SHS,0,Graduate,8647342,1050000,7597342
3602,4837,Mursed Sekh,MALDAHA DAKSHIN,RPI(A),0,5th Pass,160500,0,160500
3603,4222,Mursid Ahmed,ALWAR,AITC,0,Graduate,63986428,88000,63898428
3604,7058,"Murugaan, N.",KARUR,IND,0,10th Pass,523120,0,523120
3605,7101,Murugaiyan. K,NAGAPATTINAM,IND,0,5th Pass,167000,0,167000
3606,7481,Murugan P,SIVAGANGA,IND,1,12th Pass,230000,60000,170000
3607,5435,Murugan P,TIRUVANNAMALAI,IND,0,Post Graduate,23000,0,23000
3608,7601,Murugan.S,TIRUNELVELI,IND,0,8th Pass,1620910,205000,1415910
3609,7461,Muruganantham.M,THANJAVUR,BJP,20,10th Pass,102000,0,102000
3610,5440,Murugesan K,TIRUVANNAMALAI,IND,0,12th Pass,4808164,0,4808164
3611,7045,"Murugesan, M.",KARUR,SP,0,Graduate,8190000,1400000,6790000
3612,4040,Murugesan_s,ERODE,IND,0,5th Pass,2566000,0,2566000
3613,7178,Murugeswari,RAMANATHAPURAM,IND,1,10th Pass,538600,0,538600
3614,975,Musarrat Jahan,CHANDNI CHOWK,Rashtriya Janmorcha,0,Graduate,3119753,0,3119753
3615,4149,Mushtaq Ahmad Malik,ANANTNAG,BJP,0,10th Pass,315000,0,315000
3616,6816,Mushtaq Shamim,SRINAGAR,Akhil Bharatiya Muslim League (Secular),0,Graduate,5605000,250000,5355000
3617,272,Musthafa Kommeri,KOZHIKODE,SDPI,1,Graduate,1489200,0,1489200
3618,2627,Muthuraju,BANGALORE NORTH,RPI(A),0,Graduate,4655000,700000,3955000
3619,7523,"Muthuramalingam, M.",THENI,IND,0,Others,368660,333000,35660
3620,2104,Muttappa Channasangappa Angadi,BELGAUM,AAP,0,12th Pass,9470924,1524180,7946744
3621,3721,Muttappa Hirekumbi,BAGALKOT,IND,0,Literate,2887000,500000,2387000
3622,933,Muttemwar Vilasrao Baburao,NAGPUR,INC,0,Graduate,26382690,3569251,22813439
3623,2699,Muzaffar Fakhruddin,MUNGER,IND,0,Graduate,1883100,0,1883100
3624,4358,Muzaffar Hossain,JANGIPUR,CPI(M),0,12th Pass,1130866,0,1130866
3625,5710,Muzaffar Husain Khan,KANPUR,IND,0,Illiterate,472000,0,472000
3626,1812,N Abdulla Davud,KANNUR,BSP,0,10th Pass,3226369,50000,3176369
3627,7499,N Alagu Muthu Velayudam,MADURAI,IND,0,10th Pass,7200000,2100000,5100000
3628,1188,N B Krishnappa Nayaka,BELLARY,IND,0,Graduate Professional,169500,0,169500
3629,303,N J Pious,ERNAKULAM,IND,0,Graduate,3722750,150000,3572750
3630,470,N K P Nair,ANDAMAN & NICOBAR ISLANDS,CPI(ML)L,0,10th Pass,5287805,43642,5244163
3631,902,N Kannan,ANDAMAN & NICOBAR ISLANDS,IND,0,8th Pass,32400,549313,0
3632,1189,N R Mallaiah Swamy,BELLARY,IND,0,12th Pass,1333000,0,1333000
3633,333,N Sadanandan,MAVELIKKARA,AAP,0,Graduate Professional,4309529,0,4309529
3634,2161,N Y Hanumantappa,BELLARY,INC,0,Post Graduate,22848300,0,22848300
3635,6081,N. Indrasena Reddy,BHONGIR,BJP,0,Post Graduate,138815590,5055000,133760590
3636,2561,N.C.Puttaraju,MANDYA,IND,0,12th Pass,200000,0,200000
3637,361,N.Dharam Singh,BIDAR,INC,1,Post Graduate,236308464,53289216,183019248
3638,7420,N.Dineshkumar,TIRUPPUR,DMDK,3,Post Graduate,132560738,29692857,102867881
3639,7418,N.Gurusamy,TIRUPPUR,BSP,0,Post Graduate,5941492,0,5941492
3640,10,N.K.Biju,KOTTAYAM,SUCI(C),0,12th Pass,750,0,750
3641,14,N.K.Premachandran,KOLLAM,Revolutionary Socialist Party,1,Graduate Professional,16228989,3114638,13114351
3642,7893,N.Mahender Singh,HYDERABAD,Nava Bharat National Party,1,12th Pass,5300000,2000000,3300000
3643,5466,N.Muthaiyan,VILUPPURAM,IND,0,8th Pass,20500,0,20500
3644,2586,N.S. Manjunatha Nerenahal,CHITRADURGA,IND,0,10th Pass,450000,0,450000
3645,4345,N.S.Krishnan,KARUR,DMDK,0,Post Graduate,7085000,0,7085000
3646,7421,N.Sivakumar,TIRUPPUR,Ulzaipali Makkal Katchy,0,5th Pass,400000,0,400000
3647,3787,N.Venkatesh,KOLAR,IND,0,10th Pass,6744000,1000000,5744000
3648,4139,Naarad Prasad Nishad,RAIPUR,IND,0,8th Pass,313400,0,313400
3649,1148,Naba Krushna Danta,BOLANGIR,IND,0,Graduate Professional,482285,606700,0
3650,4096,Naba Kumar Sarania,KOKRAJHAR,IND,3,12th Pass,2155559,0,2155559
3651,3258,Nabin Kumar Dalai,JAJPUR,IND,0,Graduate,307000,0,307000
3652,7620,Nade Dnyaneshwar Dagduji,JALNA,IND,0,8th Pass,5000,0,5000
3653,7611,Nadeem Rana,AURANGABAD,IND,0,12th Pass,3250000,0,3250000
3654,3855,Nadu Madhav,BEED,AAP,0,Graduate Professional,76855663,875946,75979717
3655,3122,Nafisuddin,MORADABAD,CPI(M),0,8th Pass,9951294,400000,9551294
3656,3575,Nagamani Kisan Jakkan,MADHA,IND,0,5th Pass,1165000,0,1165000
3657,2150,Naganath Patil,BIDAR,IND,0,Graduate,510000,0,510000
3658,3806,Nagappa Karatagi,KOPPAL,IND,0,Graduate,5205986,495000,4710986
3659,1830,Nagappa Shiraguppi,BAGALKOT,IND,0,Literate,45403,0,45403
3660,1068,Nagaraj,RAICHUR,CPI(ML) Red star,0,12th Pass,901500,114611,786889
3661,6981,"Nagaraj, S.",COIMBATORE,IND,0,5th Pass,140000,0,140000
3662,6335,Nagarajan V,DINDIGUL,IND,0,10th Pass,326000,0,326000
3663,6965,"Nagarajan, P.",COIMBATORE,AIADMK,0,Graduate Professional,34306545,2235538,32071007
3664,7086,Nagarajan. M,MAYILADUTHURAI,IND,0,Others,840000,0,840000
3665,1082,Nagarajappa,DAVANAGERE,IND,0,Illiterate,15000,0,15000
3666,7954,Nagarjuna Cherukuru,KHAMMAM,Jai Samaikyandhra Party,0,12th Pass,7780000,450000,7330000
3667,2756,Nagendra Kumar,PATALIPUTRA,Bharat Vikas Morcha,0,Graduate,1166489,0,1166489
3668,796,Nagendra Kumar Pradhan,SAMBALPUR,BJD,0,Post Graduate,12796623,1461565,11335058
3669,2962,Nagendra Singh,KHAJURAHO,BJP,0,Graduate,44538002,0,44538002
3670,4533,Nagireddy Raji Reddy,KHAMMAM,IND,0,12th Pass,1071000,0,1071000
3671,1236,Nagmani,CHATRA,AJSUP,1,12th Pass,87315758,0,87315758
3672,7031,Nagoor Meeran Peer Mohammed U.,KANNIYAKUMARI,IND,0,10th Pass,2855555,0,2855555
3673,4900,Nagori Imrankhan Mahmadkhan,PATAN,IND,0,Post Graduate,291000,78000,213000
3674,5762,Nagpal,MISRIKH,Bhartiya Krishak Dal,0,12th Pass,340500,0,340500
3675,6383,Nagula Srinivas Yadav,BHONGIR,Mahajana Socialist Party,1,Graduate Professional,8043000,650000,7393000
3676,4199,Naharsingh Richhuji Barde,KHARGONE,BSP,0,Graduate,2994951,135000,2859951
3677,653,Nahid Hasan,KAIRANA,SP,2,Graduate,30399449,2105000,28294449
3678,1078,Naik Santosh Omu,UTTARA KANNADA,BSP,0,Post Graduate,2577000,1230000,1347000
3679,3524,Naikwade Digambar Gunaji,HINGOLI,IND,0,5th Pass,100000,0,100000
3680,5641,Najakatali Kabir Ansari,THANE,IND,0,8th Pass,2054916,0,2054916
3681,582,Najmudheen.C.T,LAKSHADWEEP,CPI,7,Graduate,322000,0,322000
3682,646,Najrul Hassan Hashmi,KODARMA,AJSUP,0,Literate,1800614,0,1800614
3683,2494,Nakul Das Rai,SIKKIM,AITC,0,Graduate,22091161,115000,21976161
3684,5741,Nakul Dubey,LUCKNOW,BSP,0,Graduate Professional,23867898,909000,22958898
3685,1221,Nalin Kumar Katil,DAKSHINA KANNADA,BJP,1,10th Pass,8789001,1493367,7295634
3686,5261,Nalini Mandal,KATIHAR,IND,0,12th Pass,351119,0,351119
3687,7030,Nalla Thampy C.,KANNIYAKUMARI,IND,0,8th Pass,600005,0,600005
3688,7952,Nama Nageswara Rao,KHAMMAM,TDP,1,12th Pass,3382293440,269489166,3112804274
3689,691,Namdeo Anandrao Kannake,GADCHIROLI-CHIMUR,CPI,0,Graduate,3322000,400000,2922000
3690,540,Namdeo Pundlik Dongardive,BULDHANA,IND,1,Graduate Professional,17500,0,17500
3691,923,Namdeo Shedmake,CHANDRAPUR,IND,1,10th Pass,1074059,425000,649059
3692,4233,Namonarayan,DAUSA,INC,1,Graduate,36642035,0,36642035
3693,4448,Namrata Sarma,MANGALDOI,AAP,0,Post Graduate,219905,0,219905
3694,3379,Nana Kshirsagar,PUNE,Bharipa Bahujan Mahasangh,0,Post Graduate,88792,0,88792
3695,917,Nanabhau Falgunrao Patole,BHANDARA-GONDIYA,BJP,5,12th Pass,12738190,0,12738190
3696,3201,Nanad Ram Khharagwansi,SAMBHAL,IND,0,Literate,7605000,0,7605000
3697,2094,Nanak Chand,FARIDABAD,IND,0,10th Pass,512000,0,512000
3698,3365,Nanaware Pramod Mahadeo,MAVAL,IND,0,Graduate,365491,0,365491
3699,2765,Nand Kishore Singh,PATNA SAHIB,IND,0,Graduate Professional,21239370,654750,20584620
3700,2942,Nand Kishore Tyagi,GUNA,IND,0,8th Pass,171000,0,171000
3701,5747,Nand Kumar Rajpoot,LUCKNOW,Rashtriya Krantikari Samajwadi Party,0,Graduate,500000,0,500000
3702,368,Nand Lal Ram,SASARAM,IND,0,8th Pass,688000,0,688000
3703,4784,Nand Lal Singh Chouhan,KHANDWA,IND,0,10th Pass,3366500,100000,3266500
3704,1582,Nand Lal Uikey,BALAGHAT,Chhattisgarh Swabhiman Manch,0,Post Graduate,8000,0,8000
3705,6312,Nandagopalakrishnan.K.,CUDDALORE,DMK,0,Graduate Professional,41858537,1162495,40696042
3706,4385,Nandakishor Singha,RAIGANJ,Amra Bangalee,0,10th Pass,727000,20000,707000
3707,4296,Nandakumar G,SALEM,IND,0,Others,6137168,0,6137168
3708,611,Nandan Nilekani,BANGALORE SOUTH,INC,0,Graduate Professional,77102957219,0,77102957219
3709,5171,Nandarkar Vishal Uddhav,AURANGABAD,IND,0,10th Pass,1088000,60000,1028000
3710,7399,"Nandha Kumar, V.",VELLORE,SP,0,Graduate,50000,0,50000
3711,6840,Nandi Yellaiah,NAGARKURNOOL,INC,0,Graduate,7048969,0,7048969
3712,3738,Nandini Alva,BANGALORE CENTRAL,JD(S),3,Graduate,807875641,37846084,770029557
3713,1483,Nandkishor Gangaram Rangari,CHANDRAPUR,Aambedkar-right Party of India,0,Post Graduate,4111000,1580000,2531000
3714,4194,Nandkumar Singh Chouhan,KHANDWA,BJP,0,Post Graduate,40188989,9561188,30627801
3715,4211,Nandlal Chauhan,UJJAIN,Bahujan Mukti Party,0,12th Pass,8829056,0,8829056
3716,4783,Nandlal Singh Chouhan (Nandu Bhaiya),KHANDWA,IND,0,5th Pass,420000,450000,0
3717,7932,Nandyala Narsimha Reddy,NALGONDA,CPI(M),0,Graduate,7948560,0,7948560
3718,3770,Nanjappa,CHIKKBALLAPUR,IND,0,5th Pass,6350000,0,6350000
3719,2492,Nar Bahadur Khatiwara,SIKKIM,BJP,0,Graduate Professional,41384503,0,41384503
3720,3419,Narain Das Sindhi,AJMER,IND,0,12th Pass,402000,0,402000
3721,4589,Naranbhai Jemlabhai Rathwa,CHHOTA UDAIPUR,INC,0,Post Graduate,40904985,850000,40054985
3722,3247,Narayan Chandra Jena,BHADRAK,AAP,1,Graduate,2066000,0,2066000
3723,3536,Narayan Gundu Powar,KOLHAPUR,AAP,6,12th Pass,3352800,1120000,2232800
3724,3431,Narayan Lal,JALORE,IND,0,8th Pass,115000,0,115000
3725,2354,Narayan Lal Parihar,JAIPUR RURAL,Bharat Nav Nirman Party,0,8th Pass,1567700,253370,1314330
3726,135,Narayan Singh,RAJGARH,INC,4,12th Pass,13622052,1709097,11912955
3727,4255,Narayan Singh,AGRA,BSP,1,Literate,45103247,9921989,35181258
3728,4079,Narayan Singh Kushwah,GWALIOR,IND,0,12th Pass,338425,0,338425
3729,3794,Narayanaswamy,KOLAR,IND,0,Literate,401390,0,401390
3730,2939,Narayanrao Gupchup,GUNA,IND,0,8th Pass,4055500,0,4055500
3731,2681,Narendar Kumar,JAHANABAD,SHS,0,Graduate,311800,0,311800
3732,2018,Narender,HISAR,IND,1,10th Pass,30260500,700000,29560500
3733,2067,Narender Pichopa-Khurd,BHIWANI-MAHENDRAGARH,IND,0,12th Pass,300000,0,300000
3734,2807,Narendra Bansod,RAJNANDGAON,Ambedkarite Party of India,0,Graduate Professional,1590000,0,1590000
3735,675,Narendra Bhati,GAUTAM BUDHHA NAGAR,SP,0,12th Pass,53617561,0,53617561
3736,2501,Narendra Chandra Deb Barma,TRIPURA EAST,Indigenous Peoples Front of Tripura,0,Graduate,11365500,0,11365500
3737,1406,Narendra Chinduji Meshram,WARDHA,GGP,0,5th Pass,4121000,20000,4101000
3738,5386,Narendra Gupta,DURG,Bhrashtachar Mukti Morcha,0,Graduate Professional,7685000,0,7685000
3739,971,Narendra Kr Pandey,CHANDNI CHOWK,BSP,0,12th Pass,48980150,3166282,45813868
3740,5776,Narendra Kumar,MOHANLALGANJ,INC,0,Graduate,29531000,0,29531000
3741,6628,Narendra Kumar Shrivastava,BANDA,IND,0,10th Pass,3803936,0,3803936
3742,6585,Narendra Modi,VADODARA,BJP,0,Post Graduate,15157582,0,15157582
3743,821,Narendra Mohanty,KANDHAMAL,AAP,9,Post Graduate,1217466,287074,930392
3744,5642,Narendra Prabhashankar Pandey,THANE,IND,0,10th Pass,9554000,0,9554000
3745,2650,Narendra Pratap Singh,BUXAR,IND,0,Post Graduate,7294224,0,7294224
3746,26,Narendra Sharma,NORTH EAST DELHI,SUCI(C),0,Post Graduate,112772737,0,112772737
3747,1343,Narendra Singh Rawat,NEW DELHI,IND,0,12th Pass,79000,0,79000
3748,2957,Narendra Singh Tomar,GWALIOR,BJP,1,Graduate,11412622,4531444,6881178
3749,6545,Narendrabhai Amrutlal Mahajan,RAJKOT,IND,0,8th Pass,30000,0,30000
3750,4544,Narendranath Chaganla,MEDAK,BJP,13,10th Pass,1764805829,88204083,1676601746
3751,7675,Naresh,ADILABAD,INC,0,Doctorate,1800000,0,1800000
3752,5880,Naresh Arvind Thakur,KALYAN,AAP,0,Post Graduate,3157123,6270,3150853
3753,433,Naresh Batra,HISAR,IND,0,10th Pass,38729000,0,38729000
3754,3039,Naresh Chand,AMROHA,IND,0,10th Pass,11068000,0,11068000
3755,1684,Naresh Gautam,GHAZIABAD,Bahujan Mukti Party,0,Graduate,3660000,0,3660000
3756,2060,Naresh Kumar,BHIWANI-MAHENDRAGARH,SP,0,Not Given,2992100,0,2992100
3757,3040,Naresh Kumar,AMROHA,IND,0,Post Graduate,2145327,0,2145327
3758,1288,Naresh Kumar,SOUTH DELHI,IND,0,Illiterate,143186,0,143186
3759,7909,Naresh Kumar,JHANSI,Rashtriya Sarvajan Party,0,8th Pass,333900,0,333900
3760,4104,Naresh Kumar Priyadarshi,BANKA,IND,0,Graduate,3863500,250000,3613500
3761,1425,Naresh Mahadeo Patil,RAMTEK,Bahujan Mukti Party,0,Doctorate,3845000,312000,3533000
3762,1516,Naresh Mahadeorao Gughane,YAVATMAL-WASHIM,IND,0,8th Pass,65000,0,65000
3763,2715,Naresh Prasad Singh,NALANDA,IND,0,Graduate,11387000,2599000,8788000
3764,4842,Naresh Rishi,MALDAHA DAKSHIN,IND,0,12th Pass,528000,0,528000
3765,3053,Naresh Singh Solanki,AONLA,AAP,0,Graduate,32537903,8782000,23755903
3766,5406,Naresh Tandi,RAIPUR,IND,1,5th Pass,551000,0,551000
3767,2017,Narinder Kumar,HISAR,IND,0,Others,8931000,600000,8331000
3768,3430,Naringa Ram Yadav,JALORE,IND,0,Post Graduate,8840490,0,8840490
3769,4602,Nariya Pravinbhai Vallabhbhai,JAMNAGAR,IND,0,5th Pass,42000,0,42000
3770,6416,Narla Mohan Rao,SECUNDERABAD,All India Majlis-E-Ittehadul Muslimeen,0,10th Pass,15073000,0,15073000
3771,4822,Narmada Prashad Ahirwar,VIDISHA,Bahujan Mukti Party,0,5th Pass,3862000,0,3862000
3772,3355,Narwekar Rahul Suresh,MAVAL,NCP,0,Graduate Professional,100454484,13436552,87017932
3773,1615,Naseem Ahmad Ansari,MUZAFFARNAGAR,IND,0,Literate,126110,0,126110
3774,3177,Naseer Ahmad Khan,RAMPUR,SP,0,Post Graduate,36512409,0,36512409
3775,509,Nasir Ahmed,JORHAT,AIUDF,0,Graduate,1830000,0,1830000
3776,2105,Nasir Papulsab Bagwan,BELGAUM,JD(S),0,12th Pass,962297866,95826301,866471565
3777,6053,Nasiruddin Mir,SREERAMPUR,Indian Unity Centre,0,Post Graduate,633103,0,633103
3778,4361,Nasmul Hoque,MALDAHA DAKSHIN,Party for Democratic Socialism,1,10th Pass,625000,0,625000
3779,6964,"Natarajan, P.R.",COIMBATORE,CPI(M),1,12th Pass,4126060,0,4126060
3780,5685,Natarajan.M,NAMAKKAL,IND,0,8th Pass,17205000,1400000,15805000
3781,6988,Natarajan.R,DHARMAPURI,IND,0,10th Pass,3304600,0,3304600
3782,7478,Natchiappan Sp,SIVAGANGA,IND,0,5th Pass,51000,0,51000
3783,7275,Nathabhai Dayabhai Tota,AMRELI,IND,0,Literate,148000,50000,98000
3784,5969,Nathekar Pramod Gyaniram,NASHIK,IND,0,10th Pass,253000,96000,157000
3785,1145,Nathu Ram,SAMBALPUR,BSP,0,Graduate,6538687,0,6538687
3786,2310,Natthi Lal Sharma,ALIGARH,IND,0,Graduate,9794000,0,9794000
3787,7905,Natubhai G. Patel,DADRA & NAGAR HAVELI,BJP,5,5th Pass,154760217,62286836,92473381
3788,4474,Naushaba Khanam,BHAGALPUR,BSP,2,10th Pass,6756440,600000,6156440
3789,1243,Naushad Alam,CHATRA,AITC,0,Graduate,4839400,0,4839400
3790,513,Navajyoti Kalita,DIBRUGARH,AITC,0,10th Pass,25004000,32650000,0
3791,3566,Navanath Bhimrao Patil,MADHA,Hindusthan Praja Paksha,1,Graduate,1102500,160000,942500
3792,3186,Naved Mian,RAMPUR,IND,0,Not Given,95000,0,95000
3793,1321,Naveen Chandra,NEW DELHI,Naya Daur Party,0,Graduate,4565000,0,4565000
3794,5407,Naveen Gupta,RAIPUR,SP,0,10th Pass,23829011,4816480,19012531
3795,451,Naveen Jaihind,ROHTAK,AAP,1,Doctorate,340057,0,340057
3796,754,Naveen Jain,JABALPUR,IND,0,Graduate,11687096,50000,11637096
3797,631,Naveen Jindal,KURUKSHETRA,INC,2,Post Graduate,3083154000,49114000,3034040000
3798,4026,Naveen Murmu,SINGHBHUM,Rashtriya Deshaj Party,0,12th Pass,590500,0,590500
3799,5192,Navid Hasan Momin,BHIWANDI,IND,1,Graduate,500157500,0,500157500
3800,4742,Navin Chandra Jha,GODDA,IND,0,Post Graduate,958900,0,958900
3801,2367,Navin Pilania,JAIPUR RURAL,National Peoples Party,0,Graduate Professional,117822738,18022060,99800678
3802,7749,Navjot Singh Mandair,LUDHIANA,BSP,0,Post Graduate,6071675,200000,5871675
3803,4491,Navlesh Pathak,PURNIA,IND,0,Post Graduate,25060000,10000,25050000
3804,3603,Navnath Dashrath Uplekar,OSMANABAD,IND,0,10th Pass,160000,0,160000
3805,6122,Navneet,BATHINDA,SHS,0,12th Pass,5760000,560000,5200000
3806,7745,Navneet Chautala,ANANDPUR SAHIB,IND,0,12th Pass,3005000,1012,3003988
3807,216,Navneet Ravi Rana,AMRAVATI,NCP,3,10th Pass,29496562,1858727,27637835
3808,7767,Navpreet Singh Bedi,LUDHIANA,IND,1,Post Graduate,9996000,0,9996000
3809,6079,Navulla Mallareddy,BHONGIR,IND,0,Post Graduate,1485500,45000,1440500
3810,3179,Nawab Kazim Ali Khan,RAMPUR,INC,0,Post Graduate,571146438,7745000,563401438
3811,1256,Nawal Kishor Singh,LOHARDAGA,IND,0,10th Pass,1733000,0,1733000
3812,5323,Nayak Manojkumar Jantilal,GANDHINAGAR,Loktantrik Rashrtavadi Party,0,12th Pass,186000,0,186000
3813,2720,Nayeb Ali,NALANDA,AITC,0,Doctorate,1896783,0,1896783
3814,3900,Nazakat Hussain,UDHAMPUR,IND,0,Post Graduate,500000,0,500000
3815,1872,Nazarudheen,MALAPPURAM,SDPI,5,10th Pass,1855691,750000,1105691
3816,3803,Nazeer Hussain,KOPPAL,Rashtriya Krantikari Samajwadi Party,0,10th Pass,582000,0,582000
3817,4077,Neelam Agrwal,GWALIOR,AAP,0,12th Pass,3461200,700000,2761200
3818,3010,Neeraj,TIKAMGARH,CPI,0,8th Pass,461000,0,461000
3819,4260,Neeraj Kumar Advocate,AKBARPUR,IND,0,Graduate Professional,1985000,0,1985000
3820,6241,Neeraj Pathak,MADHUBANI,AAP,0,Graduate,13763263,120000,13643263
3821,2385,Neeru Agarwal,JAIPUR,National Unionist Zamindara Party,0,Post Graduate,2665000,0,2665000
3822,2458,Neeru Ram,RAJSAMAND,BSP,0,10th Pass,6866060,90000,6776060
3823,2867,Neil Tirkey,KHUNTI,AJSUP,1,Graduate,23771799,8400000,15371799
3824,407,Neiphiu Rio,NAGALAND,NPF,0,Graduate,315834264,0,315834264
3825,3455,Nemichand,NAGAUR,AARAKSHAN VIRODHI PARTY,0,10th Pass,246000,0,246000
3826,3102,Net Ram,BAREILLY,IND,0,Literate,6525004,0,6525004
3827,6201,Nethawath Ramdas,ADILABAD,IND,0,Illiterate,0,0,0
3828,3253,Netrananda Mallick,BHADRAK,Aama Odisha Party,0,Graduate,1710000,0,1710000
3829,5220,Nihal Ah A Reheman,DHULE,SP,0,10th Pass,28605000,0,28605000
3830,2281,Nihalchand,GANGANAGAR,BJP,0,Graduate,10861172,1611557,9249615
3831,6872,Nijam Mohaideen .M,CHENNAI NORTH,SDPI,0,Graduate,1394351,79800,1314551
3832,3685,Nikam Devdatta Jaywant,SHIRUR,NCP,3,Graduate,7277063,296000,6981063
3833,3395,Nikam Sopanrao Pandharinath,SHIRUR,AAP,0,Post Graduate,35506712,300000,35206712
3834,4362,Nikhil Chandra Mondal,MALDAHA DAKSHIN,BSP,0,10th Pass,10144432,160000,9984432
3835,372,Nikhil Kumar,AURANGABAD,INC,0,Post Graduate,297302441,0,297302441
3836,3971,Nikhil Kumar Choudhary,KATIHAR,BJP,0,Graduate,25225976,408966,24817010
3837,1323,Nikhil Sablania,NEW DELHI,IND,0,Graduate Professional,38000,0,38000
3838,1227,Nilam Devi,CHATRA,JVM(P),0,5th Pass,9780527,1048964,8731563
3839,3631,Nilesh Dhanave,PUNE,IND,0,Post Graduate,14136754,1950000,12186754
3840,1429,Nilesh Mahadeo Dhoke,RAMTEK,IND,0,8th Pass,0,0,0
3841,3641,Nilesh Narayan Rane,RATNAGIRI SINDHUDURG,INC,2,Doctorate,136811633,49129849,87681784
3842,4803,Nilesh Tiwari,MANDSOUR,IND,0,Post Graduate,1156972,0,1156972
3843,3689,Nilesh Yashwant Mhaskule,SHIRUR,IND,0,12th Pass,819858,210000,609858
3844,3164,Nilima Sharma,PILIBHIT,Peace Party,0,Doctorate,5595570,20000,5575570
3845,2268,Nilu Mandol,SILCHAR,SHS,0,8th Pass,283000,0,283000
3846,2572,Nilufar Jamani,TUMKUR,BSP,0,Graduate,740837798,0,740837798
3847,1796,Nima Lama,DARJEELING,Gorkha Rashtriya Congress,0,Graduate,7664167,155997,7508170
3848,4854,Nimu Bhowmick,RAIGANJ,BJP,0,10th Pass,3200680,0,3200680
3849,1096,Nina P Nayak,BANGALORE SOUTH,AAP,0,Post Graduate,35129117,1000000,34129117
3850,406,Ninong Ering,ARUNACHAL EAST,INC,0,Graduate,88065000,0,88065000
3851,3339,Nirada Barana Khuntia,PURI,AAP,0,Not Given,5004386,0,5004386
3852,2748,Niraj Kumar,PATALIPUTRA,IND,0,Graduate,51500,0,51500
3853,4460,Niraj Kumar,BANKA,AAP,0,12th Pass,1977100,0,1977100
3854,2722,Niraj Sharma,NALANDA,Rajnaitik Vikalp Party,0,Literate,11399238,0,11399238
3855,156,Niranjan Kumar,GAYA,CPI(ML)L,2,Graduate,140000,1384,138616
3856,4734,Niranjan Prasad Yadav,GODDA,IND,0,Post Graduate,1015032,105000,910032
3857,3300,Niranjan Saha,DARJEELING,Amra Bangalee,0,Graduate Professional,1825400,0,1825400
3858,5023,Niranjan Singh,HATHRAS,IND,0,10th Pass,4023000,0,4023000
3859,4404,Niranjan Singh Dhangar,HATHRAS,RLD,1,12th Pass,48777359,2328803,46448556
3860,4410,Nirmal Kumar,KANNAUJ,BSP,0,Post Graduate,47927051,13842793,34084258
3861,3274,Nirmal Samal,DHENKANAL,IND,0,8th Pass,740000,0,740000
3862,578,Nirmal Singh,JAMMU,IND,0,Graduate,30496000,904000,29592000
3863,6144,Nirmal Singh,FATEHGARH SAHIB,NCP,0,12th Pass,170000,0,170000
3864,7717,Nirmal Singh Bolina,JALANDHAR,IND,0,Post Graduate,2724000,2000000,724000
3865,7847,Nirmal Singh Dhaliwal,PATIALA,CPI,0,Graduate Professional,8403786,300000,8103786
3866,1279,Nirmala,FARIDABAD,JD(U),0,Illiterate,2914700,0,2914700
3867,3761,Nirmala Kumari,CHAMARAJANAGAR,IND,0,Post Graduate,295000,0,295000
3868,2852,Niroop Mahanty,JAMSHEDPUR,JMM,0,Post Graduate,191088713,0,191088713
3869,2260,Nirupam Mandal,SILCHAR,IND,0,Graduate Professional,25500,0,25500
3870,3342,Nisar Subhan Khan Pathan,PARBHANI,IND,1,12th Pass,3100000,165000,2935000
3871,1660,Nishant Tyagi,BAGHPAT,IND,0,12th Pass,1147000,0,1147000
3872,5076,Nishar Ahmad,ALWAR,Jai Maha Bharath Party,0,Literate,36413916,0,36413916
3873,4476,Nishi Kant Mandal,BHAGALPUR,Bahujan Mukti Party,0,Graduate Professional,1480865,303354,1177511
3874,4164,Nishikant Dubey,GODDA,BJP,5,Post Graduate,155633719,0,155633719
3875,2872,Nitima Bodra Bari,KHUNTI,SP,0,Graduate,6237543,0,6237543
3876,1678,Nitin,GHAZIABAD,IND,0,10th Pass,1000,0,1000
3877,3652,Nitin Ganpatrao Savgave,SANGLI,Bahujan Mukti Party,0,Doctorate,17149503,2630000,14519503
3878,7244,Nitin H. Khare,MUMBAI NORTH WEST,IND,0,Graduate Professional,8395927,2457620,5938307
3879,7315,Nitin Ishwarlal Vakil,BHARUCH,IND,0,Graduate Professional,715400,0,715400
3880,3406,Nitin Navnath Udmale,SHIRDI,AAP,0,Graduate,3756000,1692146,2063854
3881,7190,Nitin Ravindra Rajvardhan,MUMBAI NORTH,Bahujan Mukti Party,0,10th Pass,5315311,0,5315311
3882,5644,Nitin Shankar Deshpande,THANE,Dharmarajya Paksha,0,Post Graduate,11459035,368337,11090698
3883,6645,Nitin Singh,BARABANKI,Naitik Party,0,Graduate,50000,0,50000
3884,1485,Nitin Vasant Pohane,CHANDRAPUR,Lok Bharati,0,Graduate,8529000,2255000,6274000
3885,770,Nitinkumar Sahu,CHHINDWARA,BSP,2,10th Pass,585000,150000,435000
3886,2688,Nityanand Singh,JAHANABAD,IND,2,Literate,1392245,2000000,0
3887,7215,Niyaz Ahmed Allauddin Shaikh,MUMBAI NORTH CENTRAL,Awami Vikas Party,0,8th Pass,40851500,171500000,0
3888,306,Noble Mathew,KOTTAYAM,IND,0,Post Graduate,55079708,50000,55029708
3889,5391,Nohar Singh Sonwani,JANJGIR-CHAMPA,SP,0,Graduate,3270000,0,3270000
3890,7349,Nole Javidbhai Osmanbhai,JAMNAGAR,IND,0,8th Pass,32000,0,32000
3891,7159,Noor Jiyavudeen.M.I,RAMANATHAPURAM,SDPI,5,8th Pass,5640727,1245457,4395270
3892,5947,Noor Mohammed Khan,MUMBAI SOUTH CENTRAL,IND,1,10th Pass,47491284,0,47491284
3893,4278,Noor Mohmmad,ETAH,BSP,0,Graduate Professional,27700594,0,27700594
3894,310,Nripendra Narayan Singha Karjee,COOCHBEHAR,SUCI(C),1,12th Pass,368300,0,368300
3895,4354,Nural Islam,BALURGHAT,SUCI(C),0,Graduate,880700,0,880700
3896,6020,Nurul Islam,BIRBHUM,JD(U),0,Graduate,200038,0,200038
3897,3197,Nutan Vijay,SAMBHAL,IND,0,Post Graduate,80200000,0,80200000
3898,348,O M Jyotheendra Nath,THIRUVANANTHAPURAM,IND,0,Graduate,5620000,130000,5490000
3899,346,O Rajagopal,THIRUVANANTHAPURAM,BJP,0,Graduate Professional,1211046,0,1211046
3900,634,O V Sreedath,THIRUVANANTHAPURAM,Socialist Republican Party,4,Graduate,33965814,0,33965814
3901,3482,Oinam Jotin Singh,INNER MANIPUR,Jai Maha Bharath Party,0,Graduate,336000,0,336000
3902,2199,Olwin Mariyan Lopis,UTTARA KANNADA,Bahujan Mukti Party,0,10th Pass,398845,0,398845
3903,2409,Om Birla,KOTA,BJP,2,Post Graduate,25870497,997366,24873131
3904,1005,Om Dutt Sharma,NORTH EAST DELHI,SHS,2,12th Pass,197000,0,197000
3905,2297,Om Parkash,GANGANAGAR,IND,0,Literate,350600,0,350600
3906,2006,Om Parkash,HISAR,Bharatiya Sant Mat Party,0,10th Pass,2024000,0,2024000
3907,7732,Om Parkash Jakhu,HOSHIARPUR,IND,0,5th Pass,58144,0,58144
3908,5763,Om Prakash,MISRIKH,INC,0,Post Graduate,49009224,3691009,45318215
3909,6718,Om Prakash,MOHANLALGANJ,Peace Party,0,12th Pass,461300,0,461300
3910,4922,Om Prakash,AGRA,IND,0,Literate,1935966,0,1935966
3911,5408,Om Prakash Dande,RAIPUR,IND,0,12th Pass,9814792,400000,9414792
3912,1045,Om Prakash Dhankhad,ROHTAK,BJP,1,Post Graduate,10587916,0,10587916
3913,2331,Om Prakash Jharoda,JHUNJHUNU,CPI(ML)L,3,10th Pass,230500,0,230500
3914,3472,Om Prakash Mali,PALI,IND,0,5th Pass,166500,0,166500
3915,4351,Om Prakash Mishra,BALURGHAT,INC,0,Post Graduate,12670505,1594992,11075513
3916,3153,Om Prakash Ravi,NAGINA,SHS,0,8th Pass,468848,0,468848
3917,1289,Ombir,SOUTH DELHI,Bharatiya Bahujan Party,0,12th Pass,732000,0,732000
3918,868,Ombir,BHIWANI-MAHENDRAGARH,Lok Parivartan Party(DC),0,10th Pass,1040000,0,1040000
3919,2083,Ombir Sharma,GURGAON,IND,0,10th Pass,5496500,0,5496500
3920,4263,Omkar Nath,AKBARPUR,Al-Hind Party,0,Doctorate,1005820,0,1005820
3921,756,Omkar Singh Markam,MANDLA,INC,0,Post Graduate,9618675,0,9618675
3922,1355,Ompal Singh,EAST DELHI,Kalyankari Jantantrik Party,0,Graduate,9063978,550000,8513978
3923,6567,Omprakash Anandiprasad Shrivastav,SURAT,BSP,1,12th Pass,556081,0,556081
3924,5409,Omprakash Meshram,RAIPUR,Republican Paksha (Khoripa),0,Post Graduate,264000,0,264000
3925,4407,Omprkash,HATHRAS,IND,0,8th Pass,3440000,0,3440000
3926,5918,Omraj Lokish Rathod,MUMBAI SOUTH,IND,0,Graduate Professional,585000,0,585000
3927,3063,Omveer,AONLA,Bhartiya Vikas Party,0,Literate,211000,0,211000
3928,1027,Onkar Singh,KURUKSHETRA,National Janhit Congress (AB),0,Literate,13440157,673667,12766490
3929,3423,Otaram,JALORE,BSP,0,Graduate,26365198,1604589,24760609
3930,289,P C Chacko,CHALAKUDY,INC,0,Post Graduate,28000209,2063744,25936465
3931,168,P C Mohanan Master,KANNUR,BJP,2,12th Pass,12859808,739740,12120068
3932,1955,P C Venugopal,ALAPPUZHA,IND,0,Post Graduate,309510,158235,151275
3933,1807,P K Raman,KASARAGOD,IND,2,10th Pass,616200,0,616200
3934,255,P K Sreemathi,KANNUR,CPI(M),8,Others,16939970,0,16939970
3935,251,P Karunakaran,KASARAGOD,CPI(M),6,Post Graduate,5900345,0,5900345
3936,6648,P L Punia,BARABANKI,INC,0,Doctorate,20081069,0,20081069
3937,1223,P Muniraju,BANGALORE RURAL,BJP,0,12th Pass,505854419,76201010,429653409
3938,256,P P Aboobacker,KANNUR,CPI(ML) Red star,0,10th Pass,1375736,0,1375736
3939,3464,P P Choudhary,PALI,BJP,0,Graduate Professional,353503467,7892216,345611251
3940,1808,P P Mohanan,KANNUR,IND,0,12th Pass,13953502,0,13953502
3941,266,P R Rasmilnath,WAYANAD,BJP,0,Graduate,1445000,100000,1345000
3942,325,P V Natesan,ALAPPUZHA,BSP,0,Graduate,3219698,0,3219698
3943,845,P Y Hemanth Kumar,DHARWAD,AAP,0,12th Pass,62688810,0,62688810
3944,6863,P. Ahila,CHENNAI CENTRAL,IND,0,10th Pass,40000,0,40000
3945,4343,P. Asaithambi,TIRUCHIRAPPALLI,CPI(ML)L,0,Graduate,1000,0,1000
3946,5582,P. Asaravel,PONDICHERRY,IND,0,Literate,412500,0,412500
3947,5576,P. Bakkiaraj,PONDICHERRY,IND,1,8th Pass,149100,0,149100
3948,4535,P. Balram,MAHABUBABAD,INC,1,Post Graduate,737144941,8472086,728672855
3949,6856,P. Manimaran,CHENNAI CENTRAL,IND,0,5th Pass,61000,0,61000
3950,264,P.Abdul Hameed Master,VADAKARA,SDPI,1,Graduate,4988654,0,4988654
3951,7431,P.Balasubramaniyan,TIRUPPUR,IND,0,Not Given,332000,0,332000
3952,5490,P.C Kuril,BARABANKI,Indian National League,0,12th Pass,30509500,36000,30473500
3953,1218,P.C. Gaddigoudar,BAGALKOT,BJP,0,Graduate Professional,36362500,9589199,26773301
3954,187,P.C. Mohan,BANGALORE CENTRAL,BJP,2,12th Pass,475796999,261111285,214685714
3955,707,P.C.Jolly,IDUKKI,IND,0,12th Pass,16991308,5500000,11491308
3956,4326,P.Chandrabose,MADURAI,IND,2,Literate,905000,284000,621000
3957,721,P.D. Chandrabhanu,ERNAKULAM,Socialist Republican Party,0,10th Pass,8306000,884000,7422000
3958,7493,P.Gopalakrishnan,MADURAI,IND,0,Graduate,72803120,7406426,65396694
3959,7486,P.Jeyakumar,MADURAI,IND,0,Graduate Professional,1003650,260000,743650
3960,1900,P.K.Biju,ALATHUR,CPI(M),0,Post Graduate,3231047,341749,2889298
3961,3952,P.Kumar S/O Palanivel,TIRUCHIRAPPALLI,AIADMK,0,Graduate Professional,18522597,1917891,16604706
3962,1843,P.Kumarankutty,VADAKARA,IND,0,Graduate Professional,44347759,0,44347759
3963,6293,P.Loganathan,ARANI,IND,0,8th Pass,1213000,0,1213000
3964,335,P.M. Velayudhan,KOLLAM,BJP,0,10th Pass,5927000,750000,5177000
3965,5463,P.Muthaiyan,VILUPPURAM,IND,0,Illiterate,142500,0,142500
3966,6369,P.Narayansamy,KALLAKURICHI,IND,1,10th Pass,1714800,225000,1489800
3967,4333,P.Ramasubramanian,MADURAI,IND,0,10th Pass,3742169,3012000,730169
3968,7428,P.Selvaboobathi,TIRUPPUR,IND,0,5th Pass,155639,0,155639
3969,7546,P.V.Radhakrishnan,VIRUDHUNAGAR,IND,0,Graduate,5596881,145000,5451881
3970,6038,Paban Mazumder,HOOGHLY,SUCI(C),0,Graduate,779,0,779
3971,234,Paban Singh Ghatowar,DIBRUGARH,INC,0,Graduate,49229437,2547986,46681451
3972,4379,Pabitra Ranjan Dasmunshi (Satya),RAIGANJ,AITC,0,Graduate,11557345,3768411,7788934
3973,7125,"Pachamuthu, N.",PERAMBALUR,IND,0,Not Given,2025000,0,2025000
3974,1349,Padam Chand,EAST DELHI,IND,0,10th Pass,2670000,0,2670000
3975,5753,Padam Chandra Gupta,LUCKNOW,IND,0,Graduate Professional,4342000,0,4342000
3976,443,Padam Singh,SONIPAT,INLD,0,Graduate Professional,30051128,466311,29584817
3977,2049,Padam Singh,SONIPAT,IND,0,12th Pass,11672304,0,11672304
3978,4604,Padhiyar Laljibhai Karabhai,JAMNAGAR,IND,0,Literate,10051180,0,10051180
3979,6620,Padhiyar Vikramsinh Chhaganbhai,ANAND,Rashtriya Samaj Paksha,0,Graduate,2906733,0,2906733
3980,7945,Padiga Yarraiah,MAHABUBABAD,IND,0,5th Pass,480000,0,480000
3981,1333,Padmaja Kandukuri,NEW DELHI,IND,0,Not Given,2367592,180000,2187592
3982,3559,Padmakar Kondiba Ovhal,LATUR,IND,0,Literate,500,0,500
3983,2552,Padmamma M V,MYSORE,AAP,0,Graduate,11627675,478620,11149055
3984,268,Padmanabhan .C.K.,KOZHIKODE,BJP,0,10th Pass,9306000,400000,8906000
3985,7032,Padmanabhan S.,KANNIYAKUMARI,IND,0,Post Graduate,4575197,0,4575197
3986,4028,Padmarajan.K.Dr,DHARMAPURI,IND,0,Post Graduate,1515900,48000,1467900
3987,3604,Padmsinh Vijaysinh Mundhe,OSMANABAD,IND,0,12th Pass,1080000,188000,892000
3988,7868,Paduri Srinivas Reddy,MALKAJGIRI,Telangana Loksatta Party,0,Post Graduate,56066969,85000,55981969
3989,4593,Pagi Ganpatbhai Mavjibhai,GANDHINAGAR,IND,0,12th Pass,133796,0,133796
3990,3844,Paglanand,BADAUN,Mahan Dal,0,10th Pass,1795492,0,1795492
3991,5948,Pal Jitendra Kumar Nanaku,MUMBAI SOUTH CENTRAL,IND,0,12th Pass,1108000,0,1108000
3992,2285,Pala Ram,GANGANAGAR,CPI(M),0,Literate,750500,0,750500
3993,5331,Palani Ali Ishak,JAMNAGAR,IND,0,5th Pass,26000,0,26000
3994,7479,Palani S,SIVAGANGA,IND,0,10th Pass,236000,0,236000
3995,7384,"Palani, A. Thiru",SRIPERUMBUDUR,IND,1,10th Pass,15310000,0,15310000
3996,6342,Palaniappan Josiyar C.M,ERODE,CPI(ML) Red Star,0,Illiterate,20000,0,20000
3997,7543,Palanichamy,VIRUDHUNAGAR,IND,0,Post Graduate,0,0,0
3998,7097,Palanisamy. G,NAGAPATTINAM,CPI,0,5th Pass,3022631,0,3022631
3999,7145,Palanisamy. N,POLLACHI,IND,0,8th Pass,7658116,5200000,2458116
4000,7146,Palanisamy. V,POLLACHI,IND,0,Literate,1486600,325000,1161600
4001,7451,Palanivel.P,TIRUCHIRAPPALLI,IND,0,Post Graduate,24953196,16407645,8545551
4002,2032,Pale Ram Kashyap,KARNAL,Rashtriya Janshakti Party(Eklavya),0,10th Pass,731148,0,731148
4003,2481,Pallickal Surendran,MAVELIKKARA,IND,0,10th Pass,410278,0,410278
4004,7175,Palpandi .C,RAMANATHAPURAM,IND,1,Graduate,120000,0,120000
4005,7550,"Palpandi, S.",VIRUDHUNAGAR,IND,0,Doctorate,0,0,0
4006,2280,Paluskar Krishnarao Tatoba,GANGANAGAR,Prabuddha Republican Party,0,Post Graduate,3461100,1500000,1961100
4007,4188,Pamanand Tolani,INDORE,IND,0,10th Pass,2371000,375000,1996000
4008,7465,Panasai Arangan.N,THANJAVUR,IND,0,10th Pass,30000,0,30000
4009,2741,Pancham Lal,PATALIPUTRA,IND,0,Graduate,29991521,0,29991521
4010,6271,Panchu.Udayakumar,ARAKKONAM,IND,0,Post Graduate,710000,150000,560000
4011,5348,Pandav Bhailalbhai Kalubhai,KHEDA,BSP,0,10th Pass,80000,0,80000
4012,5958,Pandhare Vijay Baliram,NASHIK,AAP,0,Graduate Professional,16620000,0,16620000
4013,6327,Pandi.N,DINDIGUL,CPI(M),1,12th Pass,2920205,604640,2315565
4014,7545,Pandiarajan,VIRUDHUNAGAR,IND,0,8th Pass,1958200,1200000,758200
4015,7087,Pandiyan .R,MAYILADUTHURAI,IND,0,10th Pass,769965,0,769965
4016,5989,Pandurang Jethya Pardhi,PALGHAR,AAP,0,10th Pass,1337700,260000,1077700
4017,3670,Pandurang Ramchandra Shinde,SATARA,IND,2,Post Graduate,52408590,1700753,50707837
4018,3543,Pandurang Tukaram Chougale,KOLHAPUR,IND,0,8th Pass,2522000,0,2522000
4019,5334,Pandya Chiragbhai Hariombhai,JAMNAGAR,IND,0,10th Pass,3316540,900000,2416540
4020,7799,Panjab Singh Katwal,FIROZPUR,IND,0,12th Pass,17282000,1800000,15482000
4021,660,Pankaj Agarwal,MUZAFFARNAGAR,INC,0,Graduate,242260053,27148000,215112053
4022,4103,Pankaj Kishor Mandal,ARARIA,IND,2,10th Pass,202412,50000,152412
4023,4992,Pankaj Kumar Sharma,FATEHPUR SIKRI,Rashtriya Samanta Dal,0,Post Graduate,14308000,10000,14298000
4024,3974,Pankaj Kumar Singh,PURNIA,CPI(ML)L,3,8th Pass,2961753,0,2961753
4025,6160,Pankaj Paswan,BEGUSARAI,IND,0,Post Graduate,102895,0,102895
4026,2536,Pankaj Prafulkumar Bhansali,NAGPUR,IND,0,12th Pass,20684589,0,20684589
4027,51,Pankaj Sewakram Masurkar,RAMTEK,Hindustan Janta Party,0,10th Pass,30000,0,30000
4028,742,Pankaj Singh Patel,SIDHI,AAP,0,Post Graduate,144766,0,144766
4029,6604,Pankajkumar Parbhubhai Patel,VALSAD,Aadivasi Sena Party,1,Graduate Professional,3718604,0,3718604
4030,922,Pankajkumar Sharma,CHANDRAPUR,AITC,0,Graduate,9757822,450000,9307822
4031,5706,Panneerselvam N,SALEM,IND,1,8th Pass,1135000,425000,710000
4032,7564,Panneerselvam.C,THOOTHUKKUDI,IND,0,Graduate Professional,146579,0,146579
4033,5689,Panneerselvam.S,NAMAKKAL,IND,0,12th Pass,2086049,0,2086049
4034,3938,Pannerselvam.V,SALEM,AIADMK,0,Graduate Professional,32268097,253282,32014815
4035,6633,Pappu Yadav,BANDA,JD(U),0,12th Pass,1322000,0,1322000
4036,6410,Parameshwar Ramagalla,WARANGAL,BJP,5,Graduate Professional,9280000,308203,8971797
4037,810,Parameswar Kand,KALAHANDI,Samata Kranti Dal,1,12th Pass,2270000,100000,2170000
4038,8543,Paramjeet Kaur W/O Gurpreet Singh,FARIDKOT,IND,0,Literate,230466,100000,130466
4039,7796,Paramjeet Singh Desal,FIROZPUR,IND,0,8th Pass,950000,0,950000
4040,6135,Paramjit Kaur Gulshan,FARIDKOT,SAD,0,Post Graduate,37637845,4876412,32761433
4041,7786,Paramjit Kaur Wife Of Amrik Singh,FARIDKOT,Bahujan Mukti Party,0,10th Pass,60000,0,60000
4042,7706,Paramjit Kumar,JALANDHAR,Bahujan Mukti Party,0,12th Pass,566932,0,566932
4043,6137,Paramjit Singh,FATEHGARH SAHIB,IND,0,10th Pass,532000,0,532000
4044,1050,Paramjit Singh,KARNAL,AAP,0,Graduate,2863613,1382819,1480794
4045,1824,Parappa Shankareppa Antakkanavar,BELGAUM,IND,1,Graduate Professional,12751189,1053795,11697394
4046,4794,Paras Dada Saklecha,MANDSOUR,AAP,2,Post Graduate,4657101,136232,4520869
4047,1061,Parashuram Rathod,BAGALKOT,IND,0,12th Pass,776342,84800,691542
4048,2204,Parasuram S,DAVANAGERE,CPI(ML)L,0,Literate,271500,125000,146500
4049,7459,Parasuraman.K,THANJAVUR,AIADMK,0,12th Pass,146049347,27954352,118094995
4050,7303,Parbhubhai Nagarbhai Vasava,BARDOLI,BJP,1,Others,15909957,1353400,14556557
4051,768,Pardaeshi Lal Uikey,CHHINDWARA,GGP,0,12th Pass,864500,0,864500
4052,2068,Pardeep Singh Tanwar,BHIWANI-MAHENDRAGARH,IND,0,Graduate,17720045,225000,17495045
4053,6093,Pardeep Singh Walia,AMRITSAR,BSP,0,Others,49565228,450000,49115228
4054,1607,Pardip,KAIRANA,Bahujan Mukti Party,0,12th Pass,871000,0,871000
4055,4446,Paresh Baishya,MANGALDOI,AIUDF,2,Graduate,459875,0,459875
4056,5283,Paresh Dahyalal Rawal,AHMEDABAD EAST,BJP,0,12th Pass,795211576,81472461,713739115
4057,7012,Pargunan A.,KANCHEEPURAM,IND,0,10th Pass,0,0,0
4058,7626,Parikh Viral Hasmukhbhai,KHEDA,IND,9,12th Pass,3386800,500000,2886800
4059,7115,"Parivendar Pachamuthu, T.R.",PERAMBALUR,BJP,1,Post Graduate,776948435,30885280,746063155
4060,7284,Parmar Amarsinh Dahyabhai,ANAND,IND,0,8th Pass,27000,0,27000
4061,6503,Parmar Bhaichandbhai Somabhai,PATAN,Republican Party of India Ektavadi,0,5th Pass,273000,0,273000
4062,7268,Parmar Harjivanbhai Kalabhai,AHMEDABAD WEST,IND,0,10th Pass,190000,0,190000
4063,7290,Parmar Hitendrasinh Mohansinh,ANAND,Bharatiya National Janta Dal,0,8th Pass,1095800,0,1095800
4064,4899,Parmar Maganbhai Amarabhai,PATAN,BSP,0,10th Pass,940000,0,940000
4065,6574,Parmar Minaxiben Vijaybhai,SURENDRANAGAR,BSP,0,5th Pass,238278,0,238278
4066,6582,Parmar Prabhubhai Gokalbhai,SURENDRANAGAR,IND,1,Graduate Professional,4464629,0,4464629
4067,5361,Parmar Ramsinh Prabhatsinh,PANCHMAHAL,INC,0,10th Pass,43816858,547000,43269858
4068,6618,Parmar Ravjibhai Shibhaibhai,ANAND,AAP,0,Post Graduate,11314555,294189,11020366
4069,7650,Parmar Vasharambhai Bavalbhai,SURENDRANAGAR,IND,0,Literate,216851,0,216851
4070,623,Parmendra Kumar Yadav,NAWADA,Bharatiya Ekta Dal,0,12th Pass,1030800,0,1030800
4071,1383,Parmeshwar Hiraman Gawai,BULDHANA,Ambedkarist Republican Party,0,12th Pass,8810000,60000,8750000
4072,5275,Parmeshwar Jha,SUPAUL,AAP,0,Graduate,11516000,0,11516000
4073,748,Parmeshwar Singh,SHAHDOL,CPI,0,5th Pass,515000,200000,315000
4074,2712,Parnav Prakash,NALANDA,AAP,0,Graduate Professional,58483543,16000000,42483543
4075,4153,Parshuram Paswan,DHANBAD,IND,0,Graduate Professional,77400,0,77400
4076,5061,Parsottam,MATHURA,Rashtriya Mahan Ganatantra Party,0,12th Pass,781935,0,781935
4077,818,Parsuram Majhi,NABARANGPUR,BJP,0,Graduate,8274821,61600,8213221
4078,7654,Partap Singh Bajwa,GURDASPUR,INC,0,Graduate,247069039,0,247069039
4079,524,Partha Karmakar,TRIPURA WEST,CPI(ML)L,0,Graduate,5540194,0,5540194
4080,7505,"Parthipan, R.",THENI,AIADMK,0,Graduate,22047681,869650,21178031
4081,6959,"Parvathi, S",CHIDAMBARAM,IND,0,Not Given,210000,0,210000
4082,2762,Parveen Amanullah,PATNA SAHIB,AAP,0,Graduate,34292500,0,34292500
4083,7837,Parveen Kaur,SANGRUR,IND,0,8th Pass,1270000,0,1270000
4084,7861,Parveen Kumar,PATIALA,IND,0,12th Pass,52500,0,52500
4085,7862,Parvesh Bhateja,PATIALA,IND,0,8th Pass,453030,190632,262398
4086,70,Parvesh Sahib Singh,WEST DELHI,BJP,1,Post Graduate,107235461,26650000,80585461
4087,1762,Parvez Aqil,BIJNOR,All India Minorities Front,0,Graduate,104992,0,104992
4088,2776,Parwez Ahmad,PATNA SAHIB,Loktantrik Janata Party (Secular),0,Graduate,88692,0,88692
4089,4855,Pasarul Alam,RAIGANJ,AAP,0,Post Graduate,10495835,1636925,8858910
4090,4701,Pashupati Nath Singh,DHANBAD,BJP,1,Graduate,24248150,0,24248150
4091,7436,Pastor A.James,TIRUPPUR,IND,0,10th Pass,31000,0,31000
4092,6556,Patel Bhogilal Haribhai,SABARKANTHA,Bharatiya National Janta Dal,0,8th Pass,3872000,2660000,1212000
4093,5359,Patel Bhupendrakumar Dhirubhai,NAVSARI,JD(U),0,10th Pass,3015000,0,3015000
4094,5296,Patel Dilipbhai Manibhai,ANAND,BJP,4,10th Pass,75998610,7632620,68365990
4095,7288,Patel Dilipbhai Manilal,ANAND,IND,0,Post Graduate,390000,0,390000
4096,5351,Patel Dilipbhai Somabhai,MAHESANA,Hindustan Janta Party,0,8th Pass,4321000,0,4321000
4097,6603,Patel Govindbhai Ranchhodbhai,VALSAD,AAP,1,Post Graduate,533572,300000,233572
4098,7901,Patel Hemantbhai Keshavbhai,DADRA & NAGAR HAVELI,BSP,0,12th Pass,145206,0,145206
4099,314,Patel Hidayat Ulla Barkat Ulla,AKOLA,INC,1,12th Pass,12476287,202500,12273787
4100,4559,Patel Himmatsingh Prahladsingh,AHMEDABAD EAST,INC,1,8th Pass,38489984,1708500,36781484
4101,6549,Patel Ishavarbhai Sakaraji,SABARKANTHA,IND,0,12th Pass,793300,0,793300
4102,7286,Patel Jayeshbhai Arvindbhai,ANAND,IND,0,Graduate,16030246,22000,16008246
4103,5354,Patel Jayshreeben Kanubhai,MAHESANA,BJP,0,10th Pass,13278493,1814057,11464436
4104,4891,Patel Jivabhai Ambalal,MAHESANA,INC,0,10th Pass,229480000,26829000,202651000
4105,4569,Patel Joitabhai Kasanabhai,BANASKANTHA,INC,0,8th Pass,23987116,356250,23630866
4106,6083,Patel Ketanbhai Dahayabhai,DAMAN & DIU,INC,1,Others,131833259,10442779,121390480
4107,5327,Patel Kiritbhai Ishvarbhai,GANDHINAGAR,INC,1,Graduate,35674384,3130000,32544384
4108,6084,Patel Lalubhai Babubhai,DAMAN & DIU,BJP,1,8th Pass,144931238,1234039,143697199
4109,4896,Patel Mehool Kumar Thakorbhai,NAVSARI,AAP,0,Graduate,19178744,2077958,17100786
4110,5319,Patel Mohanbhai Budhabhai,SURAT,AAP,0,12th Pass,8032681,0,8032681
4111,7285,Patel Naineshkumar Umedbhai,ANAND,IND,1,12th Pass,5346000,0,5346000
4112,6612,Patel Pankajbhai Ravjibhai,PANCHMAHAL,IND,0,Graduate,686286,0,686286
4113,5324,Patel Piyushkumar Dashrathlal,GANDHINAGAR,National Youth Party,0,12th Pass,206000,0,206000
4114,919,Patel Praful Manoharbhai,BHANDARA-GONDIYA,NCP,0,Graduate,1959685779,40000000,1919685779
4115,6564,Patel Purushottambhai Ambalal,SABARKANTHA,IND,0,10th Pass,3990000,125000,3865000
4116,4906,Patel Shaileshbhai Gandabhai,VALSAD,JD(U),0,8th Pass,1875886,0,1875886
4117,2798,Patel Shri Dhar Chandrakar,MAHASAMUND,Apna Dal,1,Post Graduate,24903805,1378101,23525704
4118,4893,Patel Vandanaben Dineshbhai,MAHESANA,AAP,0,12th Pass,11846813,200000,11646813
4119,4616,Pathan Abdulrazak Badshahkhan,KHEDA,Apna Desh Party,0,5th Pass,40000,0,40000
4120,4614,Pathan Amanullakha Sitabkha,KHEDA,IND,0,10th Pass,97000,0,97000
4121,5976,Pathan Ayub Maddekhan,NASHIK,IUML,0,Graduate Professional,2842358,84885,2757473
4122,3318,Pathan Jafar Ali Kha Md. Ali Kha,NANDED,IND,0,12th Pass,3642000,0,3642000
4123,6589,Pathan Mahemudkhan Razakkhan,VADODARA,Apna Desh Party,0,5th Pass,30000,0,30000
4124,6588,Pathan Sahebkhan Asifkhan,VADODARA,SP,0,12th Pass,2860000,0,2860000
4125,5966,Pathan Sakhawatkha Yasinkha,NASHIK,Bahujan Mukti Party,0,Graduate,3610000,325000,3285000
4126,7600,Pathmanaban.K,TIRUNELVELI,IND,0,Graduate,44381,0,44381
4127,5833,Patil Ashok Tapiram,JALGAON,BJP,0,Graduate,226180395,0,226180395
4128,3542,Patil Bajrang Krishna,KOLHAPUR,IND,0,10th Pass,352142,0,352142
4129,5358,Patil Chandrakant Raghunath,NAVSARI,BJP,7,10th Pass,744761133,405888122,338873011
4130,5955,Patil Dinkar Dharma,NASHIK,BSP,8,8th Pass,65166950,288076,64878874
4131,5179,Patil Madhukar Vitthal,BHIWANDI,CPI,0,5th Pass,3897131,70000,3827131
4132,3605,Patil Manohar Anandrao,OSMANABAD,IND,0,12th Pass,215000,0,215000
4133,5173,Patil Nitin Suresh,AURANGABAD,INC,7,Graduate,150699930,13163583,137536347
4134,3606,Patil Padmasinha Bajirao,OSMANABAD,NCP,6,Graduate Professional,131918437,10174735,121743702
4135,5870,Patil Pramod Ratan,KALYAN,MNS,0,10th Pass,85592187,27664328,57927859
4136,3656,Patil Pratik Prakashbapu,SANGLI,INC,0,10th Pass,52543606,8891772,43651834
4137,3505,Patil S R Tatya,HATKANANGLE,IND,0,Graduate Professional,3500000,200000,3300000
4138,5846,Patil Sandeep Yuvraj,JALGAON,IND,0,12th Pass,0,0,0
4139,5840,Patil Sangram Gokulsingh,JALGAON,AAP,0,Post Graduate,17098312,3818000,13280312
4140,5839,Patil Suresh Padurang,JALGAON,Hindustan Janta Party,0,10th Pass,50000,0,50000
4141,1506,Patil Upendra Babarao,YAVATMAL-WASHIM,IND,0,Graduate Professional,3675000,315000,3360000
4142,5180,Patil Vishwanath Ramchandra,BHIWANDI,INC,2,10th Pass,25593787,1311000,24282787
4143,1459,Patle Anjali Agastikumar,BHANDARA-GONDIYA,Bharipa Bhahujan Mahasangha,0,Post Graduate,1679100,2425000,0
4144,6393,Patolla Kartik Reddy,CHEVELLA,INC,0,Graduate Professional,37137244,0,37137244
4145,7072,Pattabirama.C,KRISHNAGIRI,IND,0,12th Pass,3993522,0,3993522
4146,1780,Paul Dexion Khariya,ALIPURDUARS,IND,0,Graduate,406000,0,406000
4147,6891,Paul Kanagaraj. R.C,CHENNAI NORTH,IND,0,Graduate Professional,58886378,9840813,49045565
4148,119,Paul Lyngdoh,SHILLONG,UDP,0,Post Graduate,17371929,0,17371929
4149,6336,Pauldurai V K,DINDIGUL,IND,0,12th Pass,1540000,0,1540000
4150,6874,Paulraj .T,CHENNAI NORTH,Makkal Manadu Katchi,0,Graduate,189000,0,189000
4151,7023,Paulraj C.M.,KANNIYAKUMARI,CPI(ML) Red Star,0,Graduate Professional,1900000,25000,1875000
4152,4640,Paulus Kujur,RAIGARH,Bahujan Mukti Party,0,10th Pass,3956000,0,3956000
4153,6354,Pavithravalli H,ERODE,DMK,0,Post Graduate,37629685,3680000,33949685
4154,7735,Pawan Kumar,HOSHIARPUR,IND,0,10th Pass,91000,0,91000
4155,6765,Pawan Kumar,JHANJHARPUR,IND,0,Graduate,5165500,0,5165500
4156,30,Pawan Kumar Bansal,CHANDIGARH,INC,0,Graduate Professional,77478000,0,77478000
4157,895,Pawan Kumar Sharma,CHANDIGARH,IND,0,12th Pass,9196223,720000,8476223
4158,7701,Pawan Kumar Tinu,JALANDHAR,SAD,0,Graduate,28285754,1498000,26787754
4159,4712,Pawan Mahato,DHANBAD,IND,1,12th Pass,10512603,1597,10511006
4160,2373,Pawan Singh Shekhawat,JAIPUR,IND,1,10th Pass,418893,154152,264741
4161,3301,Pawar (Patil) Digambar Bapuji,NANDED,BJP,0,12th Pass,43054709,1538191,41516518
4162,7677,Pawar Krishna,ADILABAD,IND,1,Post Graduate,0,0,0
4163,5962,Pawar Pradeepchandra Narayan,NASHIK,MNS,12,Others,335123791,38008797,297114994
4164,3407,Pawar Vijay Banderao,SHIRDI,The Lok Party of India,0,10th Pass,110000,0,110000
4165,3700,Pawar Yuvraj Sidram,SOLAPUR,IND,0,Graduate,45000,0,45000
4166,7946,"Payam Chandhar Rao (Chinna Chandhranna)	",MAHABUBABAD,IND,1,Literate,80000,0,80000
4167,6958,"Pazhanivel, P",CHIDAMBARAM,IND,0,Others,798500,0,798500
4168,1961,Peelipose,PATHANAMTHITTA,IND,0,8th Pass,100205,0,100205
4169,7879,Peesari Satish Reddy,MALKAJGIRI,IND,0,Post Graduate,443200,0,443200
4170,4989,Peetam Singh,FATEHPUR SIKRI,Rashtriya Kranti Party,0,12th Pass,495000,0,495000
4171,2917,Peeyush Soni,BHOPAL,IND,0,12th Pass,639500,550,638950
4172,6010,Pejush Kumar Sahana,BARDHAMAN PURBA,CPI(ML)L,0,10th Pass,1654,0,1654
4173,7639,Percy Munshi,NAVSARI,IND,0,Graduate,10095000,0,10095000
4174,7176,Periyasamy .P,RAMANATHAPURAM,IND,0,Graduate,1225000,0,1225000
4175,884,Perseen Singh,JAMMU,IND,0,12th Pass,205959,0,205959
4176,3942,Perumal.A,NAMAKKAL,IND,0,12th Pass,4196631,390477,3806154
4177,7661,Peter Masih,GURDASPUR,SARVAJAN SAMAJ PARTY (D),0,12th Pass,1764000,0,1764000
4178,3487,Petras Kisan Gaware,AHMEDNAGAR,IND,2,Illiterate,366073,20000,346073
4179,644,Phaljit Mahto,KODARMA,IND,0,Illiterate,995000,15000,980000
4180,4856,Phani Bhusan Choudhury,BARPETA,AGP,0,Graduate,9374499,67240,9307259
4181,7214,Phiroze Palkhivala,MUMBAI NORTH CENTRAL,AAP,0,Graduate Professional,34762841,0,34762841
4182,411,Phool Chand,AMBALA,IND,0,8th Pass,3750000,0,3750000
4183,1574,Phool Singh Dhurwey,MANDLA,Chhattisgarh Swabhiman Manch,3,Graduate,2820609,20000,2800609
4184,1624,Phool Singh Pal,MUZAFFARNAGAR,IND,0,12th Pass,17502382,0,17502382
4185,747,Phool Singh Paraste,SHAHDOL,BSP,2,Post Graduate,5694356,120000,5574356
4186,4242,Phoolsingh,KARAULI-DHOLPUR,Jago Party,0,8th Pass,1268000,0,1268000
4187,2896,Phoolsingh Baraiya,BHIND,Bahujan Sangharshh Dal,0,Graduate Professional,21329109,4815877,16513232
4188,429,Phul Singh,HISAR,CPI(M),0,Graduate,14551828,1022496,13529332
4189,5174,Phulare Suresh Asaram,AURANGABAD,IND,0,12th Pass,497750,0,497750
4190,4660,Phuleshwar Prasad Surajhiha,KORBA,IND,0,Not Given,25000,0,25000
4191,2528,Phusey Ghanshyam Ramaji,NAGPUR,RPI,0,Graduate,4987645,577000,4410645
4192,1770,Pijush Barman,COOCHBEHAR,Welfare Party Of India,0,Post Graduate,1670000,0,1670000
4193,3715,Pinaki Mishra,PURI,BJD,0,Graduate Professional,1370991203,19975839,1351015364
4194,5210,Pinjari Jainuddin Husain,DHULE,IND,0,10th Pass,1092000,225000,867000
4195,6754,Pinki Devi,BEGUSARAI,Bahujan Mukti Party,2,12th Pass,3638500,0,3638500
4196,2244,Pintu Malakar,KARIMGANJ,IND,0,12th Pass,440000,0,440000
4197,704,Piravathoor Sreedharan,MAVELIKKARA,IND,0,Post Graduate,829000,0,829000
4198,4995,Pitam Singh,FATEHPUR SIKRI,JD(U),0,Illiterate,320000,0,320000
4199,5366,Piyushkumar Dilipbhai Parmar,PANCHMAHAL,AAP,0,Post Graduate,15000,0,15000
4200,728,Pjech Debbarma,TRIPURA WEST,IND,0,10th Pass,15085500,10373,15075127
4201,3576,Pol Sudhir Arjun,MADHA,IND,0,12th Pass,25000,0,25000
4202,7881,Polisetty Krishna Rao,MALKAJGIRI,IND,0,Graduate,26410000,6300000,20110000
4203,6970,Pon Chandran.,COIMBATORE,AAP,1,Post Graduate,6278508,0,6278508
4204,7506,Pon. Muthuramalingam,THENI,DMK,0,Graduate Professional,24443618,0,24443618
4205,6944,Pon. Siva Kumar,CHENNAI SOUTH,IND,0,Graduate,810500,470000,340500
4206,6233,Ponaka Sammakka,MAHABUBABAD,IND,0,Graduate,6000,0,6000
4207,7136,Pongalur Palanisamy.N,POLLACHI,DMK,3,Graduate,406806230,0,406806230
4208,4529,Ponguleti Srinivasa Reddy,KHAMMAM,Yuvajana Sramika Rythu Congress Party,0,12th Pass,346150516,1240000,344910516
4209,5669,Ponmudi.P,NAMAKKAL,IND,0,Others,488500,0,488500
4210,6227,Ponnam Prabhakar,KARIMNAGAR,INC,1,Post Graduate,3806747,0,3806747
4211,7110,"Ponnusamy, P.",NILGIRIS,CPI(ML) Red Star,1,Illiterate,0,0,0
4212,6894,Ponraj. P,CHENNAI NORTH,IND,0,5th Pass,1039000,0,1039000
4213,425,Poonam Chand,SIRSA,AAP,0,12th Pass,3825442,0,3825442
4214,5902,Poonam Mahajan Alias Poonam Vajendla Rao,MUMBAI NORTH CENTRAL,BJP,0,Others,1080867626,414479088,666388538
4215,7572,Poongani.J.,TENKASI,Samata Party,0,10th Pass,4974010,1300000,3674010
4216,3399,Popat Manik Fule,AHMEDNAGAR,Maharashtra Parivartan Sena (T),0,5th Pass,500,0,500
4217,2480,Popat Ram,BARMER,IND,0,5th Pass,180000,0,180000
4218,5332,Popatputra Rafik Abubakar,JAMNAGAR,IND,0,8th Pass,28000,0,28000
4219,7880,Potturi Tulasi Das,MALKAJGIRI,IND,0,5th Pass,670340,0,670340
4220,3862,Pournima Vilas Korpale,SANGLI,IND,0,Post Graduate,60000,0,60000
4221,3961,Pr Senthilnathan,SIVAGANGA,AIADMK,0,Graduate Professional,49050835,7459581,41591254
4222,5446,Prabakaran L,TIRUVANNAMALAI,IND,0,10th Pass,535000,0,535000
4223,7586,Prabakaran.K.R.P,TIRUNELVELI,AIADMK,0,Graduate Professional,2764500,0,2764500
4224,6630,Prabhakar Prasad,BANDA,Bharatiya Kisan Sena Party,0,Graduate,351027,0,351027
4225,7191,Prabhakaran G. Titus,MUMBAI NORTH,Peoples Party of India(secular),0,10th Pass,43500,3500,40000
4226,6893,Prabhakaran. K,CHENNAI NORTH,IND,0,Post Graduate,42000,52000,0
4227,789,Prabhas Kumar Singh,BARGARH,BJD,0,Doctorate,5786971,670000,5116971
4228,5826,Prabhat Chindhu Sonawane,DINDORI,Bharipa Bahujan Mahasangh,0,Post Graduate,1280000,55000,1225000
4229,826,Prabhat Kumar Mahanty,ASKA,AAP,1,Graduate,989407,0,989407
4230,6170,Prabhat Ranjan Das,DARBHANGA,AAP,0,Doctorate,364642463,0,364642463
4231,3924,Prabhawati Shakya Khot,BHOPAL,IND,0,12th Pass,100000,0,100000
4232,612,Prabhu,BANGALORE SOUTH,IND,0,Literate,90000,0,90000
4233,2129,Prabhu,BIDAR,IND,0,10th Pass,2200000,0,2200000
4234,2438,Prabhu Lal Gujjar,CHITTORGARH,Jai Maha Bharath Party,0,8th Pass,615000,100000,515000
4235,6966,"Prabhu, R.",COIMBATORE,INC,0,Post Graduate,609497080,112606039,496891041
4236,7147,Prabhu. J,POLLACHI,IND,0,12th Pass,145000,0,145000
4237,3234,Prabhudan Marandi,MAYURBHANJ,Aama Odisha Party,0,Graduate Professional,2683854,0,2683854
4238,2451,Prabhulal Meena,UDAIPUR,Bahujan Mukti Party,0,8th Pass,595000,50000,545000
4239,1535,Prabhunath Prasad Saket,REWA,IND,0,Doctorate,316246,0,316246
4240,2499,Prabiddha Reang,TRIPURA EAST,IND,0,10th Pass,402519,0,402519
4241,6027,Prabir Mukhopadhyay,BIRBHUM,BSP,0,10th Pass,250000,0,250000
4242,7126,"Prabu, S.",PERAMBALUR,IND,0,10th Pass,1850000,0,1850000
4243,771,Pradeep,HOSHANGABAD,BSP,0,10th Pass,10082,0,10082
4244,1898,Pradeep,PALAKKAD,IND,0,10th Pass,131500,0,131500
4245,1800,Pradeep Kumar,ALIGARH,Bahujan Mukti Party,0,Graduate Professional,41900,0,41900
4246,5040,Pradeep Kumar,KANNAUJ,IND,0,10th Pass,1170000,0,1170000
4247,5551,Pradeep Kumar Jain,JHANSI,INC,2,Post Graduate,14253928,1318412,12935516
4248,1727,Pradeep Kumar Jatav,BULANDSHAHR,BSP,1,12th Pass,25731324,557571,25173753
4249,37,Pradeep Kumar Joshi,KARAKAT,Rashtra Sewa Dal,21,12th Pass,11721162,11908841,0
4250,1208,Pradeep Kumar M,CHAMARAJANAGAR,Karunaadu Party,0,12th Pass,45000,0,45000
4251,116,Pradeep Kumar Majhi,NABARANGPUR,INC,0,Graduate,6978000,36000,6942000
4252,2653,Pradeep Kumar Prasad,BUXAR,Pragatisheel Manav Samaj Party,0,10th Pass,1994000,0,1994000
4253,3967,Pradeep Kumar Singh,ARARIA,BJP,4,10th Pass,4291479,802182,3489297
4254,6758,Pradeep Paswan,DARBHANGA,IND,1,12th Pass,392707,0,392707
4255,1331,Pradeep Varma,NEW DELHI,Bharat Vishal Party,0,Graduate Professional,4200000,500000,3700000
4256,7527,"Pradeepkumar, D",VIRUDHUNAGAR,Lok Satta Party,0,Post Graduate,7264000,0,7264000
4257,1006,Pradesh Kumar,NORTH EAST DELHI,Ambedkar National Congress,0,Post Graduate,257000,0,257000
4258,4437,Pradip Kalita,GAUHATI,IND,0,12th Pass,3600000,0,3600000
4259,3316,Pradip Kumar Mallick,JAGATSINGHPUR,BSP,0,Post Graduate,1760000,0,1760000
4260,6040,Pradip Saha,HOOGHLY,CPI(M),0,10th Pass,980403,35000,945403
4261,2465,Pradip Singh Bhatnagar,RAJSAMAND,AAP,0,Post Graduate,12368765,520000,11848765
4262,2253,Pradip Suklabaidya,KARIMGANJ,IND,0,8th Pass,299847,0,299847
4263,4736,Pradip Yadav,GODDA,JVM(P),7,Graduate,10128031,38800,10089231
4264,813,Pradipta Kumar Naik,KALAHANDI,BJP,0,Graduate Professional,42970197,0,42970197
4265,3269,Pradyumna Kumar Naik,DHENKANAL,Bahujan Mukti Party,0,Graduate Professional,1427000,0,1427000
4266,3577,Prafull Shivrao Kadam,MADHA,IND,0,Post Graduate,4595131,347241,4247890
4267,2694,Pragati Mehta,MUNGER,RJD,0,Graduate,6422050,0,6422050
4268,2921,Prahlad Singh Patel,DAMOH,BJP,0,Graduate Professional,39586235,12429302,27156933
4269,2928,Prahlad Singh Patel-Mukundilal,DAMOH,IND,0,Illiterate,176000,0,176000
4270,2929,Prahlad-Gabdu,DAMOH,IND,0,Illiterate,857000,0,857000
4271,6509,Prajapati Chhaganbhai Naranbhai,PATAN,IND,0,10th Pass,2237121,0,2237121
4272,4590,Prajapati Raj Chandrakantbhai,GANDHINAGAR,IND,0,12th Pass,263000,0,263000
4273,5353,Prajapati Vitthalbhai Virdas,MAHESANA,IND,0,10th Pass,5306239,0,5306239
4274,4080,Prajesh Choudhary,GWALIOR,IND,0,8th Pass,1057799,0,1057799
4275,5696,Prakasam R,SALEM,IND,0,12th Pass,2971359,0,2971359
4276,5911,Prakash Gangaram Reddy,MUMBAI SOUTH,CPI,1,Graduate Professional,23829258,280159,23549099
4277,1170,Prakash Hikaka,KORAPUT,CPI(ML) Red star,0,Literate,2500,0,2500
4278,1815,Prakash Hukkeri,CHIKKODI,INC,0,12th Pass,75717628,3635650,72081978
4279,4641,Prakash Kumar Uranw,RAIGARH,IND,0,8th Pass,835800,0,835800
4280,2912,Prakash Mangilal Sharma,BHOPAL,INC,5,Graduate Professional,27818657,1799934,26018723
4281,586,Prakash Minj,ANDAMAN & NICOBAR ISLANDS,IND,0,Post Graduate,308000,0,308000
4282,1502,Prakash Raghunath Raut,YAVATMAL-WASHIM,IND,0,10th Pass,250000,0,250000
4283,565,Prakash Rathod,BIJAPUR,INC,3,Post Graduate,113403666,27599682,85803984
4284,7225,Prakash Sadashiv Pancharas,MUMBAI NORTH EAST,Maharashtra Parivartan Sena (T),0,5th Pass,235490,0,235490
4285,5877,Prakash Shamrao Telgote,KALYAN,IND,0,10th Pass,612819,0,612819
4286,4503,Prakash Surya,BILASPUR,IND,0,10th Pass,3093472,389952,2703520
4287,7902,Prakash Vansha Khanvelkar,DADRA & NAGAR HAVELI,IND,1,10th Pass,1144221,31200,1113021
4288,7055,"Prakash, N.",KARUR,IND,0,Graduate Professional,175000,0,175000
4289,1075,Pralhad Joshi,DHARWAD,BJP,1,Graduate,41979658,6739989,35239669
4290,3347,Pramila Behera,BHUBANESWAR,CPI(ML) Red star,0,Graduate,166297,0,166297
4291,2396,Pramod Kumar,JHALAWAR-BARAN,INC,0,12th Pass,290302756,92884227,197418529
4292,2705,Pramod Kumar,MUNGER,SUCI(C),0,Post Graduate,1741914,0,1741914
4293,3284,Pramod Kumar Mallick,CUTTACK,BSP,0,Graduate,136000,0,136000
4294,2724,Pramod Kumar Nirala,NALANDA,Sankhyanupati Bhagidari Party,0,Graduate,7929000,67000,7862000
4295,3052,Pramod Kumar Yadav,AONLA,Bhartiya Krishak Dal,0,Post Graduate,477000,0,477000
4296,5790,Pramod Kureel,RAE BARELI,IND,0,Post Graduate,4550140,125000,4425140
4297,1494,Pramod Mangaruji Sorte,CHANDRAPUR,IND,0,12th Pass,566100,0,566100
4298,3343,Pramod Maroti Panditkar,PARBHANI,IND,0,Graduate,180000,0,180000
4299,3750,Pramod Mutalik,BANGALORE SOUTH,IND,8,Graduate,268756,0,268756
4300,2193,Pramod Mutalik.,DHARWAD,IND,8,Graduate,268756,0,268756
4301,4497,Pramod Narayan Poddar,PURNIA,Bhartiya Jantantrik Janata Dal,1,Graduate,8642000,750000,7892000
4302,3291,Pramod Sahu,KENDRAPARA,IND,0,Graduate Professional,1263856,0,1263856
4303,1533,Pramod Tiwari,REWA,Bhartiya Shakti Chetna Party,0,Graduate,35000,0,35000
4304,3346,Prana Krushna Dalabehera,BHUBANESWAR,Samruddha Odisha,0,Graduate Professional,2790039,255034,2535005
4305,642,Pranav Kumar Verma,KODARMA,JVM(P),0,Post Graduate,1386131,0,1386131
4306,4880,Pranjal Bordoloy,GAUHATI,AAP,0,Graduate,8726568,7111191,1615377
4307,795,Prasadi Pradhan,SAMBALPUR,SUCI(C),0,8th Pass,485502,36800,448702
4308,7929,Prasanna Kumar,MADHEPURA,IND,0,Post Graduate,9574085,0,9574085
4309,3710,"Prasanna Kumar Patasani,",BHUBANESWAR,BJD,0,Post Graduate,13557443,9590067,3967376
4310,6789,Prasanta Bag,BARDHAMAN PURBA,Jharkhand Disom Party,0,Literate,1000,0,1000
4311,3236,Prasanta Kumar Mishra,BALASORE,CPI,1,Graduate Professional,2357346,8000,2349346
4312,6023,Prasanta Kumar Roy,BIRBHUM,SP,0,Graduate,11677050,3451812,8225238
4313,59,Prashant Chaudhary,BAGHPAT,BSP,0,Post Graduate,258289957,3950000,254339957
4314,7226,Prashant Dnyaneshwar Gangawane,MUMBAI NORTH EAST,Prabuddha Republican Party,3,Post Graduate,60067552,572151,59495401
4315,7197,Prashant Narsinh Kharatmal,MUMBAI NORTH,IND,0,10th Pass,3235000,2990000,245000
4316,1503,Prashant Pandharinath Surve,YAVATMAL-WASHIM,IND,0,Post Graduate,26770200,4600000,22170200
4317,918,Prashant Shyamsundar Mishra,BHANDARA-GONDIYA,AAP,0,Post Graduate,41306880,559171,40747709
4318,3662,Prashant Vasant Chavan,SATARA,BSP,0,Graduate,1930279,793050,1137229
4319,3880,Prashant Vishnu Sasane,BEED,IND,0,Graduate,0,0,0
4320,1198,Prashanth.S.M,BANGALORE CENTRAL,IND,0,Post Graduate,210000,0,210000
4321,2682,Prashuram Bind,JAHANABAD,Bahujan Mukti Party,0,Graduate,2636206,0,2636206
4322,2662,Prashuram Prasad,BUXAR,Bahujan Mukti Party,1,12th Pass,460000,0,460000
4323,1177,Praska Renga,KORAPUT,BSP,0,8th Pass,352000,0,352000
4324,6048,Prasun Banerjee,HOWRAH,AITC,0,Graduate,10041098,0,10041098
4325,4127,Pratap Bhanu,KORBA,IND,0,12th Pass,3330217,300000,3030217
4326,3242,Pratap Chandra Sarangi,BALASORE,BJP,10,Graduate,1018629,160,1018469
4327,939,Pratap Goswami,RAMTEK,AAP,0,Graduate,23772549,2075378,21697171
4328,2349,Pratap Singh,SIKAR,IND,0,8th Pass,3003000,0,3003000
4329,2319,Pratap Singh,CHURU,INC,0,Post Graduate,12282074,1241053,11041021
4330,2339,Pratap Singh Jat,SIKAR,INC,0,Graduate Professional,22669772,1123169,21546603
4331,838,Prataprao Alagouda Patil,CHIKKODI,NCP,1,Post Graduate,19483000,37260000,0
4332,271,Prathap Kumar. N. P,KOZHIKODE,IND,0,Graduate Professional,4356708,100000,4256708
4333,1216,Prathap Simha,MYSORE,BJP,0,Post Graduate,6321591,4399048,1922543
4334,7245,Pratik Prabhakar Toraskar,MUMBAI NORTH WEST,IND,0,Graduate,45000,0,45000
4335,2273,Pratima Engheepi,AUTONOMOUS DISTRICT,CPI(ML)L,0,Graduate,469165,365000,104165
4336,1950,Praveen K Mohan,KOTTAYAM,IND,3,10th Pass,512500,0,512500
4337,2338,Praveen Kumar,JHUNJHUNU,IND,0,Post Graduate,10556850,1355300,9201550
4338,1365,Praveen Kumar,EAST DELHI,Bhartiya Jan Manch,0,8th Pass,155178,1700,153478
4339,4770,Praveen Kumar Ajmera Jain,INDORE,IND,0,Post Graduate,624098,0,624098
4340,6757,Praveen Kumar Jha,DARBHANGA,IND,0,Post Graduate,11558930,0,11558930
4341,618,Praveen M S,MYSORE,IND,0,Post Graduate,198500,0,198500
4342,3087,Praveen Singh Aron,BAREILLY,INC,1,Graduate Professional,274576248,383067,274193181
4343,6659,Pravesh Kumar Vyas,HAMIRPUR,IND,0,Graduate,280094,0,280094
4344,5785,Pravesh Singh,RAE BARELI,BSP,2,Graduate,18166310,150000,18016310
4345,7240,Pravin Chandrakant Kaurpuriya,MUMBAI NORTH WEST,Hindustan Swaraj Congress Party,0,Graduate Professional,409823,0,409823
4346,5411,Pravin Jain,RAIPUR,IND,0,10th Pass,54840493,1350000,53490493
4347,4584,Pravinbhai Jinabhai Rathod,BHAVNAGAR,INC,0,10th Pass,2888968,2475000,413968
4348,6533,Pravinchandra Chunilal Parekh,RAJKOT,IND,0,Graduate Professional,42890000,0,42890000
4349,2838,Prayag Prasad,HAZARIBAGH,IND,0,Literate,4063000,150000,3913000
4350,652,Prechard B. M. Basaiawmoit,SHILLONG,IND,0,12th Pass,39194012,0,39194012
4351,5528,Preetam Singh,HAMIRPUR,INC,0,Post Graduate,24162000,7457000,16705000
4352,2803,Preeti Dhruw,MAHASAMUND,GGP,0,Others,150000,0,150000
4353,5091,Prem Chand Dhamani,BHARATPUR,IND,0,10th Pass,7740000,180000,7560000
4354,6685,Prem Chandra Pandey,KANPUR,IND,0,12th Pass,1330000,0,1330000
4355,4280,Prem Chanra,ETAWAH,Kisan Majdoor Berojgar Sangh,0,12th Pass,557000,0,557000
4356,4962,Prem Das,ETAWAH,SP,1,Graduate,10427522,0,10427522
4357,2490,Prem Das Rai,SIKKIM,SDF,0,Post Graduate,32389223,0,32389223
4358,4706,Prem Prakash Paswan,DHANBAD,IND,0,12th Pass,248371,0,248371
4359,4918,Prem Singh,AGRA,Bahujan Mukti Party,0,10th Pass,20815800,0,20815800
4360,1354,Prem Singh,EAST DELHI,Socialist Party (India),0,Doctorate,13650000,200000,13450000
4361,6110,Prem Singh Chandumajra,ANANDPUR SAHIB,SAD,0,Post Graduate,141599902,2248200,139351702
4362,338,Premachandran,KOLLAM,IND,0,10th Pass,71500,0,71500
4363,2488,Premachandran,KOLLAM,IND,1,10th Pass,2605267,0,2605267
4364,963,Premakumari,ALATHUR,BSP,1,Others,32000,158000,0
4365,3264,Premananda Sahoo,DHENKANAL,BSP,0,Post Graduate,1650041,55253,1594788
4366,4812,Premchand Guddu,UJJAIN,INC,3,10th Pass,535213275,2221000,532992275
4367,4122,Premchand Jayasi,JANJGIR-CHAMPA,INC,0,Post Graduate,4422744,553873,3868871
4368,5398,Premshankar Mahilange,JANJGIR-CHAMPA,IND,0,12th Pass,1197500,0,1197500
4369,7848,Preneet Kaur,PATIALA,INC,0,Graduate,863564071,4207846,859356225
4370,3517,Principal Dr.Vithal Namdeorao Kadam,HINGOLI,AAP,0,Doctorate,9525025,926227,8598798
4371,6796,Pritam Ghosh,HOOGHLY,INC,1,12th Pass,56970260,0,56970260
4372,3351,Prithiviraj Harichandan,BHUBANESWAR,BJP,1,Post Graduate,10162181,5087000,5075181
4373,3270,Priyabrata Garnaik,DHENKANAL,Samata Kranti Dal,0,Graduate,1191000,350000,841000
4374,5494,Priyanka Singh Rawat,BARABANKI,BJP,0,Post Graduate,13175500,1450000,11725500
4375,4798,Pro. Purushottam Meghwal,MANDSOUR,IND,1,Post Graduate,6150367,2307000,3843367
4376,4472,Pro. Yogendra Mahto,BHAGALPUR,AAP,0,Doctorate,3087000,112000,2975000
4377,2239,Probash Chandra Sarkar,KARIMGANJ,SUCI(C),0,10th Pass,30000,0,30000
4378,141,Prodip Hazarika,JORHAT,AGP,0,Post Graduate,6989852,650000,6339852
4379,7223,Prof. Avinash Dolas,MUMBAI NORTH EAST,Bharipa Bahujan Mahasangh,0,Post Graduate,21912532,0,21912532
4380,7937,Prof. Azmeera Seetaram Naik,MAHABUBABAD,TRS,0,Doctorate,8008000,4100000,3908000
4381,2781,Prof. Bhim Singh,UDHAMPUR,JKNPP,0,Post Graduate,3895677,1410000,2485677
4382,5828,Prof. Dnyaneshwar Damu Mali,DINDORI,AAP,0,Post Graduate,14670,0,14670
4383,1423,Prof. Dr. Natthu Madhao Lokhande,RAMTEK,IND,0,Doctorate,5276500,0,5276500
4384,4542,Prof. K.Nageshwar,MALKAJGIRI,IND,0,Doctorate,17997551,3746000,14251551
4385,6133,Prof. Sadhu Singh,FARIDKOT,AAP,0,Post Graduate,5879516,70000,5809516
4386,6234,Professor Gulam Gaus,MADHUBANI,JD(U),1,Post Graduate,10324645,403333,9921312
4387,2844,Promod Kumar Mahatha,HAZARIBAGH,Pragatisheel Magahi Samaj,0,12th Pass,3030000,653525,2376475
4388,4767,Pt. Jagdish Chandra Bhatt,INDORE,Jai Maha Bharath Party,0,Graduate,5757342,0,5757342
4389,7386,"Pugazhendi, A. Thiru",SRIPERUMBUDUR,IND,0,Graduate Professional,797000,0,797000
4390,7376,Pulavar. E.Su. Mani. Thiru,SRIPERUMBUDUR,National Organisation Congress,0,Graduate,735000,0,735000
4391,6226,Pulikota Ramesh,KARIMNAGAR,IND,0,8th Pass,150000,0,150000
4392,4720,Pulis Hembrom,DUMKA,IND,0,Literate,1227400,0,1227400
4393,6836,Pullaiahgari Prbhu Goud,MEDAK,Yuvajana Sramika Rythu Congress Party,0,10th Pass,5489000,800000,4689000
4394,7652,Punjabhai Bhimabhai Vansh,JUNAGADH,INC,1,12th Pass,18336717,2067932,16268785
4395,93,Puran Mal,BHIWANI-MAHENDRAGARH,IND,0,10th Pass,4158000,290000,3868000
4396,2033,Puran Singh Panwar,KARNAL,Rashtravadi Janata Party,0,Graduate Professional,3621304,296000,3325304
4397,737,Purnanand Tiwari,REWA,AAP,0,Post Graduate,1533286,0,1533286
4398,650,Purno Agitok Sangma,TURA,NPP,0,Post Graduate,215134618,0,215134618
4399,1274,Purshotam,FARIDABAD,AAP,0,10th Pass,27376208,1193221,26182987
4400,4565,Pursottambhai Mathurbhai Chauhan,ANAND,BSP,0,Graduate Professional,7356493,18000,7338493
4401,5252,Purushottam Choubey,BHAGALPUR,SP,2,10th Pass,1156393030,20310000,1136083030
4402,3671,Purushottam Jadhav,SATARA,IND,5,10th Pass,106966036,4653805,102312231
4403,5032,Pushpa Devi,KANNAUJ,Bhartiya Shakti Chetna Party,0,12th Pass,1976200,0,1976200
4404,5804,Pushpa Devi,SITAPUR,IND,0,8th Pass,2366581,400000,1966581
4405,1965,Pushpangathan,PATHANAMTHITTA,IND,0,10th Pass,92000,0,92000
4406,6960,"Pushparaj, S",CHIDAMBARAM,IND,0,8th Pass,1097000,0,1097000
4407,1547,Puspendra Singh,SIDHI,GGP,1,Graduate Professional,10453934,2020000,8433934
4408,4464,Putul Kumari,BANKA,BJP,2,Post Graduate,58028261,725973,57302288
4409,5592,Puvala Nageswara Rao,PONDICHERRY,IND,0,Literate,1400000,0,1400000
4410,1724,Pyare Lal,BULANDSHAHR,Bahujan Mukti Party,0,Graduate Professional,11325000,900000,10425000
4411,3210,Pyare Urf Rajkumar Gautam,SHAHJAHANPUR,VANCHITSAMAJ INSAAF PARTY,0,Not Given,65000,0,65000
4412,7636,Pyarelal Bharti,NAVSARI,Hindusthan Nirman Dal,0,10th Pass,21000,1000,20000
4413,1907,R Biju,ALATHUR,IND,0,10th Pass,1500,0,1500
4414,2512,R Chandrika Kattakada,THIRUVANANTHAPURAM,RPI,0,10th Pass,150000,0,150000
4415,3743,R Gayathri,BANGALORE SOUTH,Pyramid Party of India,0,Post Graduate,2973000,300000,2673000
4416,1278,R K Anand,FARIDABAD,INLD,0,Graduate Professional,149352852,15495731,133857121
4417,2328,R S Kadyan,JHUNJHUNU,AAP,0,Post Graduate,130227500,0,130227500
4418,3832,R Venkatesan,SALEM,RPI(A),0,5th Pass,175000,0,175000
4419,863,R. Dhruvanarayana,CHAMARAJANAGAR,INC,0,Graduate,31519950,2605818,28914132
4420,5480,R. K. Singh Patel,BANDA,BSP,2,Graduate,37792491,1733008,36059483
4421,6949,R. Kandasamy@Babu,CHENNAI SOUTH,Ambedkar Peoples Movement,0,8th Pass,351747,0,351747
4422,1194,R. Mohan Raju,BANGALORE CENTRAL,BSP,0,Post Graduate,6774000,460000,6314000
4423,1091,R. Prabhakara Reddy,BANGALORE RURAL,JD(S),0,Graduate,2243612066,2218003086,25608980
4424,5578,R. Radhakrishnan,PONDICHERRY,All India N.R. Congress,0,Post Graduate,77724418,7658530,70065888
4425,6920,R. Ravichandran,CHENNAI SOUTH,IND,0,5th Pass,660000,0,660000
4426,2163,R. Ravinayaka,BELLARY,JD(S),2,12th Pass,5286536,273603,5012933
4427,5588,R. Valavan,PONDICHERRY,IND,0,Others,942970,0,942970
4428,5568,R. Viswanathan,PONDICHERRY,CPI,0,10th Pass,27140629,6017909,21122720
4429,5472,R.Arumugam,VILUPPURAM,IND,0,Graduate,350000,200000,150000
4430,4304,R.Chakravarthi Raja Gopala Krishnan,TIRUPPUR,AAP,0,Post Graduate,325925000,0,325925000
4431,1534,R.D. Vishwkarma,REWA,Apna Dal,0,10th Pass,1575000,0,1575000
4432,3965,R.Gopalakrishnan,MADURAI,AIADMK,0,Graduate,72503060,7406366,65096694
4433,4305,R.Gopalsamy,TIRUPPUR,Lok Satta Party,0,Post Graduate,851533,191088,660445
4434,5770,R.K Chaudhary,MOHANLALGANJ,BSP,1,Graduate Professional,9309539,0,9309539
4435,5581,R.K.R. Anantharaman,PONDICHERRY,Pattali Makkal Katchi,3,Graduate Professional,24654438,18044310,6610128
4436,6366,R.Manimaran,KALLAKURICHI,DMK,0,Post Graduate,23653826,1121682,22532144
4437,7422,R.Murugesan,TIRUPPUR,Makkal Manadu Katchi,0,Literate,5000,0,5000
4438,7430,R.Nandhakumar,TIRUPPUR,IND,0,8th Pass,46600,0,46600
4439,3953,R.P.Marutharajaa,PERAMBALUR,AIADMK,0,Post Graduate,24570213,0,24570213
4440,6368,R.Pandiyan,KALLAKURICHI,IND,0,10th Pass,1671563,0,1671563
4441,7433,R.R.Murugan,TIRUPPUR,IND,0,Post Graduate,1158000,0,1158000
4442,3797,R.Ravindra Kumar,KOLAR,Bharatiya Dr. B.R.Ambedkar Janta Party,0,Graduate,10601000,8332000,2269000
4443,123,R.S.Uma Bharatthy,ANDAMAN & NICOBAR ISLANDS,NCP,0,Post Graduate,1380999,253000,1127999
4444,6296,R.Saraswathi,ARANI,IND,0,12th Pass,375000,15000,360000
4445,7424,R.Sathyabama,TIRUPPUR,IND,0,Post Graduate,97000,0,97000
4446,7425,R.Sathyabhama,TIRUPPUR,IND,0,8th Pass,1071000,90000,981000
4447,6285,R.Sivanandam,ARANI,DMK,10,10th Pass,130816910,64526381,66290529
4448,7016,Raajarathinum F.M.,KANNIYAKUMARI,DMK,0,Post Graduate,14280853,3400000,10880853
4449,6501,Rabari Babubhai Karshanbhai,PATAN,SP,1,5th Pass,445000,0,445000
4450,7287,Rabari Hiteshkumar Laljibhai,ANAND,IND,0,12th Pass,1140000,0,1140000
4451,7524,"Rabeek, K.",THENI,IND,0,Others,946200,35000,911200
4452,6806,Rabia Altaf,SRINAGAR,IND,0,Post Graduate,11498600,2625000,8873600
4453,3239,Rabindra Kumar Jena,BALASORE,BJD,0,Post Graduate,570139716,55893020,514246696
4454,3353,Rabindra Nath Behera,BHUBANESWAR,SP,0,Post Graduate,4697137,1714853,2982284
4455,2252,Rabindra Nath Choudhury,KARIMGANJ,AGP,0,Graduate Professional,15546810,0,15546810
4456,3028,Rabindra Roy Basunia,DARJEELING,IND,0,Post Graduate,3398828,230346,3168482
4457,2911,Rachna Dhingra,BHOPAL,AAP,3,Graduate Professional,7192772,0,7192772
4458,5552,Rachna Sharma,JHANSI,IND,0,Graduate,66000,0,66000
4459,6518,Radadiya Vithalbhai Hansrajbhai,PORBANDAR,BJP,10,Graduate,73003639,316000,72687639
4460,4681,Radha Bai Yadav,DURG,IND,0,Literate,1359207,0,1359207
4461,2427,Radha Devi,CHITTORGARH,CPI,0,Post Graduate,10625129,125000,10500129
4462,5750,Radha Krishnan,LUCKNOW,Uttar Pradesh Republican Party,0,Post Graduate,999973,0,999973
4463,7530,Radhakrishnan,VIRUDHUNAGAR,AIADMK,0,10th Pass,43736485,5273447,38463038
4464,7483,Radhakrishnan A,SIVAGANGA,IND,0,12th Pass,511000,335000,176000
4465,1933,Radhakrishnan P T,ERNAKULAM,IND,0,Graduate Professional,3488000,0,3488000
4466,7015,Radhakrishnan P.,KANNIYAKUMARI,BJP,0,Graduate Professional,40963269,0,40963269
4467,7025,Radhakrishnan T.,KANNIYAKUMARI,IND,0,8th Pass,1290710,80000,1210710
4468,6967,"Radhakrishnan, C.P.",COIMBATORE,BJP,0,Graduate,663198857,35999300,627199557
4469,6984,"Radhakrishnan, R.",COIMBATORE,IND,0,5th Pass,100000,0,100000
4470,6321,Radhakrishnan.K.R,CUDDALORE,IND,0,8th Pass,1645000,271000,1374000
4471,7580,Radhakrishnan.S.,TENKASI,IND,1,Graduate Professional,12814404,1000000,11814404
4472,4816,Radheshayam Panavar,UJJAIN,AIFB,0,10th Pass,5065700,0,5065700
4473,2240,Radheshyam Biswas,KARIMGANJ,AIUDF,0,12th Pass,7068281,0,7068281
4474,4795,Radheshyam Gehlot (Raju Malviya),MANDSOUR,Bahujan Mukti Party,0,Graduate,9536000,3500000,6036000
4475,4179,Radheshyam Malviya,DEWAS,IND,0,Literate,1365144,0,1365144
4476,2420,Radhy Shyam Vaishnav,BHILWARA,Bahujan Sangharshh Dal,0,10th Pass,35000,0,35000
4477,4101,Rafiqul Islam,NOWGONG,AIFB,0,8th Pass,390000,0,390000
4478,7445,Ragavan. R,TIRUCHIRAPPALLI,IND,2,12th Pass,1730000,150000,1580000
4479,685,Raghav Lakhanpal,SAHARANPUR,BJP,0,Post Graduate,35406431,0,35406431
4480,2195,Raghavendra Krishnarao Thane,UTTARA KANNADA,AAP,0,Post Graduate,4952691,5616664,0
4481,6418,Raghu Deshaboina,SECUNDERABAD,Bahujan Mukti Party,0,Doctorate,5756920,274890,5482030
4482,907,Raghubir Singh,ANDAMAN & NICOBAR ISLANDS,SP,1,8th Pass,1128697,20000,1108697
4483,643,Raghunandan Prasad Vishwakarma,KODARMA,AIFB,0,10th Pass,4822232,487351,4334881
4484,3408,Raghunath Ramji Makasare,SHIRDI,Bharipa Bahujan Mahasangh,0,Post Graduate,2132555,289000,1843555
4485,2590,Raghunath Shankarrao Shelke,YAVATMAL-WASHIM,Ambedkarist Republican Party,0,Graduate,9692000,0,9692000
4486,3499,Raghunathdada Patil,HATKANANGLE,AAP,4,Graduate,20095000,695000,19400000
4487,1732,Raghuraj Pratap Singh,BULANDSHAHR,Rashtriya Kranti Party,0,12th Pass,849500,21000,828500
4488,1736,Raghuveer Singh Bodh,SAHARANPUR,IND,0,8th Pass,2590110,0,2590110
4489,2450,Raghuvir Singh,UDAIPUR,INC,0,Graduate Professional,26644500,3527476,23117024
4490,380,Ragini Lata Singh,AURANGABAD,AAP,0,Post Graduate,14532000,183755,14348245
4491,7090,Raguraman. A,MAYILADUTHURAI,IND,0,10th Pass,552881,0,552881
4492,5555,Rahat Afroz,FIROZABAD,IUML,0,10th Pass,9063214,0,9063214
4493,2333,Rahisa Bano,JHUNJHUNU,BSP,0,Literate,661308,0,661308
4494,528,Rahmat Ullah,KALIABOR,IND,0,Graduate Professional,255300,0,255300
4495,2312,Rahul Kaswan,CHURU,BJP,0,Graduate,25721266,5386104,20335162
4496,7883,Rahul Pandit,MALKAJGIRI,IND,0,Graduate,25181037,5850000,19331037
4497,3857,Rahul Prabhakar Kamble,BEED,Ambedkarite Party of India,0,Graduate Professional,102000,0,102000
4498,2669,Rahul Ranjan,JAHANABAD,JMM,0,Graduate,3431000,0,3431000
4499,1422,Rahul Sheshraoji Meshram,RAMTEK,IND,0,12th Pass,10938968,0,10938968
4500,1427,Rahulkant Alias Ramesh Sinha,RAMTEK,IND,0,Graduate Professional,6520000,700000,5820000
4501,1685,Raj Babbar,GHAZIABAD,INC,1,12th Pass,197233950,22896345,174337605
4502,6147,Raj Gill,FIROZPUR,IND,0,8th Pass,590000,0,590000
4503,871,Raj Kumar,AMBALA,INC,0,10th Pass,36214599,5883900,30330699
4504,2023,Raj Kumar,HISAR,IND,0,10th Pass,66000,0,66000
4505,572,Raj Kumar,JAMMU,IND,0,12th Pass,2268500,0,2268500
4506,7768,Raj Kumar Atwal,LUDHIANA,IND,0,Graduate,1572847,400000,1172847
4507,3128,Raj Kumar Gupta,MORADABAD,IND,0,8th Pass,1973100,0,1973100
4508,4479,Raj Kumar Mandal,KATIHAR,IND,0,Post Graduate,691300,0,691300
4509,1999,Raj Kumar Nagar,SIRSA,SP,0,Graduate,5675000,3200000,2475000
4510,2738,Raj Kumar Ram,PATALIPUTRA,BSP,0,10th Pass,660000,450000,210000
4511,1034,Raj Kumar Saini,KURUKSHETRA,IND,0,5th Pass,562200,24000,538200
4512,2641,Raj Kumar Singh,ARRAH,BJP,0,Graduate Professional,48403293,0,48403293
4513,4490,Raj Kumar Uraon,PURNIA,BSP,0,12th Pass,4277000,0,4277000
4514,367,Raj Narain Rao,SASARAM,IND,0,12th Pass,558000,100,557900
4515,5743,Raj Nath Singh,LUCKNOW,BJP,0,Post Graduate,29240729,0,29240729
4516,992,Raj Pal Singh,WEST DELHI,BSP,0,Graduate,30390435,0,30390435
4517,2024,Raj Singh,HISAR,IND,0,Others,708500,0,708500
4518,6903,Raj. N,CHENNAI NORTH,IND,0,5th Pass,300000,0,300000
4519,5704,Raja A,SALEM,IND,1,8th Pass,1971000,0,1971000
4520,7484,Raja A,SIVAGANGA,IND,0,Graduate,309500,0,309500
4521,2966,Raja Pateriya,KHAJURAHO,INC,0,12th Pass,52438292,552639,51885653
4522,5021,Raja Ram,HATHRAS,IND,0,Graduate,575000,0,575000
4523,34,Raja Ram Singh,KARAKAT,CPI(ML)L,4,Graduate Professional,6796970,0,6796970
4524,2121,Raja Thimmappa Nayak,RAICHUR,BSP,0,12th Pass,15732000,100000,15632000
4525,7103,"Raja, A.",NILGIRIS,DMK,1,Graduate,36055771,3965347,32090424
4526,7525,"Raja, V.",THENI,IND,0,12th Pass,4709650,150000,4559650
4527,6904,Raja. B,CHENNAI NORTH,IND,0,Others,387500,0,387500
4528,2582,Rajagiri T.D,CHITRADURGA,BSP,3,Post Graduate,3875000,500000,3375000
4529,7390,"Rajagopal Mallar, P. Thiru",SRIPERUMBUDUR,IND,0,Post Graduate,8584801,1900000,6684801
4530,7003,Rajagopal V,ERODE,IND,0,12th Pass,327000,0,327000
4531,6976,"Rajagopal, M.",COIMBATORE,IND,0,10th Pass,6447504,120000,6327504
4532,4553,Rajaiah Siricilla,WARANGAL,INC,4,Graduate,35362961,600000,34762961
4533,5702,Rajakannu A,SALEM,IND,0,8th Pass,691401,0,691401
4534,7603,Rajamaravan @ Manickavasagam.S,TIRUNELVELI,IND,4,Graduate,174500,67601,106899
4535,1369,Rajan Lal,NORTH EAST DELHI,Bharatiya Republican Paksha,0,Graduate Professional,11571000,0,11571000
4536,1934,Rajaneesh Babu,ERNAKULAM,IND,0,10th Pass,1000,0,1000
4537,38,Rajani Dubey,KARAKAT,Akhil Bharatiya Jan Sangh,0,Graduate,8324677,0,8324677
4538,3918,Rajaram Mehar,BHOPAL,Proutist Sarva Samaj,0,Post Graduate,1530000,0,1530000
4539,4267,Rajaram Pal,AKBARPUR,INC,1,Graduate Professional,8888279,18738000,0
4540,7129,"Rajasekar, T.",PERAMBALUR,IND,0,10th Pass,540000,0,540000
4541,4335,Rajasekar.S @ S.R.Thevar,SIVAGANGA,Desiya Forward Bloc,5,8th Pass,16012209,1437300,14574909
4542,7113,"Rajasekaran, M.,",PERAMBALUR,INC,4,Graduate,23598000,0,23598000
4543,2336,Rajbala,JHUNJHUNU,IND,0,8th Pass,816752,0,816752
4544,2326,Rajbala Ola,JHUNJHUNU,INC,0,Doctorate,58115000,500000,57615000
4545,147,Rajballabh Prasad,NAWADA,RJD,3,10th Pass,83137973,1387290,81750683
4546,423,Rajbir Palna,SIRSA,IND,0,Post Graduate,356000,37362,318638
4547,3161,Rajeev Agrawal,PILIBHIT,AAP,1,12th Pass,54959664,2264609,52695055
4548,3491,Rajeev Appasaheb Rajale,AHMEDNAGAR,NCP,3,Graduate Professional,63094594,17101039,45993555
4549,6778,Rajeev Ranjan,KHAGARIA,Lok Dal,2,12th Pass,4247500,0,4247500
4550,6692,Rajeev Ranjan Tiwari,LUCKNOW,IND,0,Graduate Professional,600151,0,600151
4551,5600,Rajeev Satyendra Sharma,RAVER,AAP,0,Graduate,63431845,0,63431845
4552,3511,Rajeev Shankarrao Satav,HINGOLI,INC,0,Graduate Professional,49681499,584357,49097142
4553,2087,Rajeev Yadav,GURGAON,IND,0,Post Graduate,3963909,0,3963909
4554,84,Rajen Gohain,NOWGONG,BJP,1,Graduate Professional,24736544,5328287,19408257
4555,3296,Rajen Hansda,BALURGHAT,BSP,0,Post Graduate,512524,0,512524
4556,505,Rajen Saikia,TEZPUR,AIFB,0,10th Pass,1318447,0,1318447
4557,2097,Rajender,FARIDABAD,IND,0,10th Pass,940500,0,940500
4558,463,Rajender,FARIDABAD,BSP,0,Graduate,17146020,250000,16896020
4559,1749,Rajender Kumar,SAHARANPUR,Adarsh Rashtriya Vikas Party,0,Graduate,44300,0,44300
4560,1993,Rajender Kumar,AMBALA,Bhartiya Shakti Chetna Party,0,10th Pass,4150500,0,4150500
4561,6338,Rajendhran. R,DINDIGUL,IND,0,8th Pass,360500,0,360500
4562,4272,Rajendra,ETAH,Braj Vikas Party,0,12th Pass,1290000,0,1290000
4563,667,Rajendra Agarwal,MEERUT,BJP,2,Post Graduate,8803517,3074600,5728917
4564,3702,Rajendra Dnyandeo Randive,SOLAPUR,IND,0,Graduate Professional,34000,0,34000
4565,5646,Rajendra Gajbhiye,THANE,Ambedkarite Party of India,0,12th Pass,2011650,81832,1929818
4566,7915,Rajendra Kumar,JHANSI,IND,0,Post Graduate,1180000,0,1180000
4567,5797,Rajendra Kumar Misra,SITAPUR,Nav Bharat Democratic Party,0,Post Graduate,198826000,0,198826000
4568,1155,Rajendra Kumar Mund,KALAHANDI,IND,0,Post Graduate,32280000,48000,32232000
4569,6653,Rajendra Kumar Singh,DHAURAHRA,Peace Party,0,12th Pass,692768,0,692768
4570,2665,Rajendra Kumar Singh Chauhan,BUXAR,Bharat Vikas Morcha,0,Literate,35000,0,35000
4571,3369,Rajendra Maruti Kate,MAVAL,IND,0,Graduate,402000,0,402000
4572,5560,Rajendra Prasad,FIROZABAD,Bahujan Mukti Party,0,Graduate,180000,50000,130000
4573,6158,Rajendra Prasad Singh,BEGUSARAI,CPI,5,Graduate,8437962,194145,8243817
4574,2889,Rajendra Purty,SINGHBHUM,Jharkhand Party,0,12th Pass,551520,15000,536520
4575,1016,Rajendra Singh,NAWADA,AAP,0,Graduate Professional,1455858,858745,597113
4576,4661,Rajendra Singh Kanwar,KORBA,Chhattisgarh Swabhiman Manch,0,Graduate,2737000,300000,2437000
4577,2878,Rajendra Singh Munda,RANCHI,CPI(M),0,10th Pass,8243730,3000,8240730
4578,6157,Rajendra Yadav,BEGUSARAI,IND,0,Post Graduate,7368500,0,7368500
4579,1452,Rajendrakumar Punjabrao Kanphade,NAGPUR,IND,0,Graduate,1841093,0,1841093
4580,7151,Rajendran. M,POLLACHI,IND,0,12th Pass,129378,0,129378
4581,6309,Rajendran.K,CHIDAMBARAM,BSP,0,10th Pass,557000,0,557000
4582,744,Rajes Nandini Singh - Dalvir,SHAHDOL,INC,0,Graduate,41389440,645000,40744440
4583,2088,Rajesh,GURGAON,IND,0,10th Pass,36429409,880000,35549409
4584,1357,Rajesh,EAST DELHI,Ambedkar National Congress,0,Graduate,83220,0,83220
4585,1617,Rajesh Devi Urf Radhika,MUZAFFARNAGAR,AITC,0,Graduate Professional,7370060,0,7370060
4586,3919,Rajesh Keer,BHOPAL,Bahujan Mukti Party,0,Graduate Professional,2215850,15000,2200850
4587,2410,Rajesh Kumar,KOTA,Jai Maha Bharath Party,0,10th Pass,364000,0,364000
4588,2038,Rajesh Kumar,KARNAL,IND,0,Graduate,18210000,225000,17985000
4589,1318,Rajesh Kumar,NORTH WEST DELHI,Rashtriya Bahujan Hitay Party,0,10th Pass,1141000,0,1141000
4590,5018,Rajesh Kumar,HATHRAS,BJP,0,Graduate Professional,5651457,0,5651457
4591,5235,Rajesh Kumar,ARARIA,Bharat Vikas Morcha,0,10th Pass,1475000,50000,1425000
4592,6190,Rajesh Kumar,KHAGARIA,BSP,0,Graduate,10016038,0,10016038
4593,7035,Rajesh Kumar K.R.,KANNIYAKUMARI,IND,0,Graduate,1121500,0,1121500
4594,4662,Rajesh Kumar Mahant,KORBA,JD(U),0,8th Pass,466000,0,466000
4595,4663,Rajesh Kumar Pandey,KORBA,IND,2,10th Pass,390250,0,390250
4596,6711,Rajesh Kumar S/O Babooram,MISRIKH,IND,0,Graduate,36050,0,36050
4597,6715,Rajesh Kumar S/O Parmeshwar Deen,MISRIKH,Bharatiya Republican Paksha,1,Graduate,100000,0,100000
4598,5798,Rajesh Kumar Singh,SITAPUR,BJP,0,Post Graduate,41418622,1265000,40153622
4599,5487,Rajesh Kumar Vidyarthi,BARABANKI,Peace Party,0,Post Graduate,9893000,1760000,8133000
4600,2981,Rajesh Kushwah,MORENA,SP,0,Graduate Professional,491500,0,491500
4601,6198,Rajesh Ranjan Urf Pappu Yadav,MADHEPURA,RJD,24,Graduate,81242966,956306,80286660
4602,1890,Rajesh S,PALAKKAD,SHS,0,10th Pass,0,255390,0
4603,4177,Rajesh Sariyam,BETUL,AAP,0,Post Graduate,1797958,184853,1613105
4604,1453,Rajesh Suresh Sadhankar,NAGPUR,IND,0,Not Given,0,0,0
4605,6259,"Rajesh, R",ARAKKONAM,INC,0,Post Graduate,196025973,3000000,193025973
4606,6260,"Rajesh, S.",ARAKKONAM,AAP,0,Graduate Professional,7716,0,7716
4607,6539,Rajeshbhai Lavjibhai Pipalva,RAJKOT,Loktantrik Rashrtavadi Party,0,Graduate,2360000,524000,1836000
4608,7605,Rajeshkannan,TIRUNELVELI,IND,0,8th Pass,2140000,0,2140000
4609,5048,Rajeshwari,MAINPURI,IND,0,Post Graduate,5331700,430000,4901700
4610,7604,Raji Yadav,TIRUNELVELI,IND,0,10th Pass,47955,0,47955
4611,7798,Rajinder Bhatheja,FIROZPUR,IND,0,8th Pass,813725,0,813725
4612,6126,Rajinder Singh,BATHINDA,Shiromani Akali Dal (Amritsar)(Simranjit Sing,0,10th Pass,2600000,0,2600000
4613,7863,Rajinder Singh Pawar,PATIALA,IND,0,8th Pass,11511278,0,11511278
4614,6919,Rajini Nivetha,CHENNAI SOUTH,IND,0,12th Pass,151457,0,151457
4615,6997,Rajinikanth.S,DHARMAPURI,BSP,0,Graduate Professional,145000,0,145000
4616,2061,Rajiv,BHIWANI-MAHENDRAGARH,Bahujan Mukti Party,0,12th Pass,161000,0,161000
4617,7769,Rajiv Kumar Kalra,LUDHIANA,IND,0,10th Pass,1478091,0,1478091
4618,2697,Rajiv Ranjan Singh Alias Lalan Singh,MUNGER,JD(U),1,Graduate,55757926,3512083,52245843
4619,1525,Rajkumar,SATNA,Bhartiya Shakti Chetna Party,0,10th Pass,790000,600000,190000
4620,6668,Rajkumar,JALAUN,Peace Party,0,Graduate,4910000,0,4910000
4621,3562,Rajkumar Bhimrao Chandanshive,LATUR,IND,0,8th Pass,108500,120000,0
4622,510,Rajkumar Dowarah,JORHAT,IND,0,Graduate,487600,0,487600
4623,1237,Rajkumar Pahan,CHATRA,Rashtriya Deshaj Party,0,Graduate,8851813,0,8851813
4624,3479,Rajkumar Ranjan Singh,INNER MANIPUR,BJP,0,Doctorate,13350861,0,13350861
4625,90,Rajkumar Saini,KURUKSHETRA,BJP,0,Graduate,132880476,23262108,109618368
4626,5749,Rajkumar Singh,LUCKNOW,National Youth Party,0,Post Graduate,3032355,0,3032355
4627,6961,"Rajkumar, S",CHIDAMBARAM,IND,0,12th Pass,3811500,0,3811500
4628,7467,Rajkumar.R,THANJAVUR,IND,0,Post Graduate,114000,0,114000
4629,6316,Rajkumar.V,CUDDALORE,IND,0,Graduate,368000,0,368000
4630,2103,Rajmahendra Sakharam Gaonkar,BELGAUM,IND,0,Post Graduate,3620123,0,3620123
4631,494,Rajmohan Gandhi,EAST DELHI,AAP,0,Post Graduate,48208736,0,48208736
4632,5421,Rajnath,SURGUJA,IND,0,10th Pass,732000,0,732000
4633,6746,Rajnikant,UNNAO,IND,0,Graduate Professional,1040000,0,1040000
4634,6196,Rajo Sah,MADHEPURA,IND,0,Literate,3490200,650000,2840200
4635,2321,Rajpal,CHURU,IND,0,Post Graduate,25500,0,25500
4636,3036,Rajpal,AMROHA,Adarsh Rashtriya Vikas Party,0,10th Pass,2901400,30000,2871400
4637,5495,Rajrani Rawat,BARABANKI,SP,0,12th Pass,33493596,933806,32559790
4638,3304,Rajratna Ambedkar,NANDED,Bahujan Mukti Party,0,Post Graduate,4040148,450000,3590148
4639,5176,Raju Baburao Dole,AURANGABAD,IND,0,Graduate,16149796,3435981,12713815
4640,1561,Raju Baiga,SHAHDOL,IND,1,10th Pass,5177500,120000,5057500
4641,6804,Raju Dey Sarkar,SREERAMPUR,IND,0,Graduate,245042,0,245042
4642,1985,Raju Dsouza,NORTH GOA,Samajwadi Janata Party (Rashtriya),0,10th Pass,9352368,5050000,4302368
4643,2377,Raju Lal Bairwa,JAIPUR,Ambedkarite Party of India,0,10th Pass,4327500,96000,4231500
4644,1111,Raju Mahadeorao Sonone,AMRAVATI,IND,0,Graduate,674000,0,674000
4645,1522,Raju Or Bharatraje Uddhaorao Patil,YAVATMAL-WASHIM,MNS,6,Graduate,25700000,1400000,24300000
4646,1838,Raju Padaganur,BIJAPUR,IND,0,10th Pass,680000,10000,670000
4647,48,Raju S. Mankar,AMRAVATI,IND,0,Literate,13736000,150000,13586000
4648,3501,Raju Shetty,HATKANANGLE,Swabhimani Paksha,12,10th Pass,16152914,1504152,14648762
4649,5647,Raju Shravan Chavan,THANE,Republican Bahujan Sena,0,Literate,3326553,325000,3001553
4650,2642,Raju Yadav,ARRAH,CPI(ML)L,1,Post Graduate,491000,0,491000
4651,4733,Rajvardhan Azad,GODDA,JD(U),0,Post Graduate,26048342,0,26048342
4652,5562,Rajveer,FIROZABAD,IND,0,10th Pass,394000,0,394000
4653,4952,Rajveer Singh,ETAH,IND,0,Graduate,2752626,0,2752626
4654,4277,Rajvir Singh,ETAH,BJP,0,Graduate Professional,251921157,46898091,205023066
4655,2360,Rajyavardhan Singh Rathore,JAIPUR RURAL,BJP,0,Graduate,83734044,117065,83616979
4656,3216,Rakesh,SHAHJAHANPUR,IND,0,Not Given,90000,0,90000
4657,1628,Rakesh,MUZAFFARNAGAR,IND,0,12th Pass,1818316,28990,1789326
4658,1714,Rakesh,GAUTAM BUDHHA NAGAR,IND,0,12th Pass,19913600,0,19913600
4659,3049,Rakesh,AMROHA,Peace Party,1,8th Pass,4005000,40000,3965000
4660,2308,Rakesh Chandra Rawat,ALIGARH,Rashtriya Sawarn Dal,0,Post Graduate,23000000,0,23000000
4661,4273,Rakesh Gandhi,ETAH,IND,0,Graduate,3578000,0,3578000
4662,6750,Rakesh Kumar,UNNAO,Bahujan Mukti Party,0,Post Graduate,2896938,0,2896938
4663,1292,Rakesh Kumar,SOUTH DELHI,IND,0,10th Pass,660800,0,660800
4664,1305,Rakesh Kumar,WEST DELHI,Bhartiya Janta Dal (Integrated),0,10th Pass,40000,0,40000
4665,2070,Rakesh Kumar,BHIWANI-MAHENDRAGARH,IND,0,Graduate Professional,8693411,1050000,7643411
4666,2022,Rakesh Kumar (Rinku Bhai),HISAR,IND,0,12th Pass,451122,28102,423020
4667,5526,Rakesh Kumar Goswami,HAMIRPUR,BSP,0,Graduate Professional,49515582,0,49515582
4668,4186,Rakesh Kumar Patel,INDORE,IND,0,Graduate Professional,180000,0,180000
4669,5024,Rakesh Kumar Tiwari Advocate,KANNAUJ,IND,0,Graduate Professional,2856442,0,2856442
4670,2719,Rakesh Ranjan Sinha,NALANDA,RPI(A),0,Graduate,3748727,16599,3732128
4671,5520,Rakesh Sachan,FATEHPUR,SP,8,Post Graduate,228815082,25814891,203000191
4672,373,Rakesh Sharma,AURANGABAD,IND,0,Doctorate,12693861,828288,11865573
4673,750,Rakesh Singh Urf Ghanshyam Singh,JABALPUR,BJP,1,Graduate,27823610,0,27823610
4674,3035,Rakesh Tikait,AMROHA,RLD,3,Graduate,42518038,1095120,41422918
4675,4395,Rakesh Yadav,FIROZABAD,AAP,0,Post Graduate,55947000,3400000,52547000
4676,166,Rakhal Raj Datta,TRIPURA WEST,Amra Bangalee,0,Post Graduate,6549960,0,6549960
4677,496,Rakhi Birla,NORTH WEST DELHI,AAP,0,Post Graduate,163467,230000,0
4678,5905,Rakhi Sawant,MUMBAI NORTH WEST,Rashtriya Aam Party,1,Illiterate,146946664,32528125,114418539
4679,3163,Ram Autar,PILIBHIT,CPI(ML)L,0,12th Pass,2345938,0,2345938
4680,6739,Ram Avtar Nishad,SITAPUR,Jai Hind Samaj Party,0,12th Pass,2849728,0,2849728
4681,2703,Ram Badan Rai,MUNGER,SP,0,Post Graduate,23860981,1000000,22860981
4682,6654,Ram Bali,DHAURAHRA,CPI(ML) Red Star,0,10th Pass,92484,0,92484
4683,1706,Ram Bilash,GAUTAM BUDHHA NAGAR,Bahujan Mukti Party,0,5th Pass,6470000,0,6470000
4684,1363,Ram Briksh Mall,EAST DELHI,Hindusthan Nirman Dal,0,Post Graduate,18234000,956912,17277088
4685,6246,Ram Chandar Ram,SAMASTIPUR,BSP,0,Graduate Professional,2190160,0,2190160
4686,6032,Ram Chandra Dome,BOLPUR,CPI(M),0,Graduate Professional,1878460,0,1878460
4687,6248,Ram Chandra Paswan,SAMASTIPUR,LJP,3,10th Pass,13058612,0,13058612
4688,6764,Ram Chandra Safi,JHANJHARPUR,IND,0,10th Pass,475666,44100,431566
4689,3015,Ram Charan Ahirwar,TIKAMGARH,Poorvanchal Rashtriya Congress,0,12th Pass,4650000,0,4650000
4690,3448,Ram Dayal,JODHPUR,IND,0,12th Pass,1231000,0,1231000
4691,5010,Ram Dayal,HARDOI,Peace Party,0,Post Graduate,24264635,732,24263903
4692,561,Ram Dayal Singh,KARAKAT,IND,0,Graduate,3256600,0,3256600
4693,4867,Ram Ekbal Shahani,DHUBRI,IND,0,5th Pass,2755078,0,2755078
4694,3106,Ram Gopal Mishra,KHERI,IND,0,8th Pass,27258000,5000,27253000
4695,1557,Ram Gopal Singh,SHAHDOL,Bhartiya Shakti Chetna Party,0,8th Pass,1475529,0,1475529
4696,5129,Ram Hans,TONK-SAWAI MADHOPUR,Naya Daur Party,0,10th Pass,320000,0,320000
4697,1025,Ram Jawari,AMBALA,Rashtriya Karmyog Party,0,Graduate,245500,0,245500
4698,1319,Ram Karan Sauran,NORTH WEST DELHI,IND,0,Graduate,11854000,1257000,10597000
4699,1995,Ram Kishan,KURUKSHETRA,Lok Parivartan Party(DC),0,10th Pass,1785984,0,1785984
4700,7738,Ram Kishan,HOSHIARPUR,IND,0,10th Pass,1293000,165000,1128000
4701,1544,Ram Kishan Nirat (Saket),REWA,RPI(A),1,Post Graduate,897056,100000,797056
4702,4981,Ram Kishore Dwivedi,FARRUKHABAD,IND,0,Not Given,309300,0,309300
4703,2750,Ram Kripal Yadav,PATALIPUTRA,BJP,1,Graduate,13989431,2100000,11889431
4704,7914,Ram Kumar Ank Shastri,JHANSI,IND,0,Graduate,33879,0,33879
4705,6151,Ram Kumar Parjapat,FIROZPUR,BSP,0,Graduate,14955000,2518500,12436500
4706,5014,Ram Lakhan Gautam,HARDOI,Indian Savaran Samaj Party,0,10th Pass,660000,0,660000
4707,2964,Ram Lakhan Singh,KHAJURAHO,BSP,1,Post Graduate,8657688,497625,8160063
4708,4011,Ram Lal Mahto,RANCHI,SUCI(C),0,Graduate,521590,0,521590
4709,3213,Ram Lal Verma,SHAHJAHANPUR,Bahujan Mukti Party,0,Graduate,2029000,28000,2001000
4710,5525,Ram Lochan Sen,FATEHPUR,Bahujan Mukti Party,0,Graduate,2348000,0,2348000
4711,3212,Ram Murti,SHAHJAHANPUR,Bhartiya Krishak Dal,0,Not Given,534000,0,534000
4712,5544,Ram Narayan,JALAUN,Bahujan Mukti Party,0,12th Pass,701000,0,701000
4713,4645,Ram Narayan Ayam,RAIGARH,Ambedkarite Party of India,0,Graduate,1811000,0,1811000
4714,2987,Ram Naresh,MORENA,IND,0,Literate,220000,0,220000
4715,2968,Ram Nath,KHAJURAHO,IND,0,8th Pass,420000,330000,90000
4716,1162,Ram Nayak,KANDHAMAL,BSP,0,5th Pass,1774911,713000,1061911
4717,6155,Ram Padarath Yadav,BEGUSARAI,BSP,0,Graduate Professional,8422000,0,8422000
4718,5011,Ram Pal,HARDOI,IND,0,8th Pass,1601000,0,1601000
4719,5137,Ram Parkash,TONK-SAWAI MADHOPUR,IND,0,8th Pass,2650000,0,2650000
4720,2956,Ram Pathwar Kori (Ramsebak),GWALIOR,IND,0,12th Pass,53200,0,53200
4721,80,Ram Prasad Sharma,TEZPUR,BJP,0,Graduate Professional,6655300,0,6655300
4722,2302,Ram Ratan,BIKANER,Bahujan Mukti Party,0,8th Pass,477590,0,477590
4723,5533,Ram Sajiwan,HAMIRPUR,Bhartiya Shakti Chetna Party,0,Graduate,2168500,0,2168500
4724,4936,Ram Sevak,AKBARPUR,IND,0,Graduate,43000,0,43000
4725,1559,Ram Singh,SHAHDOL,Chhattisgarh Swabhiman Manch,0,8th Pass,186000,0,186000
4726,2383,Ram Singh,JAIPUR,IND,0,Graduate,730306,0,730306
4727,5117,Ram Singh,KARAULI-DHOLPUR,National Peoples Party,0,Graduate,862500,0,862500
4728,7849,Ram Singh Dhiman,PATIALA,BSP,0,10th Pass,4275000,0,4275000
4729,4509,Ram Singh Pandram,BILASPUR,IND,0,12th Pass,691542,7000,684542
4730,3228,Rama Chandra Hansdah,MAYURBHANJ,BJD,0,Graduate,3630888,0,3630888
4731,99,Rama Chandra Panda,BERHAMPUR,BJP,0,Post Graduate,5552220,0,5552220
4732,4713,Rama Kant Verma,DHANBAD,AAP,0,8th Pass,1703826,0,1703826
4733,2485,Rama Ram,BARMER,IND,0,5th Pass,365485,36000,329485
4734,7780,Rama Rao,ZAHIRABAD,IND,0,Graduate,18025587,800000,17225587
4735,5422,Rama Sapna Singh,SURGUJA,Ambedkarite Party of India,0,Graduate,1478276,13209,1465067
4736,5225,Rama Singh Patel,DHAR,IND,0,8th Pass,700852,0,700852
4737,6996,Rama Suganthan,DHARMAPURI,INC,0,Post Graduate,207501877,1100000,206401877
4738,7389,"Ramachandiran, K. Thiru",SRIPERUMBUDUR,IND,0,5th Pass,762000,0,762000
4739,7372,"Ramachandran, K.N. Thiru",SRIPERUMBUDUR,AIADMK,0,Post Graduate,936721057,80806268,855914789
4740,2673,Ramadhar Chaudhary,JAHANABAD,CPI(ML)L,3,10th Pass,577037,0,577037
4741,5684,Ramajeyam.G,NAMAKKAL,IND,0,12th Pass,996000,0,996000
4742,4259,Ramakant,AKBARPUR,Peace Party,0,Graduate Professional,6928000,3400000,3528000
4743,1554,Ramakant Pandey Malaihna,SIDHI,IND,0,Post Graduate,515000,0,515000
4744,5577,Ramamurthi,PONDICHERRY,IND,0,8th Pass,4000,0,4000
4745,1128,Raman Motiram Bansod,BHANDARA-GONDIYA,Ambedkarite Party of India,0,Post Graduate,58800,50000,8800
4746,5234,Ramanand Rishideo,ARARIA,Lok Dal,0,12th Pass,10000,0,10000
4747,7273,Ramani Sureshbhai Dhirubhai,AMRELI,IND,0,12th Pass,1390000,0,1390000
4748,2155,Ramanna,BIDAR,Hindustan Janta Party,0,5th Pass,435000,0,435000
4749,1344,Ramanuj Patel,NEW DELHI,Samyak Parivartan Party,0,12th Pass,100,0,100
4750,3727,Ramanuj Singh,BANGALORE CENTRAL,IND,0,Graduate Professional,84383,56000,28383
4751,1826,Ramappa Mareppa Chalawadi,BELGAUM,IND,1,10th Pass,1620326,50000,1570326
4752,7118,"Ramar Yadav, K.",PERAMBALUR,Tamil Nadu Makkal Congress,0,Not Given,805000,0,805000
4753,7150,Ramasamy. K,POLLACHI,IND,0,Graduate,7571000,0,7571000
4754,6902,Ramasamy. M.D.,CHENNAI NORTH,IND,0,8th Pass,7243000,0,7243000
4755,4039,Ramasamy.N,NAMAKKAL,IND,0,Illiterate,30000,0,30000
4756,5675,Ramasamy.P,NAMAKKAL,IND,0,12th Pass,605332,0,605332
4757,743,Ramashankar Shahwal,SIDHI,BSP,0,Post Graduate,9743656,1092000,8651656
4758,7587,Ramasubbu.S.S,TIRUNELVELI,INC,0,Post Graduate,42408738,8590027,33818711
4759,2845,Ramavtar Mahto,HAZARIBAGH,IND,0,12th Pass,1863000,0,1863000
4760,7513,"Ramaya, R.",THENI,IND,0,5th Pass,188926,45000,143926
4761,1264,Rambadan Ram,PALAMAU,SP,0,Post Graduate,2450000,800000,1650000
4762,7623,Rambhau Vitthal Chinchore,JALNA,IND,0,10th Pass,50000,200000,0
4763,4764,Ramchand Vasaini,INDORE,IND,0,10th Pass,3703000,0,3703000
4764,4190,Ramchandr Parmar,INDORE,Bahujan Mukti Party,2,10th Pass,130000,0,130000
4765,5648,Ramchandra Bhagoji Gawade,THANE,IND,0,Literate,660000,175000,485000
4766,3322,Ramchandra Gangaram Bharande,NANDED,IND,0,Post Graduate,100000,0,100000
4767,3305,Ramchandra Gyanoba Sawant,NANDED,Bharipa Bahujan Mahasangh,0,10th Pass,176000,0,176000
4768,5479,Ramchandra Saras,BANDA,CPI,0,Graduate,4090000,610000,3480000
4769,2371,Ramcharan Bohara,JAIPUR,BJP,0,12th Pass,135809546,23871000,111938546
4770,944,Ramdas Chandrabhanji Tadas,WARDHA,BJP,5,10th Pass,33628998,1749314,31879684
4771,4821,Ramdayal Kori,VIDISHA,IND,0,10th Pass,1117500,0,1117500
4772,5419,Ramdeo Tirkey,SURGUJA,INC,0,12th Pass,7254485,1408815,5845670
4773,5279,Ramdev Sharma,SUPAUL,IND,0,12th Pass,250000,0,250000
4774,83,Ramen Deka,MANGALDOI,BJP,0,Graduate,14782357,5400953,9381404
4775,4270,Ramendra Singh Tomar,AKBARPUR,Bhartiya Shakti Chetna Party,0,10th Pass,4818007,0,4818007
4776,5112,Ramesh,KARAULI-DHOLPUR,Bharatiya Yuva Shakti,0,12th Pass,835000,0,835000
4777,4925,Ramesh,AGRA,JD(U),2,Graduate Professional,431000,0,431000
4778,1592,Ramesh,CHHINDWARA,Ambedkarite Party of India,0,8th Pass,0,0,0
4779,2136,Ramesh,BIDAR,Ambedkar National Congress,1,10th Pass,1957000,0,1957000
4780,2053,Ramesh,SONIPAT,IND,0,Graduate Professional,42376491,425241,41951250
4781,1823,Ramesh Alias Suresh Guruling Kadalaskar,BELGAUM,BSP,0,12th Pass,479000,0,479000
4782,109,Ramesh Bais,RAIPUR,BJP,0,12th Pass,73190135,274902,72915233
4783,4698,Ramesh Bharati,DHANBAD,IND,2,Graduate Professional,6053500,0,6053500
4784,71,Ramesh Bidhuri,SOUTH DELHI,BJP,4,Graduate Professional,147493056,0,147493056
4785,1023,Ramesh Chand,AMBALA,IND,0,10th Pass,1110000,0,1110000
4786,5132,Ramesh Chand,TONK-SAWAI MADHOPUR,Lok Dal,0,12th Pass,48000,0,48000
4787,677,Ramesh Chand Tomar,GAUTAM BUDHHA NAGAR,INC,4,Doctorate,61617189,0,61617189
4788,3014,Ramesh Chand Verma,TIKAMGARH,AAP,0,Graduate Professional,1698238,325000,1373238
4789,891,Ramesh Chander,CHANDIGARH,IND,0,Graduate,3324,0,3324
4790,2640,Ramesh Chandra Badal,ARRAH,BSP,1,Literate,726000,0,726000
4791,2346,Ramesh Chandra Sharma,SIKAR,Bhartiya Party,0,Graduate Professional,9353600,0,9353600
4792,4198,Ramesh Chensingh,KHARGONE,INC,1,5th Pass,5264289,720473,4543816
4793,6072,Ramesh Dhara,ULUBERIA,IND,1,10th Pass,540917,150000,390917
4794,3248,Ramesh Jena,BHADRAK,CPI,0,Graduate,346987,0,346987
4795,840,Ramesh Jigajinagi,BIJAPUR,BJP,2,Graduate,89429828,5305043,84124785
4796,6875,Ramesh Kannan .G,CHENNAI NORTH,Republican Party of India,0,Graduate,6306550,495000,5811550
4797,91,Ramesh Kaushik,SONIPAT,BJP,0,Graduate Professional,142840716,0,142840716
4798,3800,Ramesh Koti,KOPPAL,RPI(A),0,Graduate Professional,491000,0,491000
4799,1018,Ramesh Kumar,SOUTH DELHI,INC,0,10th Pass,172314296,0,172314296
4800,2787,Ramesh Kumar Gawde,KANKER,CPI,1,8th Pass,65000,100000,0
4801,5727,Ramesh Kumar Gupta,KANPUR,Parivartan Samaj Party,0,8th Pass,1233000,45000,1188000
4802,4711,Ramesh Kumar Ray,DHANBAD,IND,0,12th Pass,239715,0,239715
4803,5433,Ramesh P,TIRUVANNAMALAI,IND,0,Others,247000,0,247000
4804,5082,Ramesh Panaval,ALWAR,IND,0,12th Pass,16000,0,16000
4805,5536,Ramesh Prajapati,HAMIRPUR,Most Backward Classes Of India,0,12th Pass,4020000,850000,3170000
4806,5208,Ramesh Ragho More,DHULE,IND,0,10th Pass,5704000,0,5704000
4807,7740,Ramesh Rani Parjapati,ANANDPUR SAHIB,Bahujan Mukti Party,0,8th Pass,5535000,0,5535000
4808,4517,Ramesh Rathod,ADILABAD,TDP,3,12th Pass,19140000,41832000,0
4809,1368,Ramesh Singh Siral,NORTH EAST DELHI,Naya Daur Party,0,8th Pass,2490000,0,2490000
4810,1041,Ramesh Vishwanath Katti,CHIKKODI,BJP,0,12th Pass,89216294,598000,88618294
4811,3912,Ramesh Yadav,RAJNANDGAON,IND,0,12th Pass,1930155,0,1930155
4812,7388,"Ramesh, Thiru",SRIPERUMBUDUR,IND,0,Graduate,3249079,862500,2386579
4813,7309,Rameshbhai Bhikhabhai Rathod,BARDOLI,IND,0,Literate,98000,0,98000
4814,6748,Rameshwar,UNNAO,IND,0,Literate,8524929,0,8524929
4815,5377,Rameshwar Kewat,BILASPUR,IND,0,Post Graduate,630031,30000,600031
4816,1028,Rameshwar Kumar,KURUKSHETRA,Bhartiya Shakti Chetna Party,0,10th Pass,7416637,0,7416637
4817,479,Rameshwar Oraon,LOHARDAGA,INC,0,Doctorate,262697987,0,262697987
4818,2745,Rameshwar Prasad,PATALIPUTRA,CPI(ML)L,6,8th Pass,2386000,0,2386000
4819,645,Rameshwar Prasad Yadav,KODARMA,IND,0,Post Graduate,1488300,45000,1443300
4820,2833,Rameshwar Ram Kushwaha,HAZARIBAGH,AIFB,1,Graduate,946596,0,946596
4821,4307,Rameshwar Singh,FARRUKHABAD,SP,13,10th Pass,135820923,3878042,131942881
4822,81,Rameshwar Teli,DIBRUGARH,BJP,0,10th Pass,977943,0,977943
4823,3116,Rameshwari,KHERI,IND,0,Literate,202000,0,202000
4824,5413,Ramgopal Verma,RAIPUR,AITC,0,5th Pass,1100000,0,1100000
4825,7864,Ramisher Singh Billa,PATIALA,IND,0,10th Pass,1375000,0,1375000
4826,7640,Ramjan Mansuri(Journalist),NAVSARI,IND,0,10th Pass,170882,0,170882
4827,5019,Ramji Lal Suman,HATHRAS,SP,2,Graduate Professional,29953498,0,29953498
4828,5253,Ramji Mandal,BHAGALPUR,IND,0,10th Pass,3631000,0,3631000
4829,32,Ramji Manjhi,GAYA,RJD,0,Graduate,11115000,0,11115000
4830,3983,Ramji Sahu,BILASPUR,Chhattisgarh Swabhiman Manch,0,12th Pass,2597500,0,2597500
4831,377,Ramji Singh,AURANGABAD,IND,0,Post Graduate,1310000,50000,1260000
4832,1611,Ramkaran,KAIRANA,Bhartiya Vanchitsamaj Party,0,Post Graduate,2659619,0,2659619
4833,5517,Ramkrishan Tripathi,FATEHPUR,AITC,0,Post Graduate,549500,164541,384959
4834,4138,Ramkrishna Verma,RAIPUR,IND,0,8th Pass,12168,0,12168
4835,7563,Ramkumar. V,THOOTHUKKUDI,IND,0,10th Pass,240000,0,240000
4836,172,Ramla Mampad,WAYANAD,Welfare Party of India,0,12th Pass,2401057,0,2401057
4837,3415,Ramlal,AJMER,Akhil Bhartiya Aamjan Party,0,8th Pass,110000,0,110000
4838,3475,Ramlal,PALI,IND,0,Doctorate,11493000,600000,10893000
4839,2526,Rammurti Keshvrao Chimote,NAGPUR,GGP,0,12th Pass,2792000,0,2792000
4840,476,Ramnaresh Singh,CHATRA,CPI(ML)L,4,10th Pass,1255000,0,1255000
4841,4515,Ramnath Cherwa,SURGUJA,Shoshit Samaj Dal,0,8th Pass,9000,0,9000
4842,4968,Ramniwas Katheria,FARRUKHABAD,Bahujan Mukti Party,0,Post Graduate,5102500,0,5102500
4843,5769,Rampal,MISRIKH,IND,0,12th Pass,1364413,0,1364413
4844,486,Rampati Ranjan,PALAMAU,BSP,0,Graduate,4445000,0,4445000
4845,203,Ramphal,HISAR,IND,0,12th Pass,26200,0,26200
4846,5735,Ramphal,LUCKNOW,Bharatiya Nav Kranti Party,0,Post Graduate,12885000,200000,12685000
4847,1697,Ramphal Shakya,GHAZIABAD,IND,0,Not Given,3200000,1077,3198923
4848,2039,Ramphal Sharma,KARNAL,IND,0,10th Pass,4537000,0,4537000
4849,4023,Rampodo Mahto,RANCHI,IND,6,8th Pass,7296004,300000,6996004
4850,7510,"Ramprakash, J.",THENI,AAP,0,Post Graduate,24102861,2725330,21377531
4851,4210,Ramprasad Jatwa,UJJAIN,BSP,0,Graduate,200900,0,200900
4852,3345,Ramrao Dhansing Rathod Sir Nirankari,PARBHANI,IND,0,Post Graduate,9330000,0,9330000
4853,1477,Ramrao Govinda Nannaware,GADCHIROLI-CHIMUR,BSP,0,Graduate,2671687,1030335,1641352
4854,3515,Ramrao Harising Rathod,HINGOLI,Bharipa Bahujan Mahasangh,1,10th Pass,8884209,0,8884209
4855,1558,Ramratan Singh Pawley,SHAHDOL,GGP,0,Post Graduate,227724,0,227724
4856,2788,Ramsay Korram,KANKER,BSP,0,12th Pass,1070000,9594,1060406
4857,5545,Ramsingh,JALAUN,CPI(ML)L,0,10th Pass,522100,0,522100
4858,2875,Ramtahal Choudhary,RANCHI,BJP,0,10th Pass,10743950,0,10743950
4859,1442,Ramteke Jivan Namdeorao,NAGPUR,IND,0,10th Pass,390000,0,390000
4860,1395,Ramteke Ramesh Devidasrao,AMRAVATI,Republican Party of India (Khobragade),0,12th Pass,5770500,300000,5470500
4861,2113,Ramu Chatru,GULBARGA,IND,0,Graduate,1100000,0,1100000
4862,3739,Ramu S,BANGALORE NORTH,IND,0,12th Pass,807570,0,807570
4863,2159,Ramudu,BELLARY,BSP,0,5th Pass,0,0,0
4864,3427,Ran Singh Rajpurohit,JALORE,Jago Party,0,10th Pass,1675000,0,1675000
4865,5302,Rana Jayendrasunh Jitsinh,BHARUCH,AAP,0,Post Graduate,3059717,619966,2439751
4866,808,Rana Nag,BOLANGIR,BSP,0,Graduate,13940000,1700000,12240000
4867,6225,Ranaveni Lakshman,KARIMNAGAR,New India Party,0,10th Pass,620000,0,620000
4868,4150,Ranbir Singh,DHANBAD,IND,0,Literate,47000,0,47000
4869,415,Ranbir Singh Sharma,KURUKSHETRA,IND,0,Graduate Professional,14604045,300000,14304045
4870,7856,Randhir Singh,PATIALA,Bahujan Mukti Party,0,8th Pass,31475000,0,31475000
4871,235,Ranee Narah,LAKHIMPUR,INC,0,Graduate,88519819,1118242,87401577
4872,3820,Ranendra Nath Mali,BALURGHAT,Bahujan Mukti Party,0,12th Pass,1128000,0,1128000
4873,3818,Ranganayak,RAICHUR,Pyramid Party of India,0,10th Pass,555000,16000,539000
4874,7184,Rangarajan Mohan Kumaramangalam,SALEM,INC,0,Post Graduate,240204511,26229574,213974937
4875,4986,Rani Pakshalika Singh,FATEHPUR SIKRI,SP,0,Graduate,121911632,4507031,117404601
4876,7107,"Rani, M.T.",NILGIRIS,AAP,0,Post Graduate,6000000,0,6000000
4877,5248,Ranjan Kumar,BHAGALPUR,IND,0,8th Pass,355833,0,355833
4878,2737,Ranjan Prasad Yadav,PATALIPUTRA,JD(U),0,Doctorate,55327154,1766678,53560476
4879,5510,Ranjana Kakkar,FATEHPUR,IND,0,Post Graduate,3354000,0,3354000
4880,1135,Ranjeet Amardas Sukhdeve,BHANDARA-GONDIYA,Ambedkar samaj Party,0,12th Pass,1854500,225000,1629500
4881,4499,Ranjeet Ranjan,SUPAUL,INC,5,12th Pass,81242965,0,81242965
4882,7252,Ranjit Jugla Padvi,NANDURBAR,Bahujan Mukti Party,0,12th Pass,0,0,0
4883,7855,Ranjit Kaur,PATIALA,Bharatiya Gaon Taj Dal,0,12th Pass,4698863,0,4698863
4884,6064,Ranjit Kishore Mohanty,ULUBERIA,BJP,0,Post Graduate,42413560,1362846,41050714
4885,2881,Ranjit Mahto,RANCHI,Bahujan Mukti Party,0,Post Graduate,254840,0,254840
4886,3262,Ranjit Malik,JAJPUR,Bahujan Mukti Party,1,Graduate,1316991,270889,1046102
4887,1255,Ranjit Oraon,LOHARDAGA,IND,0,12th Pass,2024021,0,2024021
4888,3979,Ranjit Shekhar Mooshahary,KOKRAJHAR,AITC,0,Graduate,31461513,0,31461513
4889,6140,Ranjit Singh,FATEHGARH SAHIB,IND,0,10th Pass,1120500,0,1120500
4890,7682,Ranjit Singh Brahmpura,KHADOOR SAHIB,SAD,0,8th Pass,177814755,4200000,173614755
4891,86,Ranjit Singh Gorh,LAKHIMPUR,IND,0,Graduate,4611700,0,4611700
4892,6983,"Ranjithkumar, M.",COIMBATORE,IND,0,5th Pass,1641250,226000,1415250
4893,7625,Ranveer Pranayraj Govindbhai,KHEDA,Bahujan Mukti Party,0,Graduate Professional,642900,53000,589900
4894,2005,Ranvir Khobra,SIRSA,IND,0,Graduate,7896000,1450000,6446000
4895,6470,Rapelli Srinivas,NIZAMABAD,AAP,0,10th Pass,324695,0,324695
4896,5874,Rasal Shashikant Dada,KALYAN,IND,0,8th Pass,70000,0,70000
4897,7077,Rasavelu.K,MAYILADUTHURAI,BSP,3,Graduate,12500,0,12500
4898,2266,Rashid Ahmed Laskar,SILCHAR,SP,0,12th Pass,785000,0,785000
4899,3204,Rashid Hussain,SAMBHAL,IND,5,Literate,5907000,1000000,4907000
4900,7889,Rashid Shareef,HYDERABAD,TRS,0,8th Pass,9901000,0,9901000
4901,7323,Rashidkhan Hasankhan Pathan,BHAVNAGAR,IND,0,8th Pass,50000,0,50000
4902,1374,Rashmi Kashyap,CHANDNI CHOWK,Bhartiya Pragatisheel Congress,0,10th Pass,3123000,0,3123000
4903,167,Ratan Chakraborti,TRIPURA WEST,AITC,0,Graduate,3314729,0,3314729
4904,5919,Ratan Devram Bodake,MUMBAI SOUTH,IND,0,10th Pass,6560000,0,6560000
4905,2424,Ratan Lal Dhobi,BHILWARA,IND,0,Literate,1000,0,1000
4906,1742,Ratan Singh,SAHARANPUR,Bahujan Mukti Party,0,Others,46134617,0,46134617
4907,5347,Ratansinh Udesinh Chauhan,KHEDA,IND,0,10th Pass,2680000,0,2680000
4908,1348,Ratheesh,NEW DELHI,IND,0,Graduate,45200,0,45200
4909,1949,Ratheesh Perumal,KOTTAYAM,IND,0,10th Pass,1000,0,1000
4910,3815,Rathi Poovaiah,MYSORE,Karunaadu Party,0,Graduate,410000,0,410000
4911,7534,Rathinavelu,VIRUDHUNAGAR,DMK,0,Graduate Professional,91534108,4384420,87149688
4912,5649,Rathod Babusingh Vasram,THANE,Maharashtra Parivartan Sena (T),0,Not Given,100000,0,100000
4913,1510,Rathod Baliram Parashram,YAVATMAL-WASHIM,BSP,0,Graduate Professional,26249301,2106000,24143301
4914,6516,Rathod Bhavsinhbhai Dahyabhai,PATAN,INC,0,Literate,6163441,3019000,3144441
4915,4911,Rathod Chandulal Mohanlal,PORBANDAR,IND,1,5th Pass,66000,0,66000
4916,6552,Rathod Dipsinh Shankarsinh,SABARKANTHA,BJP,0,8th Pass,20700176,417585,20282591
4917,1500,Rathod Induwar Kashiram,YAVATMAL-WASHIM,Bahujan Mukti Party,0,12th Pass,5950000,210000,5740000
4918,7274,Rathod Jivanbhai Rajabhai,AMRELI,RPI(A),0,12th Pass,256000,0,256000
4919,1515,Rathod Mohan Mallu,YAVATMAL-WASHIM,Bharipa Bahujan Mahasangh,0,Post Graduate,34013105,1750000,32263105
4920,1517,Rathod Naresh Fulsing,YAVATMAL-WASHIM,AAP,0,Graduate Professional,2030000,0,2030000
4921,7321,Rathod Pravinsinh Chandrasinh,BHAVNAGAR,IND,0,10th Pass,285000,0,285000
4922,5861,Rathod Ramesh Lalsing,JALNA,Bahujan Mukti Party,0,10th Pass,1958026,81000,1877026
4923,7676,Rathod Sadashiv,ADILABAD,BSP,0,Graduate,1405000,0,1405000
4924,4588,Rathwa Ramsingbhai Patalbhai,CHHOTA UDAIPUR,BJP,0,Post Graduate,39769675,9763903,30005772
4925,6732,Ratiram,RAE BARELI,Samtawadi Republican Party,0,Graduate Professional,7449323,0,7449323
4926,6036,Ratna De,HOOGHLY,AITC,0,Post Graduate,18617758,0,18617758
4927,6244,Ratneshwar Jha,MADHUBANI,Akhil Bhartiya Mithila Party,0,12th Pass,1214000,0,1214000
4928,89,Rattan Lal Kataria,AMBALA,BJP,0,Post Graduate,42150634,843229,41307405
4929,6097,Rattan Singh Randhawa,AMRITSAR,IND,0,Post Graduate,4201500,244000,3957500
4930,4447,Ratul Kumar Choudhury,MANGALDOI,SP,1,Graduate,780000,80000,700000
4931,322,Raut Jaganath Nilkanth,WARDHA,IND,0,Graduate Professional,5940000,0,5940000
4932,7304,Ravaliben Shankarbhai Chaudhari,BARDOLI,CPI,0,10th Pass,8475030,1500000,6975030
4933,7180,Ravi .K,RAMANATHAPURAM,IND,0,5th Pass,75000,0,75000
4934,1396,Ravi Alias Shailesh Ganeshrao Yelne,WARDHA,IND,0,Graduate,1671754,0,1671754
4935,6697,Ravi Dubey,LUCKNOW,Nagrik Ekta Party,2,5th Pass,185000,0,185000
4936,7737,Ravi Dutt,HOSHIARPUR,IND,0,12th Pass,2362000,0,2362000
4937,3442,Ravi Garg,JODHPUR,Bharat Nav Nirman Party,0,12th Pass,1382000,0,1382000
4938,858,Ravi Krishna Reddy,BANGALORE RURAL,AAP,0,Post Graduate,54433258,0,54433258
4939,1346,Ravi Kumar Gupta,NEW DELHI,IND,0,12th Pass,17057930,15000,17042930
4940,1071,Ravi Menasinakai,HAVERI,JD(S),0,Graduate Professional,21964323,2395704,19568619
4941,1980,Ravi Naik,NORTH GOA,INC,0,Post Graduate,81066000,3126000,77940000
4942,6901,Ravi Pariyanar. D,CHENNAI NORTH,IND,0,10th Pass,100000,0,100000
4943,3105,Ravi Prakash Verma,KHERI,SP,1,Graduate Professional,8213389,18800,8194589
4944,4766,Ravi Sirwaiya,INDORE,IND,0,12th Pass,256000,0,256000
4945,6276,"Ravi, N.D.",ARAKKONAM,IND,0,Illiterate,55000,0,55000
4946,7054,"Ravi, S.P.",KARUR,IND,0,Graduate Professional,392000,0,392000
4947,6266,"Ravi, V.",ARAKKONAM,IND,0,12th Pass,281800,0,281800
4948,7440,Ravi.P,TIRUCHIRAPPALLI,AAP,1,Post Graduate,137774,81869,55905
4949,363,Ravikant Chaudhary,SASARAM,IND,0,10th Pass,225500,0,225500
4950,7364,Ravikumar. D,TIRUVALLUR,Viduthalal Chiruthaigal Katchi,1,Post Graduate,5886482,2472629,3413853
4951,6900,Ravikumar. T,CHENNAI NORTH,IND,0,Graduate Professional,1128300,0,1128300
4952,7368,Ravikumar.M,TIRUVALLUR,IND,0,12th Pass,160000,0,160000
4953,3745,Ravikumara T,BANGALORE SOUTH,SP,0,Graduate Professional,25140,28000,0
4954,1277,Ravinder,FARIDABAD,Akhil Bharat Hindu Mahasabha,0,12th Pass,327600,0,327600
4955,1271,Ravinder Kumar,ROHTAK,Indian Bahujan Sandesh Party (Kanshiram),0,12th Pass,1245000,0,1245000
4956,1709,Ravinder Sharma,GAUTAM BUDHHA NAGAR,Rashtriya Kranti Party,0,8th Pass,5992835,0,5992835
4957,7857,Ravinder Singh,PATIALA,Bharatiya Sant Mat Party,0,12th Pass,2053000,550000,1503000
4958,3387,Ravindra Bhimrao Takale,BARAMATI,Bahujan Mukti Party,2,Graduate,294748,0,294748
4959,3368,Ravindra Kashinath Patil,MAVAL,IND,1,Graduate Professional,10563000,0,10563000
4960,2676,Ravindra Kumar,JAHANABAD,BSP,1,Graduate,1252000,0,1252000
4961,3158,Ravindra Kumar Devnath,PILIBHIT,IND,0,Graduate,2495450,0,2495450
4962,2814,Ravindra Kumar Pandey,GIRIDIH,BJP,0,Graduate,73376970,1970628,71406342
4963,1266,Ravindra Kumar Ravi,PALAMAU,IND,0,12th Pass,200000,0,200000
4964,47,Ravindra Kumar Ray,KODARMA,BJP,0,Doctorate,10564046,200000,10364046
4965,4257,Ravindra Singh,AGRA,AAP,0,Post Graduate,6501178,1500000,5001178
4966,5459,Ravindran T,TIRUVANNAMALAI,Tamil Nadu Makkal Congress,0,10th Pass,280000,114000,166000
4967,1378,Ravindrasing Ramsing Pawar,BULDHANA,Lok Bharati,0,12th Pass,160000,0,160000
4968,7751,Ravneet Singh Bittu,LUDHIANA,INC,0,12th Pass,31509170,192000,31317170
4969,7641,Ravshaheb Bhimrav Patil (Bandhu),NAVSARI,IND,0,12th Pass,2871000,0,2871000
4970,6381,Ravulapally Kondal Rao,BHONGIR,Pyramid Party of India,0,Post Graduate,3480000,0,3480000
4971,6224,Reddi Malla Srinivas,KARIMNAGAR,RPI(A),1,Graduate Professional,1760000,0,1760000
4972,607,Reddy G K C,CHIKKBALLAPUR,JD(U),0,Doctorate,6302974,0,6302974
4973,3076,Reena,BADAUN,Rashtriya Samanta Dal,0,Post Graduate,93856,0,93856
4974,6716,Reena Chaudhary,MOHANLALGANJ,Bahujan Sangharsh Party (Kanshiram),0,Post Graduate,892565,0,892565
4975,6134,Reena Kumari,FARIDKOT,IND,0,Illiterate,468268,0,468268
4976,3214,Reeta Singh Urf Reeta Bharti,SHAHJAHANPUR,AAP,0,Graduate,591671,154000,437671
4977,6206,Regatte Venkat Reddy,CHEVELLA,AAP,0,Others,30648743,1700000,28948743
4978,6095,Rehmat Masih,AMRITSAR,IND,0,10th Pass,1710000,0,1710000
4979,2256,Rejamond Ali Barbhuiya,SILCHAR,CPI(M),0,Graduate Professional,1164212,0,1164212
4980,5499,Rekha,DHAURAHRA,BJP,0,10th Pass,10435468,2375000,8060468
4981,6068,Rekha Das,ULUBERIA,BSP,0,8th Pass,27477,0,27477
4982,3195,Rekha Devi Yadav,SAMBHAL,Sanyukt Samajwadi Dal,0,Not Given,202000,0,202000
4983,7130,"Rengaraju, M.",PERAMBALUR,IND,0,8th Pass,1350950,0,1350950
4984,7302,Reniyabhai Shankarbhai Chaudhari,BARDOLI,Hindusthan Nirman Dal,0,Graduate,2184640,200000,1984640
4985,1766,Renuka Sinha,COOCHBEHAR,AITC,0,Graduate Professional,13017282,0,13017282
4986,7741,Resham Kahlon,ANANDPUR SAHIB,Bahujan Sangharshh Dal,0,8th Pass,470500,0,470500
4987,2443,Resham Malviya,BANSWARA,INC,0,12th Pass,25370874,6079932,19290942
4988,1063,Revasing Loku,GULBARGA,BJP,0,5th Pass,33293923,3500000,29793923
4989,7091,Revathi.A,MAYILADUTHURAI,IND,0,10th Pass,6097180,3045000,3052180
4990,403,Ribulaya Gogoi,JORHAT,AITC,0,10th Pass,1383171,0,1383171
4991,539,Richard D. Shabong,SHILLONG,CPI,0,12th Pass,1328273,0,1328273
4992,5414,Rijhendra Dahariya,RAIPUR,IND,0,10th Pass,180000,0,180000
4993,7246,Rina Mahendrakumar Zaveri,MUMBAI NORTH WEST,IND,0,Graduate Professional,4591000,50000,4541000
4994,4469,Rinki Kumari,BHAGALPUR,CPI(ML)L,7,Post Graduate,22192,0,22192
4995,1674,Rinku Kumar Tyagi,GHAZIABAD,IND,0,Others,31501000,4000000,27501000
4996,2241,Rinku Malakar,KARIMGANJ,SP,0,8th Pass,533500,13000,520500
4997,381,Rita Devi,AURANGABAD,SP,0,10th Pass,5136715,800000,4336715
4998,3255,Rita Tarai,JAJPUR,BJD,0,12th Pass,1622003,0,1622003
4999,741,Riti Pathak,SIDHI,BJP,0,Post Graduate,33416561,0,33416561
5000,4705,Ritu Rani Singh,DHANBAD,IND,2,10th Pass,1260459,728268,532191
5001,6812,Riyaz Ahmed Wani,SRINAGAR,IND,0,Graduate,30000,0,30000
5002,609,Rizwan Arshad,BANGALORE CENTRAL,INC,2,Graduate,31400000,0,31400000
5003,1179,Robert Romawia Royte,MIZORAM,IND,0,Post Graduate,346499910,0,346499910
5004,1099,Robin Mathews Narekattu,CHIKKBALLAPUR,SP,0,Post Graduate,251460907,97836250,153624657
5005,1241,Robin Singh,CHATRA,IND,0,10th Pass,6430000,0,6430000
5006,2998,Rod Ji,RAJGARH,IND,0,Literate,676000,0,676000
5007,2993,Rodmal Nagar,RAJGARH,BJP,0,Graduate,28569974,3586473,24983501
5008,4323,Rohan Singh,FATEHPUR SIKRI,Bahujan Mukti Party,0,5th Pass,1668371,0,1668371
5009,3591,Rohan Subhash Deshmukh,OSMANABAD,IND,0,Graduate,7275515,7510376,0
5010,7642,Rohit Gandhi,NAVSARI,IND,0,Graduate,14778143,600000,14178143
5011,4909,Rohit Madhusudan Mohanbhai,VADODARA,BSP,0,12th Pass,4795000,130000,4665000
5012,7665,Rohit Maingi,GURDASPUR,IND,0,12th Pass,1239600,0,1239600
5013,4561,Rohit Rajubhai Virjibhai,AHMEDABAD EAST,BSP,2,12th Pass,358900,185000,173900
5014,3584,Rohit Ramrushna More,MADHA,IND,0,Graduate Professional,342105,842166,0
5015,6538,Rohitbhai Mohanbhai Sagathiya,RAJKOT,Bahujan Mukti Party,0,Post Graduate,104000,238106,0
5016,3607,Rokade Milind Somnath,OSMANABAD,Bharipa Bahujan Mahasangh,0,Post Graduate,1112500,226000,886500
5017,5817,Roop Narayan Singh,UNNAO,IND,0,10th Pass,2600000,0,2600000
5018,3126,Roopa Chandra Singh,MORADABAD,IND,0,10th Pass,7677881,21833,7656048
5019,1002,Roshan Ali,NORTH EAST DELHI,National Loktantrik Party,0,Not Given,3351382,0,3351382
5020,3217,Roshan Lal Urf Roshan Kanaujia,SHAHJAHANPUR,IND,0,Graduate Professional,991198,0,991198
5021,4558,Roshan Priyavadan Shah,AHMEDABAD EAST,IND,0,Graduate Professional,27560000,800000,26760000
5022,5349,Roshan Priyvadan Shah,KHEDA,IND,0,Graduate Professional,27560000,807000,26753000
5023,3850,Rothod Digambar Ramrao,BEED,BSP,0,Graduate,11325000,1060000,10265000
5024,307,Roy Arackal,KOTTAYAM,SDPI,0,10th Pass,513300,0,513300
5025,1345,Rubina Khan,NEW DELHI,IND,0,Graduate,602439,0,602439
5026,1282,Ruby Yadav,SOUTH DELHI,IND,0,Post Graduate,10797222,0,10797222
5027,3265,Rudranarayan Pany,DHENKANAL,BJP,5,Graduate,267145,0,267145
5028,3778,Rudregowda,HASSAN,Jai Vijaya Bharathi Party,0,Graduate Professional,3640000,1450000,2190000
5029,1842,Rudresh Dayappa Dodamani,BIJAPUR,IND,0,Post Graduate,2090000,400000,1690000
5030,2178,Rudresh Ramanna Hadagali,HAVERI,IND,0,Graduate,4006360,176924,3829436
5031,3449,Rugha Ram Choudhary Advocate,JODHPUR,IND,0,Graduate Professional,4180402,0,4180402
5032,4236,Rukmani,DAUSA,Socialist Party (India),0,Literate,2767391,175000,2592391
5033,5514,Rukmani Devi,FATEHPUR,Pragatisheel Manav Samaj Party,0,Literate,1130000,0,1130000
5034,1663,Ruksana,BAGHPAT,IND,0,Illiterate,562000,0,562000
5035,3635,Rupali Tamboli,PUNE,IND,0,Graduate,14136754,1950000,12186754
5036,3906,Rupanand Soi,MAHASAMUND,IND,0,12th Pass,185433,0,185433
5037,2892,Rupsingh Hembrom,SINGHBHUM,IND,0,10th Pass,4305000,0,4305000
5038,3742,Ruth Manorama,BANGALORE SOUTH,JD(S),0,Post Graduate,14950943,1189000,13761943
5039,1703,Ruvez Alam Rahi,GAUTAM BUDHHA NAGAR,National Loktantrik Party,0,12th Pass,337000,0,337000
5040,2164,S Bheemappa,BELLARY,CPI(ML) Red star,0,8th Pass,18900,0,18900
5041,7887,S Krishna Reddy,HYDERABAD,INC,0,Graduate,25397000,369391,25027609
5042,2548,S P Mahadevappa,MYSORE,JD(U),0,10th Pass,925000,150000,775000
5043,4054,S Periyakaruppan,SIVAGANGA,IND,0,10th Pass,4190000,1566338,2623662
5044,1969,S Radhakrishnan,PATHANAMTHITTA,IND,0,12th Pass,1875000,0,1875000
5045,1959,S Radhamani,PATHANAMTHITTA,SUCI(C),0,Graduate,16880,0,16880
5046,601,S S Mallikarjun,DAVANAGERE,INC,6,Graduate,645637999,66208771,579429228
5047,6935,S. Balamurali,CHENNAI SOUTH,IND,0,Graduate,289100,0,289100
5048,6915,S. Balu,CHENNAI SOUTH,IND,0,Graduate Professional,845000,263732,581268
5049,3432,S. Buta Singh,JALORE,IND,0,Doctorate,59509479,1132860,58376619
5050,6478,S. Chandraiah,NIZAMABAD,IND,0,Graduate,2116000,500,2115500
5051,6945,S. Charumathi,CHENNAI SOUTH,IND,0,8th Pass,850000,0,850000
5052,5585,S. Chitrakala,PONDICHERRY,JD(U),0,Graduate,5255000,1460000,3795000
5053,6924,S. Devadoss,CHENNAI SOUTH,IND,0,12th Pass,25000,0,25000
5054,5573,S. Ezhilarasan,PONDICHERRY,IND,0,Graduate,70500,30000,40500
5055,3760,S. Govinda Nayaka,CHAMARAJANAGAR,IND,0,10th Pass,2151000,100000,2051000
5056,4064,S. Krishnamoorthy,PONDICHERRY,BSP,0,8th Pass,990200,10000,980200
5057,6432,S. Lakshman Rao,SECUNDERABAD,IND,0,Graduate Professional,424203,0,424203
5058,2589,S. Meetyanaik,CHITRADURGA,SP,0,Graduate,890000,100000,790000
5059,6927,S. Parthiban,CHENNAI SOUTH,IND,0,10th Pass,14805512,0,14805512
5060,6941,S. Pragasam,CHENNAI SOUTH,IND,0,Graduate Professional,10902944,0,10902944
5061,3930,S. Rajendran,VILUPPURAM,AIADMK,0,Graduate,6200000,2371331,3828669
5062,6936,S. Rajeshwari,CHENNAI SOUTH,IND,0,5th Pass,0,0,0
5063,5569,S. Sanjivganthi,PONDICHERRY,IND,0,Graduate Professional,750,0,750
5064,2221,S. Satish Salian,SHIMOGA,IND,0,12th Pass,617300,80750,536550
5065,6925,S. Seethalakshmi,CHENNAI SOUTH,Tamil Nadu Makkal Congress,0,Doctorate,4180000,1900000,2280000
5066,6946,S. Sesu Raj,CHENNAI SOUTH,IND,0,Others,500000,50000,450000
5067,7928,S. Shiva Shankar,MAHBUBNAGAR,IND,0,Post Graduate,1214200,0,1214200
5068,5579,S. Sudarsanan,PONDICHERRY,IND,0,8th Pass,261000,0,261000
5069,6937,S. Veeramani,CHENNAI SOUTH,IND,0,Post Graduate,2242000,0,2242000
5070,7498,S.Arivudainambi,MADURAI,IND,0,Graduate Professional,261000,0,261000
5071,3782,S.B. Rajegowda,HASSAN,IND,0,Others,25000,0,25000
5072,1952,S.B.Basheer,ALAPPUZHA,IND,0,5th Pass,50000,0,50000
5073,2577,S.B.Hanumantharayappa,TUMKUR,IND,0,12th Pass,787507,0,787507
5074,6845,S.D. Krishnakumar,CHENNAI CENTRAL,RPI(A),0,12th Pass,1960000,822000,1138000
5075,5465,S.Devi,VILUPPURAM,IND,8,10th Pass,5575000,1200000,4375000
5076,6294,S.Elumalai,ARANI,IND,0,5th Pass,6362653,0,6362653
5077,7497,S.Ganesan,MADURAI,IND,0,10th Pass,230000,0,230000
5078,3835,S.Girija,CUDDALORE,IND,0,Post Graduate,370000,0,370000
5079,7429,S.K.Dineshkumar,TIRUPPUR,IND,0,10th Pass,92000,0,92000
5080,7891,S.Khaja Moinuddin,HYDERABAD,All India Azaad Congress Party,0,Graduate,3020000,150000,2870000
5081,4288,S.Lakshmanan,KALLAKURICHI,IND,0,8th Pass,575000,0,575000
5082,6365,S.Madhaiyan,KALLAKURICHI,IND,0,Illiterate,550000,44000,506000
5083,4334,S.Manickavasagam,MADURAI,IND,0,Illiterate,20000,0,20000
5084,6301,S.Manikandan,ARANI,IND,0,12th Pass,165324,0,165324
5085,3781,S.N. Mallappa,HASSAN,IND,0,12th Pass,3765750,255000,3510750
5086,4043,S.Natarajan,TIRUCHIRAPPALLI,BSP,0,12th Pass,6585500,1050000,5535500
5087,605,S.P.Muddahanumegowda,TUMKUR,INC,0,Graduate Professional,30273812,0,30273812
5088,4665,S.R. Anchal,KORBA,IND,0,Post Graduate,230000,0,230000
5089,6846,S.R. Vijayakumar,CHENNAI CENTRAL,AIADMK,0,Graduate Professional,13401510,350483,13051027
5090,7925,S.R.Premaiah,MAHBUBNAGAR,Pyramid Party of India,0,12th Pass,611000,0,611000
5091,6305,S.Ramamoorthy,ARANI,IND,0,10th Pass,230000,0,230000
5092,3993,S.S. Subhan Khan,DAVANAGERE,IND,0,Post Graduate,76000,0,76000
5093,6922,S.S.Radhakrishnan,CHENNAI SOUTH,IND,0,Post Graduate,42980572,1359520,41621052
5094,6362,S.Sakthivel,KALLAKURICHI,BSP,0,Others,1355000,0,1355000
5095,6298,S.Senthilnathan,ARANI,IND,0,Post Graduate,6676752,1837784,4838968
5096,2523,S.Siddaramaiah Heggade,BANGALORE RURAL,IND,1,12th Pass,477000,0,477000
5097,4045,S.Sridhar,TIRUCHIRAPPALLI,CPI(M),0,Post Graduate,199925,89859,110066
5098,6938,S.V. Ramani,CHENNAI SOUTH,INC,0,Graduate,1598751,255309,1343442
5099,2816,Saba Ahmad,GIRIDIH,JVM(P),1,Graduate Professional,5820782,0,5820782
5100,4443,Sabda Ram Rabha,KOKRAJHAR,IND,0,Graduate Professional,3607000,0,3607000
5101,1681,Sabir,GHAZIABAD,IND,0,Others,1836155,16555,1819600
5102,7237,Sabir Mehandi Hasan,MUMBAI NORTH EAST,IND,0,5th Pass,11506000,500000,11006000
5103,6065,Sabir Uddin Molla,ULUBERIA,CPI(M),0,Graduate,178532,0,178532
5104,5944,Sable Namdev Sahebrao,MUMBAI SOUTH CENTRAL,IND,0,Graduate,6935466,1259570,5675896
5105,708,Sabu Varghese,IDUKKI,BJP,0,Graduate Professional,9755000,386540,9368460
5106,2242,Sabuj Das,KARIMGANJ,IND,0,10th Pass,332000,0,332000
5107,1960,Sabukutty Joy (Sabu Puthuchera),PATHANAMTHITTA,Social Action Party,1,Post Graduate,21739967,2025000,19714967
5108,3277,Sabyasachi Mahapatra,CUTTACK,CPI(ML) Red star,0,Graduate,600,0,600
5109,3336,Sabyasachi Mohapatra,PURI,Kalinga Sena,0,Graduate Professional,484637,21840,462797
5110,7344,Sachada Habib Ishabhai,JAMNAGAR,IND,1,Illiterate,1031045,0,1031045
5111,7258,Sachin Damodar Shingda,PALGHAR,IND,0,10th Pass,42874357,5223972,37650385
5112,5920,Sachin Narayan Pawar,MUMBAI SOUTH,Bahujan Mukti Party,0,12th Pass,914709,0,914709
5113,1401,Sachin Pandurangji Raut Alias Gurubhau,WARDHA,IND,0,12th Pass,600000,0,600000
5114,3411,Sachin Pilot,AJMER,INC,0,Post Graduate,53934000,0,53934000
5115,4984,Sachin Singh,FARRUKHABAD,IND,1,Graduate,30876925,895209,29981716
5116,2500,Sachintra Debbarma,TRIPURA EAST,INC,0,Graduate Professional,28560336,0,28560336
5117,2197,Sadanand Deshbhandari,UTTARA KANNADA,IND,0,Graduate,3348114,598550,2749564
5118,3990,Sadhan Chatterjee,MALDAHA DAKSHIN,IND,0,Graduate Professional,14981015,0,14981015
5119,5512,Sadhavi Niranjan Jyoti,FATEHPUR,BJP,1,12th Pass,4123779,176616,3947163
5120,6274,"Sadhu Muthu Kristnan Erajandran, T.M.S.",ARAKKONAM,IND,0,Doctorate,0,0,0
5121,6138,Sadhu Singh,FATEHGARH SAHIB,INC,0,10th Pass,7335200,0,7335200
5122,4901,Sadia Vrajalal Pababhai,PORBANDAR,BSP,0,Graduate,1672300,184409,1487891
5123,6173,"Sadre Alam Khan,",DARBHANGA,Akhil Bhartiya Mithila Party,0,10th Pass,1726698,0,1726698
5124,3886,Sadulla Asdulla Inamdar,BEED,IND,0,10th Pass,200000,0,200000
5125,151,Safdar Ismail,NAWADA,IND,0,Graduate Professional,8605000,25000,8580000
5126,7351,Safiya Mamadbhai Hajibhai,JAMNAGAR,IND,0,5th Pass,36000,0,36000
5127,1712,Safruddin,GAUTAM BUDHHA NAGAR,IND,0,10th Pass,17029000,0,17029000
5128,1229,Sagar Ram,CHATRA,Akhil Bharat Hindu Mahasabha,0,Literate,700000,0,700000
5129,802,Sagar Singh Manaki,SUNDARGARH,Kosal Kranti Dal,0,Graduate,5069000,0,5069000
5130,6472,Sagar Suddala,NIZAMABAD,Bahujan Mukti Party,0,Graduate,90000,0,90000
5131,532,Sahaba Ahmed,KALIABOR,IND,0,Graduate Professional,10104000,0,10104000
5132,5783,Sahadat Ali Khan,RAE BARELI,IND,0,Not Given,1200000,0,1200000
5133,4723,Sahadeo Soren,DUMKA,AAP,0,Post Graduate,10977580,0,10977580
5134,4449,Sahadev Das,MANGALDOI,BPF,0,Post Graduate,1036784,0,1036784
5135,1156,Sahadev Jal,KALAHANDI,Bahujan Mukti Party,0,Graduate,1199800,0,1199800
5136,6729,Sahar Naqvi,RAE BARELI,Lok Dal,0,Graduate,173000,0,173000
5137,749,Sahdev Singh Paraste,SHAHDOL,National Peoples Party,0,Post Graduate,1586000,150000,1436000
5138,4886,Sahnur Ali,MANGALDOI,IND,0,10th Pass,2001874,215000,1786874
5139,3914,Sahukar Bhaskar,RAJNANDGAON,IND,0,8th Pass,2335477,150000,2185477
5140,5337,Saiyad Abubakar Ibrahim,JAMNAGAR,SP,0,5th Pass,1468000,14000,1454000
5141,7354,Saiyad Altafhusen Abdullahmiya,JUNAGADH,IND,0,5th Pass,251000,0,251000
5142,5308,Saiyad Mohsinmiya Hedarmiya,BHARUCH,Bahujan Mukti Party,0,8th Pass,2135000,0,2135000
5143,4895,Saiyed Mehmood Ahmed,NAVSARI,IND,0,10th Pass,102000,0,102000
5144,3380,Saiyyad Afser Ibrahim,PUNE,SP,0,8th Pass,80991201,619000,80372201
5145,6037,Sajal Adhikari,HOOGHLY,CPI(ML)L,0,Post Graduate,1416000,0,1416000
5146,6793,Sajal Das,BIRBHUM,Bahujan Mukti Party,1,Graduate,53733,0,53733
5147,6802,Sajal Kumar Das,HOWRAH,IND,0,12th Pass,89469,0,89469
5148,2243,Sajalendu Malakar,KARIMGANJ,IND,0,10th Pass,417000,0,417000
5149,6784,Sajan Kumar Jha,MADHEPURA,Jai Maha Bharath Party,0,Graduate,3228000,25000,3203000
5150,4760,Sajan Singh,DEWAS,IND,0,5th Pass,320000,0,320000
5151,1925,Saji Thuruthikunnel,CHALAKUDY,SHS,3,12th Pass,3017995,1206000,1811995
5152,4024,Sajiya Haidar,RANCHI,IND,0,12th Pass,22851217,6348982,16502235
5153,2825,Sajjadur Rab Hasami,GIRIDIH,IND,0,12th Pass,550000,0,550000
5154,453,Sajjan Singh,ROHTAK,IND,0,Illiterate,2761000,250000,2511000
5155,4755,Sajjan Singh Verma,DEWAS,INC,0,Post Graduate,65670004,250694,65419310
5156,7193,Sakharam Pandurang Dunghav,MUMBAI NORTH,Maharashtra Parivartan Sena (T),0,10th Pass,50000,0,50000
5157,6726,Sakil Ahmad,RAE BARELI,IND,0,8th Pass,155000,0,155000
5158,3860,Saksamudre Bhagwan Kachruba,BEED,Bahujan Mukti Party,0,Others,2407094,535000,1872094
5159,6440,Sakthi Satyavathi,SECUNDERABAD,Pyramid Party of India,0,10th Pass,71000,0,71000
5160,4294,Sakthivel S,SALEM,IND,0,8th Pass,3100000,0,3100000
5161,5683,Sakthivel.S.P,NAMAKKAL,IND,0,5th Pass,1265000,0,1265000
5162,5821,Saktimohan Malik,ARAMBAG,CPI(M),1,Post Graduate,8292881,0,8292881
5163,3220,Sakuntala Laguri,KEONJHAR,BJD,0,10th Pass,101531625,0,101531625
5164,5709,Saleem Ahmad,KANPUR,BSP,0,Graduate,18452369,2862168,15590201
5165,2171,Saleem Azeez Ahmed,HAVERI,INC,0,Post Graduate,59573517,0,59573517
5166,3057,Saleem Iqbal Shervani,AONLA,INC,7,Graduate,353932000,0,353932000
5167,1682,Saleem Malik,GHAZIABAD,IND,0,8th Pass,10000,0,10000
5168,4510,Salik Ram Jogi,BILASPUR,IND,0,Post Graduate,650000,67000,583000
5169,525,Salil Saha,TRIPURA WEST,AAP,0,Post Graduate,41153192,1973987,39179205
5170,2322,Salim Gujar,CHURU,IND,0,Literate,201000,0,201000
5171,2888,Salkhan Murmu,SINGHBHUM,Jharkhand Disom Party,3,Post Graduate,6252094,500000,5752094
5172,3333,Salma Shriniwas Kulkarni,PARBHANI,AAP,0,Post Graduate,1956452,470000,1486452
5173,5651,Salman Ajimullah Hasmi,THANE,Rashtriya Aam Party,0,8th Pass,877400,0,877400
5174,4313,Salman Khursheed,FARRUKHABAD,INC,0,Post Graduate,123886145,2855000,121031145
5175,170,Sam P Mathew,WAYANAD,CPI(ML) Red star,4,12th Pass,1934280,0,1934280
5176,5338,Sama Yusuf,JAMNAGAR,BSP,1,8th Pass,383200,40125,343075
5177,6385,Samala Ravinder,CHEVELLA,BSP,0,Post Graduate,1400000,600000,800000
5178,1789,Saman Pathak,DARJEELING,CPI(M),4,Graduate,1959732,2142,1957590
5179,4157,Samaresh Singh,DHANBAD,JVM(P),15,10th Pass,9949808,672954,9276854
5180,1379,Sambare Dinkar Tukaram,BULDHANA,IND,0,10th Pass,10000,0,10000
5181,6989,Sambath.M,DHARMAPURI,IND,0,8th Pass,485060,0,485060
5182,5213,Sambhaji Devidas Patil,DHULE,Bahujan Mukti Party,0,8th Pass,932080,0,932080
5183,5820,Sambhunath Malik,ARAMBAG,INC,0,Post Graduate,6425000,0,6425000
5184,3280,Samir Dey,CUTTACK,BJP,1,Graduate Professional,19960747,6719742,13241005
5185,6034,Samiran Das,BOLPUR,BSP,0,10th Pass,100000,0,100000
5186,1267,Sampat Singh,HISAR,INC,0,Post Graduate,62661560,14371778,48289782
5187,1205,Sampath Kumar,CHAMARAJANAGAR,AAP,0,Graduate Professional,20951240,2190000,18761240
5188,7383,Sampath. K. Thiru,SRIPERUMBUDUR,IND,0,Graduate,95596,28500,67096
5189,1089,Sampathu N,MYSORE,IND,0,Graduate Professional,16127000,1200000,14927000
5190,3537,Sampatrao Shamrao Pawar Patil,KOLHAPUR,Peasants And Workers Party of India,2,Graduate,11600046,2192330,9407716
5191,5134,Sampatti Bai Alias Sunita Verma,TONK-SAWAI MADHOPUR,IND,0,10th Pass,950500,0,950500
5192,7794,Sampuran Singh,FIROZPUR,IND,0,12th Pass,1287246,0,1287246
5193,3822,Samrat Ghosh,JANGIPUR,BJP,0,Graduate Professional,3771352,1250000,2521352
5194,2062,Samser,BHIWANI-MAHENDRAGARH,National Loktantrik Party,0,Literate,161000,0,161000
5195,529,Samsul Alam,KALIABOR,AITC,0,Graduate,605000,0,605000
5196,4858,Samsul Hoque,BARPETA,IND,0,8th Pass,732000,0,732000
5197,7556,Samuel. A.S.,THOOTHUKKUDI,IND,0,Literate,150000,0,150000
5198,7964,Sanapa Pommaiah,KHAMMAM,IND,0,Not Given,50000,0,50000
5199,1549,Sanat Kumar Tripathi,SIDHI,Bhartiya Shakti Chetna Party,1,12th Pass,1615000,0,1615000
5200,2696,Sandeep,MUNGER,AAP,0,Graduate Professional,5790000,750000,5040000
5201,493,Sandeep Dikshit,EAST DELHI,INC,0,Post Graduate,73671067,8872174,64798893
5202,3545,Sandeep Gundopant Sankpal,KOLHAPUR,IND,0,10th Pass,419925,8410,411515
5203,3124,Sandeep Kumar,MORADABAD,Sarva Samaj Kalyan Party,0,Graduate,1160000,0,1160000
5204,6005,Sandeep Pandurang Parte,RAIGAD,Hindustan Janta Party,0,Literate,271966000,203000,271763000
5205,1589,Sandeep Soni,BALAGHAT,IND,1,Graduate,31006,0,31006
5206,5415,Sandeep Tiwari,RAIPUR,AAP,1,Post Graduate,950818,0,950818
5207,1387,Sandesh Ashok Ambedkar,BULDHANA,Bahujan Mukti Party,0,Post Graduate,1280500,0,1280500
5208,941,Sandesh Bhivram Bhalekar,RAMTEK,AIFB,0,Graduate Professional,1003000,0,1003000
5209,3672,Sandip Amrutrao Mozar,SATARA,IND,10,Graduate Professional,6204277,1745000,4459277
5210,1108,Sandip Kisanrao Wankhede,AKOLA,IND,0,Graduate,50000,0,50000
5211,5321,Sandis Mavjibhai Laxmanbhai,SURAT,IND,0,10th Pass,81575,0,81575
5212,7334,Sangada Kumari Induben Nathubhai,DAHOD,IND,0,12th Pass,10000,0,10000
5213,5293,Sangani Vijaybhai Dineshbhai,AMRELI,Yuva Sarkar,0,8th Pass,575000,0,575000
5214,1186,Sanganna A. Karadi,KOPPAL,BJP,1,10th Pass,12127000,6848000,5279000
5215,806,Sangeeta Kumari Singh Deo,BOLANGIR,BJP,3,Graduate,62357000,3817340,58539660
5216,6795,Sanghamitra Mukherjee,HOOGHLY,Rashtriya Janasachetan Party (R.J.P.),0,12th Pass,132000,0,132000
5217,5935,Sanghapal Hirachand Gadekar,MUMBAI SOUTH CENTRAL,Ambedkarite Party of India,0,Graduate,42083,0,42083
5218,4415,Sanghmitra Maurya,MAINPURI,BSP,1,Graduate Professional,17494581,0,17494581
5219,3249,Sangram Keshari Jena,BHADRAK,INC,5,Post Graduate,10108428,23025000,0
5220,6387,Sanike Ram Gopal Yadav,CHEVELLA,IND,0,10th Pass,2115500,494000,1621500
5221,4747,Saniram Hembrom,RAJMAHAL,IND,0,10th Pass,1090000,0,1090000
5222,2054,Sanjay,SONIPAT,IND,0,10th Pass,15800000,0,15800000
5223,790,Sanjay Bhoi,BARGARH,INC,0,Graduate,25786368,3000000,22786368
5224,2462,Sanjay Choudhary,RAJSAMAND,IND,0,Graduate,9990000,420000,9570000
5225,5652,Sanjay Dilip Kumar Das,THANE,IND,0,Graduate,11518516,555000,10963516
5226,7222,Sanjay Dina Patil,MUMBAI NORTH EAST,NCP,3,Graduate,19904204,0,19904204
5227,985,Sanjay Gandhi,CHANDNI CHOWK,Braj Vikas Party,0,12th Pass,151747504,0,151747504
5228,3159,Sanjay Kapoor,PILIBHIT,INC,0,Graduate Professional,76385000,3330000,73055000
5229,35,Sanjay Kewat,KARAKAT,BSP,0,Graduate,1997000,0,1997000
5230,596,Sanjay Kothari,DHARWAD,IND,0,Graduate,2958023,0,2958023
5231,2311,Sanjay Kumar,ALIGARH,IND,0,5th Pass,1000,0,1000
5232,2433,Sanjay Kumar,CHITTORGARH,BSP,0,10th Pass,5560400,700000,4860400
5233,2713,Sanjay Kumar,NALANDA,BSP,0,10th Pass,920000,25000,895000
5234,3162,Sanjay Kumar,PILIBHIT,Naitik Party,0,Literate,47000,32000,15000
5235,4397,Sanjay Kumar,HARDOI,Bhartiya Krishak Dal,0,Graduate,552200,0,552200
5236,4461,Sanjay Kumar,BANKA,BSP,1,10th Pass,1800000,1200000,600000
5237,4463,Sanjay Kumar,BANKA,CPI,3,Post Graduate,23633247,9460885,14172362
5238,6167,Sanjay Kumar Jha,DARBHANGA,JD(U),0,Post Graduate,181383957,0,181383957
5239,502,Sanjay Kumar Rai,SOUTH DELHI,BSP,1,12th Pass,5839937,0,5839937
5240,4457,Sanjay Kumar Rishidev,ARARIA,CPI(ML)L,1,Literate,14175,0,14175
5241,3279,Sanjay Kumar Sahoo,CUTTACK,IND,0,Others,1050960,0,1050960
5242,3382,Sanjay Laxman Padwal,PUNE,Bhartiya Navjawan Sena (Paksha),0,10th Pass,95000,0,95000
5243,1388,Sanjay Mahadev Wankhade,BULDHANA,IND,0,Graduate,2037000,260000,1777000
5244,17,Sanjay Maurya,FARIDABAD,IND,0,8th Pass,143541,0,143541
5245,469,Sanjay Meshack,ANDAMAN & NICOBAR ISLANDS,AAP,0,10th Pass,57497526,633088,56864438
5246,1493,Sanjay Nilkanth Gawande,CHANDRAPUR,IND,0,12th Pass,2170000,0,2170000
5247,5895,Sanjay Nirupam,MUMBAI NORTH,INC,9,Graduate,57290996,3739000,53551996
5248,5856,Sanjay Nivrutti Hivrale,JALNA,Ambedkar National Congress,0,8th Pass,401000,0,401000
5249,4197,Sanjay S/O Laxman Solanki,KHANDWA,BSP,1,Graduate,3646000,830000,2816000
5250,3533,Sanjay Sadashiv Mandalik,KOLHAPUR,SHS,0,Post Graduate,11672709,920570,10752139
5251,7238,Sanjay Saoji Deshpande,MUMBAI NORTH EAST,IND,0,10th Pass,6818000,1423000,5395000
5252,5025,Sanjay Shakya,KANNAUJ,IND,0,Graduate Professional,1636000,600000,1036000
5253,5269,Sanjay Singh,PURNIA,IND,0,10th Pass,106700,0,106700
5254,4480,Sanjay Singh,KATIHAR,IND,0,Post Graduate,10830016,202000,10628016
5255,6740,Sanjay Tiwari,SITAPUR,Naitik Party,0,12th Pass,2108742,0,2108742
5256,1399,Sanjaybhau Narayanrao Chidam,WARDHA,IND,0,12th Pass,5610091,50000,5560091
5257,3655,Sanjaykaka Patil,SANGLI,BJP,0,10th Pass,108791027,19198050,89592977
5258,7300,Sanjaykumar Somnathbhai Raval,BANASKANTHA,AAP,0,Graduate Professional,34785000,9985000,24800000
5259,5104,Sanjeet Kumar,DAUSA,AAP,0,Doctorate,4465861,1823880,2641981
5260,6695,Sanjeev,LUCKNOW,Bahujan Kranti Party (Marxwad-Ambedkarwad),2,Post Graduate,1730850,900000,830850
5261,5653,Sanjeev Ganesh Naik,THANE,NCP,0,12th Pass,148635752,43986747,104649005
5262,1679,Sanjeev Kumar,GHAZIABAD,IND,0,Post Graduate,5671309,0,5671309
5263,2822,Sanjeev Kumar Mahato,GIRIDIH,IND,0,12th Pass,813000,0,813000
5264,2974,Sanjeev Kumar Mishra,KHAJURAHO,AIFB,0,12th Pass,401000,0,401000
5265,7811,Sanjeev Kumar Thapar,BATHINDA,IND,0,10th Pass,2670000,200000,2470000
5266,5654,Sanjeev Vishnu Sane,THANE,AAP,0,10th Pass,12971518,611559,12359959
5267,6794,Sanjib Malik,BOLPUR,Jharkhand Disom Party,0,12th Pass,11000,0,11000
5268,6799,Sanjib Sarkar,HOWRAH,IND,0,12th Pass,23729,0,23729
5269,2249,Sanjit Kumar Das,KARIMGANJ,IND,0,10th Pass,640607,0,640607
5270,4832,Sanjit Singh,JANGIPUR,BSP,0,8th Pass,945000,0,945000
5271,2000,Sanjiv Bhojraj,SIRSA,VANCHITSAMAJ INSAAF PARTY,1,10th Pass,106000,0,106000
5272,2819,Sanjiv Kumar Sinha,GIRIDIH,AIFB,0,Graduate,646296,120000,526296
5273,7202,Sanju Verma,MUMBAI NORTH CENTRAL,IND,0,Post Graduate,183100000,3738000,179362000
5274,6578,Sankaliya Gangarambhai Tapubhai,SURENDRANAGAR,IND,0,10th Pass,5275000,0,5275000
5275,7541,Sankar,VIRUDHUNAGAR,IND,0,Post Graduate,405000,0,405000
5276,45,Sankar Prasad Datta,TRIPURA WEST,CPI(M),1,Post Graduate,1320900,0,1320900
5277,824,Sankar Sahu,ASKA,CPI(ML) Red star,0,Post Graduate,1294992,0,1294992
5278,4563,Sankhaliya Narendrasinh Mansinh,AHMEDABAD WEST,Loktantrik Samajwadi Party,0,Graduate,15750,125000,0
5279,6955,"Sanmugam, A",CHIDAMBARAM,IND,0,5th Pass,1731000,0,1731000
5280,4442,Sansuma Khunggur Bwiswmuthiary,KOKRAJHAR,IND,0,Graduate,21117979,571917,20546062
5281,444,Sant Dharamvir Chotiwala,SONIPAT,IND,0,Graduate Professional,30110000,50000,30060000
5282,6737,Sant Kumar,SITAPUR,CPI(ML) Red Star,0,Literate,90500,0,90500
5283,6131,Sant Ram,FARIDKOT,BSP,0,12th Pass,2092700,0,2092700
5284,5013,Sant Ram,HARDOI,Bahujan Mukti Party,0,Literate,717400,0,717400
5285,5928,Santan Daigo Farnandis,MUMBAI SOUTH,IND,0,12th Pass,149000,0,149000
5286,7555,Santhadevi. S,THOOTHUKKUDI,IND,0,Graduate,679000,0,679000
5287,7532,Santhanakrishnan,VIRUDHUNAGAR,Tamil Nadu Makkal Congress,0,10th Pass,1153247,2437,1150810
5288,1966,Santhosh Kumar,PATHANAMTHITTA,IND,3,Graduate Professional,1081000,0,1081000
5289,1202,Santhoshmohan,HASSAN,AAP,0,Graduate Professional,23700200,100000,23600200
5290,7699,Santokh Singh Chaudhary,JALANDHAR,INC,0,Graduate Professional,104040531,6194323,97846208
5291,2332,Santosh Ahlawat,JHUNJHUNU,BJP,0,Post Graduate,35897048,5704000,30193048
5292,2923,Santosh Bharti,DAMOH,AAP,3,Others,15854961,5569039,10285922
5293,2810,Santosh Chandrakar,RAJNANDGAON,GGP,0,10th Pass,4656512,325188,4331324
5294,5416,Santosh Dahariya,RAIPUR,IND,0,12th Pass,490000,200000,290000
5295,3084,Santosh Gangwar,BAREILLY,BJP,0,Graduate Professional,38602862,1777215,36825647
5296,3068,Santosh Kumar,BADAUN,RPI(A),0,Not Given,857849,0,857849
5297,378,Santosh Kumar,AURANGABAD,BSP,2,Graduate,130000,0,130000
5298,3975,Santosh Kumar,PURNIA,JD(U),3,12th Pass,22316594,1406515,20910079
5299,6721,Santosh Kumar Dharkar,MOHANLALGANJ,Indian National League,0,Graduate Professional,100000,0,100000
5300,2791,Santosh Kumar Dhruw,KANKER,AAP,0,Graduate,195543,0,195543
5301,4192,Santosh Kumar Garg,INDORE,IND,0,12th Pass,695000,0,695000
5302,7657,Santosh Kumari,GURDASPUR,Megh Desham Party,0,12th Pass,602556,0,602556
5303,3678,Santosh Madhukar Roham,SHIRDI,Bahujan Mukti Party,0,Graduate,3430530,901903,2528627
5304,2109,Santosh Manjunath Shet(Raikar),BELGAUM,IND,0,10th Pass,3592220,0,3592220
5305,2102,Santosh Manohar Bavadekar,BELGAUM,IND,1,Graduate,115082,0,115082
5306,3868,Santosh Namdeorao Sagne,HINGOLI,Awami Vikas Party,0,Others,1671000,1035000,636000
5307,3640,Santosh Pawar,PUNE,IND,0,Graduate,3229500,0,3229500
5308,6011,Santosh Roy,BARDHAMAN PURBA,BJP,0,8th Pass,172339,0,172339
5309,3413,Sanwar Lal,AJMER,NCP,0,5th Pass,1092020,0,1092020
5310,3412,Sanwar Lal Jat,AJMER,BJP,0,Doctorate,18064656,0,18064656
5311,5303,Sapa Rafikbhai Sulemanbhai,BHARUCH,IND,5,5th Pass,186000,0,186000
5312,6581,Sapara Vipulbhai Rameshbhai,SURENDRANAGAR,IND,0,10th Pass,76500,0,76500
5313,7624,Sapkal Lilabai Dharma,JALNA,IND,0,Not Given,410000,0,410000
5314,6139,Sarabjeet Singh,FATEHGARH SAHIB,BSP,0,12th Pass,36550000,120000,36430000
5315,6790,Sarada Moni Samanta,BARDHAMAN-DURGAPUR,IND,0,Post Graduate,1400000,0,1400000
5316,1911,Sarah Joseph,THRISSUR,AAP,0,Post Graduate,4122398,0,4122398
5317,3480,Sarangthem Manaobi,INNER MANIPUR,AITC,0,Post Graduate,920000,0,920000
5318,7028,Saraswathi S.,KANNIYAKUMARI,IND,0,10th Pass,560000,0,560000
5319,7043,"Saraswathy, K.",KARUR,CPI(ML) Red Star,0,Illiterate,735815,0,735815
5320,6682,Saraswati,KANPUR,IND,0,12th Pass,45912,0,45912
5321,1147,Saraswati Nanda,BOLANGIR,AAP,0,Post Graduate,279095,0,279095
5322,3250,Sarat Das,BHADRAK,BJP,0,Post Graduate,1241350,309933,931417
5323,222,Sarat Pattnayak,BOLANGIR,INC,0,Graduate Professional,43999656,818572,43181084
5324,583,Saravanan,ANDAMAN & NICOBAR ISLANDS,IND,0,Graduate,236000,0,236000
5325,7594,Saravanan.P,TIRUNELVELI,IND,0,12th Pass,83586,0,83586
5326,7070,Saravanan.V,KRISHNAGIRI,IND,0,10th Pass,6166935,1950000,4216935
5327,517,Sarbananda Sonowal,LAKHIMPUR,BJP,0,Graduate Professional,14497515,0,14497515
5328,4466,Sargun Sah,BANKA,IND,0,8th Pass,1824000,0,1824000
5329,3147,Sarika,NAGINA,AAP,2,Graduate,400000,0,400000
5330,4511,Sarita Soni,BILASPUR,IND,0,12th Pass,1676000,0,1676000
5331,5390,Sarju Prasad Shukla,DURG,IND,0,10th Pass,15887210,770000,15117210
5332,5954,Sarkate Devidas Piraji,NASHIK,IND,0,12th Pass,57301,0,57301
5333,3409,Sarode Popat Rambhau,SHIRDI,Lok Bharati,0,12th Pass,272400,250000,22400
5334,3003,Saroj Katiyar Kurmi,SAGAR,BSP,0,Post Graduate,24415594,1590878,22824716
5335,5012,Saroj Kumar,HARDOI,IND,0,12th Pass,2776000,1520000,1256000
5336,1157,Saroj Kumar Naik,KALAHANDI,BSP,0,Graduate,5880000,120000,5760000
5337,3238,Saroj Kumar Panda,BALASORE,IND,0,Graduate,570000,0,570000
5338,365,Saroj Ram,SASARAM,Bahujan Mukti Party,0,Graduate Professional,2255786,80350,2175436
5339,7437,Sarubala R Thondaiman,TIRUCHIRAPPALLI,INC,0,Post Graduate,570772432,1513575,569258857
5340,5009,Sarvesh,HARDOI,IND,0,10th Pass,3956424,270000,3686424
5341,4398,Sarvesh Kumar,HARDOI,INC,2,Graduate,2917101,0,2917101
5342,4085,Sarvesh Kumar Saini,AMROHA,SHS,2,10th Pass,12800000,800000,12000000
5343,7844,Sarvey Sathyanarayana,MALKAJGIRI,INC,2,Graduate Professional,32275736,4195312,28080424
5344,4458,Sarwat Jahre Ansari,ARARIA,Samajwadi Janata Party (Rashtriya),0,Post Graduate,296000,0,296000
5345,1845,Saseendran,VADAKARA,BSP,0,5th Pass,3271000,250000,3021000
5346,7169,Sasi Kumar .S,RAMANATHAPURAM,IND,0,Not Given,279000,0,279000
5347,1810,Sasidharan K V,KANNUR,AAP,0,Post Graduate,2730285,360000,2370285
5348,12,Sasikala K S,MAVELIKKARA,SUCI(C),0,12th Pass,2700,0,2700
5349,705,Sasikkuttan Vakathanam,KOTTAYAM,CPI(ML) Red star,0,10th Pass,361750,0,361750
5350,4829,Sasti Chandra Sarkar,BALURGHAT,Rashtriya Janadhikar Suraksha Party,0,10th Pass,488095,203335,284760
5351,6022,Satabdi Roy(Banerjee),BIRBHUM,AITC,0,Graduate,54972174,5478944,49493230
5352,2985,Satandra Singh (Tony Tomar),MORENA,IND,0,Literate,238000,0,238000
5353,3527,Satav Atmaram Raghoji,HINGOLI,IND,0,8th Pass,500,500,0
5354,3528,Satav Raju Shankar,HINGOLI,IND,1,Literate,139000,0,139000
5355,431,Satbir,HISAR,IND,0,5th Pass,4959708,0,4959708
5356,5049,Satendra Veer Singh Chauhan,MAINPURI,AIFB,0,Post Graduate,2621288,40000,2581288
5357,1851,Satheesh Chandran,WAYANAD,AITC,0,Literate,112000,0,112000
5358,4292,Satheesh Kumar E,SALEM,AAP,0,Post Graduate,11428000,2416872,9011128
5359,3579,Sathi Bashir Ahmed Bashamiyan Shaikh,MADHA,IND,0,Literate,2054596,16968,2037628
5360,7170,Sathiah .G,RAMANATHAPURAM,IND,0,Graduate,940000,0,940000
5361,7139,Sathish Kumar .L,POLLACHI,SP,0,Post Graduate,497545,0,497545
5362,7010,"Sathiyanathan, N.",KANCHEEPURAM,IND,0,5th Pass,578000,0,578000
5363,7004,Sathiyaraj J.S,KANCHEEPURAM,BSP,0,Doctorate,1205000,400000,805000
5364,7008,Sathya C.E.,KANCHEEPURAM,MDMK,0,Graduate,20582544,60000,20522544
5365,7358,Sathyamurthy.C,TIRUVALLUR,BSP,0,Graduate Professional,2322609,0,2322609
5366,265,Sathyan Mokeri,WAYANAD,CPI,2,Graduate,3697322,502699,3194623
5367,1857,Sathyan Puthanveettil,WAYANAD,IND,0,8th Pass,226000,0,226000
5368,1859,Sathyan Thazhemangad,WAYANAD,IND,0,Literate,47000,0,47000
5369,7871,Sathyanarayana Yaadav Peddiboyina,MALKAJGIRI,B.C.Bharata Desam Party,0,5th Pass,66697499,1133132,65564367
5370,7810,Satish Arora,BATHINDA,IND,0,12th Pass,13615000,0,13615000
5371,1834,Satish Asangihal,BIJAPUR,IND,0,Graduate Professional,20500,0,20500
5372,3928,Satish Babu Naidu,BHOPAL,IND,0,10th Pass,142015,0,142015
5373,5853,"Satish Bhaskar Patil (Mudi Pra Dangri, Tal.Amalner)",JALGAON,IND,0,12th Pass,50000,0,50000
5374,5851,"Satish Bhaskar Patil (Nandgaon Bk, Tal.Erandol)",JALGAON,IND,0,Not Given,100000,0,100000
5375,5852,"Satish Bhaskar Patil (Varkhedi, Tal.Erandol)",JALGAON,IND,0,5th Pass,100000,0,100000
5376,3129,Satish Chandra Sharma,MORADABAD,Naitik Party,0,8th Pass,937285,711000,226285
5377,932,Satish Gokuldas Pendam,GADCHIROLI-CHIMUR,AITC,0,Graduate Professional,16000,0,16000
5378,676,Satish Kumar,GAUTAM BUDHHA NAGAR,BSP,1,12th Pass,599501967,201428322,398073645
5379,619,Satish Kumar,NAWADA,IND,0,10th Pass,11610000,0,11610000
5380,682,Satish Kumar,ALIGARH,BJP,1,10th Pass,52180006,754800,51425206
5381,1139,Satish Kumar Minz,SUNDARGARH,IND,0,Post Graduate,3008000,0,3008000
5382,2341,Satish Kumar Sharma,SIKAR,Jago Party,0,Post Graduate,903500,5000,898500
5383,1029,Satish Kumar Singal,KURUKSHETRA,IND,0,Post Graduate,8105000,0,8105000
5384,5899,Satish Parasmal Jain,MUMBAI NORTH,AAP,0,Graduate,201971234,65006000,136965234
5385,886,Satish Poonchi,JAMMU,IND,0,10th Pass,2513000,0,2513000
5386,6185,Satish Prasad Singh,KHAGARIA,IND,1,Graduate,3462200,25000,3437200
5387,6150,Satnam Paul Kamboj,FIROZPUR,AAP,0,Graduate Professional,1300000,0,1300000
5388,452,Satpal,ROHTAK,IND,0,10th Pass,3998000,0,3998000
5389,2073,Satpal S/O Lokram,BHIWANI-MAHENDRAGARH,IND,0,12th Pass,1754500,1945000,0
5390,2074,Satpal S/O Sube,BHIWANI-MAHENDRAGARH,IND,0,12th Pass,2766000,1700000,1066000
5391,7782,Satpal Singh,FARIDKOT,Indian Krantikari Lehar,0,Illiterate,1630000,0,1630000
5392,2718,Satya Nand Sharma,NALANDA,LJP,0,Literate,12818500,0,12818500
5393,2055,Satya Narayan,SONIPAT,IND,0,10th Pass,14173000,0,14173000
5394,5256,Satya Narayan Bhagat,KATIHAR,Proutist Sarva Samaj,0,Graduate,1062200,0,1062200
5395,811,Satya Narayan Mahar,KALAHANDI,AAP,1,Graduate,32332,0,32332
5396,4136,Satya Narayan Sharma (Sattu Bhaiya),RAIPUR,INC,1,12th Pass,44901667,2259662,42642005
5397,41,Satya Narayan Singh,KARAKAT,IND,0,Graduate,19450824,2396194,17054630
5398,3189,Satya Pal Singh,SAMBHAL,BJP,0,Post Graduate,19904379,0,19904379
5399,2426,Satya Prakash Sharma,BHILWARA,IND,0,12th Pass,536875,0,536875
5400,1786,Satyalal Sarkar,JALPAIGURI,BJP,0,Graduate,12290350,1267598,11022752
5401,4773,Satyanarayan Patel,INDORE,INC,0,12th Pass,699196061,8162155,691033906
5402,4390,Satyapal Singh,FIROZABAD,BJP,1,Doctorate,33097756,944483,32153273
5403,7200,Satyavijay Vithoba Chavan,MUMBAI NORTH,IND,0,8th Pass,2385347,0,2385347
5404,5393,Satyendra,JANJGIR-CHAMPA,Ambedkarite Party of India,0,Others,565700,70000,495700
5405,5837,Sau.Asha Sahebrao Patil,JALGAON,Maharashtra Parivartan Sena (T),0,12th Pass,115000,0,115000
5406,2836,Saurabh Narain Singh,HAZARIBAGH,INC,2,Post Graduate,415506982,0,415506982
5407,3131,Saurabh Pratap Singh,MORADABAD,AITC,0,Post Graduate,729238,0,729238
5408,3023,Savio Oliver Rodrigues,SOUTH GOA,Goa Su-Raj Party,0,Graduate Professional,1892000,0,1892000
5409,6994,Savithiri.K,DHARMAPURI,Ulzaipali Makkal Katchy,0,5th Pass,260000,0,260000
5410,1708,Savitri,GAUTAM BUDHHA NAGAR,IND,0,10th Pass,20577047,0,20577047
5411,2041,Savitri,KARNAL,IND,0,Illiterate,3700000,200000,3500000
5412,4183,Savitri Thakur,DHAR,BJP,0,10th Pass,9606464,1582845,8023619
5413,1521,Sawake Ramkrushna Pundlikrao,YAVATMAL-WASHIM,CPI(ML) Red star,0,10th Pass,612264,0,612264
5414,5913,Sawant Arvind Ganpat,MUMBAI SOUTH,SHS,1,Graduate,13067446,0,13067446
5415,3083,Sayad Rashid Ali,BAREILLY,IND,0,Post Graduate,6894000,0,6894000
5416,3684,Sayaji Shankar Kharat,SHIRDI,IND,0,Post Graduate,4602900,1222000,3380900
5417,3332,Sayed Abdul Rahim,PARBHANI,Welfare Party Of India,0,Graduate,259400,0,259400
5418,7228,Sayed Gulamhusain Amirhamza,MUMBAI NORTH EAST,Republican Party of India,0,Graduate,142000,1708849,0
5419,4635,Sayeed Javed Ali,RAIPUR,IND,0,5th Pass,250500,0,250500
5420,1460,Sayyad Afjalali Alias Chhanubhai,BHANDARA-GONDIYA,Minorities democratic party,0,5th Pass,1093000,0,1093000
5421,7770,Sayyad Ferojoddin,ZAHIRABAD,BSP,0,12th Pass,50000,0,50000
5422,5868,Sayyad Husain Ahmad,JALNA,IND,0,Literate,490000,0,490000
5423,5214,Sayyad Mo. Kayam,DHULE,IND,0,8th Pass,66000,0,66000
5424,3609,Sayyad Mohamd Sayyad Ibrahim,OSMANABAD,Bahujan Mukti Party,0,Post Graduate,402248,0,402248
5425,5199,Sayyad Salim Sayyad Alim,DHULE,IND,0,12th Pass,109000,0,109000
5426,7613,Sayyad Shafiyoddin Vahiyoddin,AURANGABAD,Welfare Party Of India,0,10th Pass,75000,0,75000
5427,3308,Sayyad Tanvir Sayyad Hamja,NANDED,Majlis Bachao Tahreek,0,8th Pass,50000,0,50000
5428,7317,Sayyed Asif Zafar Ali,BHARUCH,Apna Desh Party,0,5th Pass,10000,0,10000
5429,3888,Sayyed Minhaj Ali Sayyad Wajed Ali (Pendkhajurwale),BEED,IND,0,12th Pass,1125000,235000,890000
5430,3889,Sayyed Mubin Rahimtulla,BEED,IND,0,10th Pass,871000,2300000,0
5431,3887,Sayyed Navidujjamma,BEED,IND,1,Graduate,2539615,0,2539615
5432,3890,Sayyed Salim Fattu,BEED,IND,1,Illiterate,60000,275000,0
5433,7789,Seema Rani,FARIDKOT,IND,0,Graduate Professional,212286,0,212286
5434,4990,Seema Upadhyay,FATEHPUR SIKRI,BSP,0,Graduate,98220327,11340556,86879771
5435,7116,"Seemanur Prabu, S.",PERAMBALUR,DMK,0,Others,18402538,0,18402538
5436,6884,Seetha Mallar. A,CHENNAI NORTH,IND,0,Others,1770000,0,1770000
5437,7029,Seetharamadhas,KANNIYAKUMARI,IND,0,Others,1238000,0,1238000
5438,610,Seetharaman.E,BANGALORE CENTRAL,IND,0,10th Pass,1283611,0,1283611
5439,2850,Sekh Akhiruddin,JAMSHEDPUR,Jharkhand Party (Naren),0,8th Pass,1535000,0,1535000
5440,965,Seleena Prakkanam,PATHANAMTHITTA,BSP,2,12th Pass,25500,0,25500
5441,4890,Selima Sultana,NOWGONG,IND,0,10th Pass,677952,18404,659548
5442,7598,Selvaganapathy.G,TIRUNELVELI,IND,0,Graduate,190000,0,190000
5443,5951,Selvakumar Perin Baraj Nadar,MUMBAI SOUTH CENTRAL,IND,0,5th Pass,2353210,0,2353210
5444,6350,Selvakumara Chinnayan S,ERODE,AIADMK,0,Post Graduate,47459708,0,47459708
5445,7005,Selvam G,KANCHEEPURAM,DMK,0,Post Graduate,7304895,563000,6741895
5446,5686,Selvam.G,NAMAKKAL,IND,0,Post Graduate,91614000,2000000,89614000
5447,7135,Selvaraj,POLLACHI,INC,0,Post Graduate,54282853,8800000,45482853
5448,7477,Selvaraj A,SIVAGANGA,IND,0,8th Pass,185400,0,185400
5449,7052,"Selvaraj, S.",KARUR,IND,0,Graduate Professional,260000,0,260000
5450,7114,"Selvaraj, V.M.",PERAMBALUR,BSP,0,Post Graduate,2152232,38000,2114232
5451,5672,Selvaraj.R,NAMAKKAL,BSP,0,8th Pass,201000,0,201000
5452,5680,Selvaraj.S,NAMAKKAL,IND,0,8th Pass,3271000,0,3271000
5453,1444,Senapati Uttam Sapan,NAGPUR,IND,1,5th Pass,398038,0,398038
5454,7259,Sengal Naranbhai Tulshibhai,AHMEDABAD EAST,Bahujan Suraksha Dal,0,10th Pass,45000,0,45000
5455,7393,"Senguttuvan, B.",VELLORE,AIADMK,0,Post Graduate,9197355,440478,8756877
5456,6318,Senguttuvan.R,CUDDALORE,IND,0,5th Pass,408500,0,408500
5457,4050,Senthamizhselvi,CHIDAMBARAM,IND,0,5th Pass,116422,44500,71922
5458,5701,Senthil Kumar M,SALEM,IND,0,Graduate,149900,0,149900
5459,6887,Senthil Kumar. K,CHENNAI NORTH,IND,0,Others,190500,0,190500
5460,7519,"Senthil Rajan Mallar, K.",THENI,IND,1,Post Graduate,682600,0,682600
5461,5428,Senthil S,TIRUVANNAMALAI,IND,0,Others,3714000,0,3714000
5462,6311,Senthilmurugan.S,CUDDALORE,BSP,0,Graduate Professional,517700,0,517700
5463,7095,Senthilpandian. Thalai. T.A.P,NAGAPATTINAM,INC,0,Graduate Professional,4240000,93000,4147000
5464,1738,Seshraj,SAHARANPUR,IND,0,Others,106068354,0,106068354
5465,6340,Sethupathy,ERODE,BSP,1,Graduate,14267730,100000,14167730
5466,3012,Sewak Ram Ahirwar,TIKAMGARH,BSP,1,12th Pass,1982450,29199,1953251
5467,909,Seyyed Mohammed Khasim.K,LAKSHADWEEP,SP,2,12th Pass,5236685,0,5236685
5468,1629,Shabnam,MUZAFFARNAGAR,IND,0,Literate,805000,0,805000
5469,6714,Shabnum,MISRIKH,IND,0,Graduate,464025,0,464025
5470,4445,Shachindra Nath Brahma,MANGALDOI,IND,0,10th Pass,41000,0,41000
5471,1918,Shafeer Muhammed,CHALAKUDY,SDPI,3,10th Pass,1435046,170695,1264351
5472,3725,Shafi Ahmed,BANGALORE CENTRAL,IND,0,5th Pass,1025000,0,1025000
5473,5655,Shafik Ahamad Sadat Khan,THANE,IND,0,Others,8479287,0,8479287
5474,5188,Shah Abrar Ahmed Nazeer Ahmed,BHIWANDI,Peace Party,0,Graduate Professional,197500,0,197500
5475,7339,Shah Mukeshkumar Khodidas,GANDHINAGAR,IND,0,12th Pass,1550000,55000,1495000
5476,4109,Shah Tariq Anwar,KATIHAR,NCP,1,Graduate,104600951,20454853,84146098
5477,1737,Shahanavaj,SAHARANPUR,Rashtriya Janmorcha,0,12th Pass,919230,0,919230
5478,1281,Shahid,SOUTH DELHI,IND,0,10th Pass,5305000,0,5305000
5479,1635,Shahid Manzoor,MEERUT,SP,0,Post Graduate,34814614,231000,34583614
5480,2530,Shahid Sharif,NAGPUR,JD(U),0,Graduate,1450325,0,1450325
5481,54,Shahjan Masood Urf Shahdan,SAHARANPUR,SP,2,Graduate,11192498,0,11192498
5482,57,Shahnawaj Rana,BIJNOR,SP,11,Graduate Professional,145562257,54311908,91250349
5483,5921,Shahzad Shamsher Khan Pathan,MUMBAI SOUTH,Awami Vikas Party,0,Graduate,30604689,1275000,29329689
5484,6223,Shaik Mahmood,KARIMNAGAR,Welfare Party Of India,0,Graduate,2055000,0,2055000
5485,7896,Shaik Moin,HYDERABAD,IND,0,Literate,40000,0,40000
5486,7612,Shaik Sayyad Shaik Mahmood,AURANGABAD,IND,0,5th Pass,451000,0,451000
5487,3307,Shaikh Afajaloddin Azimoddin,NANDED,Lok Bharati,0,Not Given,1650000,0,1650000
5488,4799,Shaikh Azizuddin Quraishi,MANDSOUR,AIFB,0,Post Graduate,5000,0,5000
5489,3883,Shaikh Chand Shiakh Miya,BEED,IND,0,Literate,50000,0,50000
5490,7199,Shaikh Fateh Mohammad,MUMBAI NORTH,IND,4,5th Pass,13300000,0,13300000
5491,4894,Shaikh Hasan Dagdu,NAVSARI,IND,0,Literate,149000,28000,121000
5492,3859,Shaikh Iptekhar Zakeebaba,BEED,Welfare Party Of India,0,12th Pass,35000,0,35000
5493,1499,Shaikh Jabbar Shaikh Usuf,YAVATMAL-WASHIM,IND,0,8th Pass,500,0,500
5494,6607,Shaikh Kalim Abdul Latif,PANCHMAHAL,SP,0,8th Pass,536400,0,536400
5495,6608,Shaikh Majitmiya Jivamiya,PANCHMAHAL,JD(U),0,10th Pass,416000,15000,401000
5496,5602,Shaikh Mo. Asgar Sakhawat,RAVER,Republican Party of India,1,12th Pass,50000,0,50000
5497,3610,Shaikh Mubarak Mainoddin,OSMANABAD,IND,0,5th Pass,80000,0,80000
5498,5204,Shaikh Mukhatar Ah. Mo. Qasim,DHULE,Welfare Party Of India,0,Graduate Professional,3718797,0,3718797
5499,3518,Shaikh Nayeem Shaikhlal,HINGOLI,SP,0,12th Pass,9355936,270817,9085119
5500,3371,Shaikh Nurjaha Yasin,MAVAL,IND,0,8th Pass,18451152,0,18451152
5501,3500,Shaikh Shabbir Nabi,HATKANANGLE,Maharashtra Parivartan Sena (T),0,Literate,150000,150000,0
5502,3884,Shaikh Shafiq Shabbir,BEED,IND,1,10th Pass,109000,0,109000
5503,3586,Shaikh Shahajan Paigambar,MADHA,IND,0,5th Pass,145000,0,145000
5504,5621,Shaikh Shakir,RAVER,IND,0,Graduate Professional,500,0,500
5505,5622,Shaikhh Shaherabi Jainoddin Shaikh,RAVER,IND,0,5th Pass,10120,1040,9080
5506,1314,Shailender Kumar,NORTH WEST DELHI,IND,0,Graduate,620000,10000,610000
5507,4682,Shailendra Kumar Banjare,DURG,Shakti Sena (Bharat Desh),0,Post Graduate,51260000,0,51260000
5508,2909,Shailendra Kumar Shaili,BHOPAL,CPI,0,Post Graduate,8582000,0,8582000
5509,6691,Shailendra Singh,LUCKNOW,IND,1,8th Pass,175000,60000,115000
5510,2937,Shailendra Singh Kushwah,GUNA,AAP,0,Graduate,3626314,2075000,1551314
5511,846,Shailendrakumar Patil,DHARWAD,IND,1,Graduate,35000,0,35000
5512,2716,Shailesh Kumar,NALANDA,Ati Picchara party,0,Graduate Professional,4445777,0,4445777
5513,4470,Shailesh Kumar Urph Bulo Mandal,BHAGALPUR,RJD,1,12th Pass,20216734,0,20216734
5514,5306,Shaileshkumar Maganbhai Parmar,BHARUCH,IND,0,12th Pass,140000,0,140000
5515,15,Shajar Khan,THIRUVANANTHAPURAM,SUCI(C),0,Post Graduate,26800,0,26800
5516,957,Shajumon Vattekad,ALATHUR,BJP,0,10th Pass,1772801,32653,1740148
5517,5276,Shakaldev Mandal,SUPAUL,Samajwadi Janata Party (Rashtriya),1,Graduate Professional,82854500,0,82854500
5518,1366,Shakeel Ahmed,EAST DELHI,Jai Maha Bharath Party,0,12th Pass,882000,0,882000
5519,2190,Shakil Dodawad,DHARWAD,IND,0,5th Pass,97000,0,97000
5520,2539,Shakil Wasi Ahamad,NAGPUR,IND,0,Not Given,0,0,0
5521,2991,Shakti Singh Tomar,MORENA,Rashtriya Ahinsa Manch,0,12th Pass,607700,0,607700
5522,4771,Shakti Sudha,INDORE,IND,0,Post Graduate,253032,0,253032
5523,7024,Shalin Richard J.,KANNIYAKUMARI,Indians Victory Party,0,Graduate,824292,0,824292
5524,3024,Shalom Mathew Francisco Sardinha,SOUTH GOA,IND,0,Graduate Professional,32828000,2340017,30487983
5525,5813,Shalu Dharmendra,UNNAO,Samtawadi Republican Party,0,10th Pass,6793561,0,6793561
5526,2782,Sham Lal,UDHAMPUR,All J & K Kisan Majdoor Party,0,8th Pass,817000,0,817000
5527,6087,Sham Lal Gandhiwadi,AMRITSAR,IND,0,Illiterate,15500,0,15500
5528,2133,Shamala,BIDAR,IND,0,Not Given,9178000,1000000,8178000
5529,1400,Shambaba Alias Shamsundar Panjabrao Nichit,WARDHA,IND,0,Post Graduate,4155000,700000,3455000
5530,1402,Shambharkar Rajendra Gulabrao,WARDHA,IND,3,Doctorate,174963,0,174963
5531,2639,Shambhu Prasad Sharma,ARRAH,Hindustan Vikas Dal,0,Graduate Professional,300000,0,300000
5532,4666,Shambhu Sharma,KORBA,IND,0,Graduate Professional,3898542,0,3898542
5533,855,Shambulingegowda,BANGALORE SOUTH,IND,0,8th Pass,1222243,0,1222243
5534,7802,Shaminder Singh,BATHINDA,JKNPP,0,12th Pass,3335000,200000,3135000
5535,3152,Shamsher,NAGINA,IND,0,8th Pass,101000,0,101000
5536,4396,Shamsher Kha,FIROZABAD,Peace Party,0,10th Pass,1973200,300000,1673200
5537,7726,Shamsher Singh,HOSHIARPUR,Shiromani Akali Dal (Amritsar)(Simranjit Sing,0,Graduate Professional,1043500,0,1043500
5538,209,Shamsher Singh Kharkara,ROHTAK,INLD,0,Post Graduate,242943888,0,242943888
5539,7083,Shamsudeen. M,MAYILADUTHURAI,IND,0,8th Pass,352590,0,352590
5540,5894,Shamu Ramu Bhosale,KALYAN,Bharipa Bahujan Mahasangh,0,10th Pass,3278000,111684,3166316
5541,758,Shanbhulal,MANDLA,BSP,0,10th Pass,1275000,0,1275000
5542,20,Shandar Gufran,MUZAFFARNAGAR,IND,0,Post Graduate,7268197,661855,6606342
5543,6947,Shankar,CHENNAI SOUTH,IND,0,Not Given,450000,0,450000
5544,2645,Shankar Dayal Paswan,ARRAH,IND,4,Others,1525000,2500,1522500
5545,5910,Shankar Gangadhar Sonawane,MUMBAI SOUTH,IND,0,10th Pass,4237600,16663,4220937
5546,175,Shankar Jadhav,GULBARGA,Bharatiya Peoples Party,0,Graduate,3400000,0,3400000
5547,1587,Shankar Kansre,BALAGHAT,IND,0,Graduate Professional,5925841,1500000,4425841
5548,1150,Shankar Kumar Patra,BOLANGIR,Aama Odisha Party,0,Post Graduate,10380000,0,10380000
5549,3437,Shankar Lal Darji,JALORE,IND,0,5th Pass,543500,0,543500
5550,4634,Shankar Lal Varandaani,RAIPUR,IND,0,10th Pass,492000,0,492000
5551,2704,Shankar Prasad,MUNGER,Bahujan Mukti Party,2,Graduate,40253000,0,40253000
5552,595,Shankar Ram Thakur,BASTAR,SP,0,Graduate,12430000,8000,12422000
5553,1184,Shankar Rathod,BELGAUM,IND,0,10th Pass,4650000,0,4650000
5554,2522,Shankarappa,BANGALORE RURAL,Jai Vijaya Bharathi Party,0,10th Pass,45000,0,45000
5555,1146,Shankarlal Agrawala,SAMBALPUR,"Proutist Bloc, India",0,12th Pass,16466020,0,16466020
5556,2137,Shanker Bhayya,BIDAR,BSP,0,Others,7520141,0,7520141
5557,5692,Shanmugam G,SALEM,Makkal Manadu Katchi,0,8th Pass,25000,0,25000
5558,7392,"Shanmugam, A.C.",VELLORE,BJP,0,Graduate Professional,1061039972,344686084,716353888
5559,7559,"Shanmugam, A.P.C.V.",THOOTHUKKUDI,INC,0,Graduate,29971850,2532797,27439053
5560,7382,"Shanmugam, G. Thiru",SRIPERUMBUDUR,IND,0,Not Given,1153,0,1153
5561,7381,"Shanmugam, K. Thiru",SRIPERUMBUDUR,IND,0,Graduate,419000,0,419000
5562,2434,Shanti Lal Trivedi,CHITTORGARH,CPI(ML)L,0,10th Pass,2289690,96000,2193690
5563,3692,Sharad Bansode,SOLAPUR,BJP,1,Graduate Professional,60152887,7604375,52548512
5564,6192,Sharad Yadav,MADHEPURA,JD(U),0,Graduate Professional,54676401,0,54676401
5565,263,Sharafudheen,VADAKARA,IND,0,12th Pass,1119368,0,1119368
5566,567,Sharanabasappa Malakajappa,GULBARGA,SUCI(C),0,Graduate,12500,0,12500
5567,7401,"Shareef Basha, H.",VELLORE,Samata Party,0,Illiterate,1073337,0,1073337
5568,3151,Sharishtha Kumar Singh,NAGINA,Jai Maha Bharath Party,0,Graduate,5632000,0,5632000
5569,5922,Sharma Gaurav Shrinivas,MUMBAI SOUTH,IND,0,8th Pass,318305,0,318305
5570,3864,Sharmila Baba Wakshe,SANGLI,IND,0,Graduate,723500,0,723500
5571,2698,Sharwan Kumar Anand,MUNGER,IND,0,Post Graduate,5750,0,5750
5572,2040,Shashi Saini,KARNAL,IND,0,Post Graduate,73585000,0,73585000
5573,2734,Shashi Yadav,NALANDA,CPI(ML)L,1,Graduate,14000,0,14000
5574,3637,Shashikant Bhikaji Owhal,PUNE,IND,0,Graduate,1318000,0,1318000
5575,7921,Shatrohanlal Rawat,MOHANLALGANJ,IND,0,8th Pass,2291000,0,2291000
5576,3716,Shatrudhan Shah,PATALIPUTRA,Bharatiya Ekta Dal,0,10th Pass,2030000,50000,1980000
5577,6786,Shatrughan Kumar Paswan,SAMASTIPUR,Rashtriya Krantikari Samajwadi Party,1,Post Graduate,1657000,0,1657000
5578,5044,Shatrughan Singh,MAINPURI,BJP,0,Graduate,12850273,0,12850273
5579,88,Shatrughan Sinha,PATNA SAHIB,BJP,1,Graduate,1317405961,168760929,1148645032
5580,2357,Shayam Singh Rathore,JAIPUR RURAL,Lok Shakti,0,Others,20778000,3400,20774600
5581,674,Shazia Ilmi Malik,GHAZIABAD,AAP,1,Post Graduate,303342609,41846167,261496442
5582,962,Sheeba K A,ALATHUR,INC,0,Post Graduate,2903410,1310606,1592804
5583,2905,Sheeba Malik,BHOPAL,SP,3,12th Pass,5775435,0,5775435
5584,3021,Sheel Chandra Ahirwar,TIKAMGARH,IND,0,10th Pass,373600,34000,339600
5585,5388,Sheema Rahangdale,DURG,Ambedkarite Party of India,0,Graduate,22714000,0,22714000
5586,3149,Sheesh Ram Singh Ravi,NAGINA,Peace Party,0,Graduate,21393387,3830925,17562462
5587,5093,Sheetal,BHARATPUR,IND,0,Post Graduate,566241,0,566241
5588,6735,Shefali Mishra,SITAPUR,AAP,0,Post Graduate,4503611,3300000,1203611
5589,5924,Shehbaj Allahuddin Rathod,MUMBAI SOUTH,Jai Maha Bharath Party,0,5th Pass,11873000,0,11873000
5590,4787,Sheikh Sharif,KHANDWA,Akhil Bhartiya Vikas Congress Party,1,Literate,414351,0,414351
5591,6557,Shekh Arif Abdullatif,SABARKANTHA,SP,0,Graduate,1398500,1051000,347500
5592,3286,Shekh Faruk,KENDRAPARA,BSP,1,10th Pass,1346000,0,1346000
5593,1110,Shekh Hamid Imam,AKOLA,Bahujan Mukti Party,0,Graduate,3736459,483872,3252587
5594,4667,Shekh Rauf,KORBA,IND,0,12th Pass,482686,0,482686
5595,4606,Shekhada Atulbhai Govindbhai,JUNAGADH,AAP,0,Graduate Professional,16864109,7534109,9330000
5596,3683,Shende Ravindra Vitthal,SHIRDI,IND,0,8th Pass,6316274,2363899,3952375
5597,2660,Sheo Gopal Chaudhry,BUXAR,IND,0,Graduate,1010000,0,1010000
5598,3476,Sher Singh,PALI,IND,0,8th Pass,6271914,752000,5519914
5599,2072,Sher Singh,BHIWANI-MAHENDRAGARH,IND,0,10th Pass,1200000,500000,700000
5600,6148,Sher Singh Ghubaya,FIROZPUR,SAD,0,10th Pass,96121057,5133876,90987181
5601,3544,Sheregar Chetan Venkatesh,KOLHAPUR,IND,0,12th Pass,825000,173475,651525
5602,6275,"Shettu, S.",ARAKKONAM,IND,0,Post Graduate,100000,0,100000
5603,5950,Shewale Rahul Ramesh,MUMBAI SOUTH CENTRAL,SHS,1,Others,13304397,10502345,2802052
5604,6028,Shib Ratan Sharma,BIRBHUM,JMM,0,8th Pass,1030419,0,1030419
5605,6049,Shibchandra Ram,HOWRAH,BSP,0,12th Pass,2000,0,2000
5606,4160,Shibu Soren,DUMKA,JMM,0,10th Pass,46760684,1479721,45280963
5607,651,Shibun Lyngdoh,SHILLONG,BJP,0,Graduate,75894099,7061466,68832633
5608,2173,Shiddappa Kallappa Pujar,HAVERI,IND,0,10th Pass,50500,0,50500
5609,1968,Shilvin Kottackakathu,PATHANAMTHITTA,IND,0,Others,33956316,1491421,32464895
5610,2284,Shimla Devi Nayak,GANGANAGAR,National Unionist Zamindara Party,0,Post Graduate,3466420,784068,2682352
5611,5903,Shinde Anand Vyankatrao,MUMBAI NORTH CENTRAL,BSP,0,10th Pass,35000,0,35000
5612,3306,Shinde Balaji Vishwanathrao,NANDED,SP,0,Graduate Professional,18406800,3237539,15169261
5613,3612,Shinde Rajendra Bhairavnath,OSMANABAD,Maharashtra Parivartan Sena (T),0,Graduate,500000,0,500000
5614,3704,Shinde Rajkumar Laxmanrao,SOLAPUR,IND,0,12th Pass,879456,0,879456
5615,5930,Shinde Sarjerao Mahadev,MUMBAI SOUTH CENTRAL,IND,0,Post Graduate,535181794,0,535181794
5616,3563,Shinde Sudhir Shripatrao,LATUR,IND,0,Graduate Professional,330626,300000,30626
5617,3693,Shinde Sushilkumar Sambhajirao,SOLAPUR,INC,0,Graduate Professional,234700792,150000,234550792
5618,4412,Shishupal Singh,MAINPURI,Bhartiya Shakti Chetna Party,0,Post Graduate,4335000,0,4335000
5619,5733,Shishupal Yadav,LUCKNOW,RASHTRIYA VIKLANG PARTY,0,Not Given,972016,0,972016
5620,7204,Shital Kumar Jain,MUMBAI NORTH CENTRAL,IND,0,10th Pass,19300000,0,19300000
5621,3007,Shitin Kesherwani,SAGAR,IND,0,12th Pass,331000,0,331000
5622,6823,Shitkaran Mahilvar,DURG,IND,0,5th Pass,1557000,300000,1257000
5623,4399,Shiv Kumar,HARDOI,IND,0,Graduate,148039,0,148039
5624,2027,Shiv Kumar,HISAR,IND,0,10th Pass,305500,0,305500
5625,1745,Shiv Kumar,SAHARANPUR,Ambedkar Samaj Party,0,8th Pass,220619,0,220619
5626,388,Shiv Kumar Kant,GAYA,BSP,0,Graduate,5232500,200000,5032500
5627,5786,Shiv Sewak,RAE BARELI,Rashtriya Ahinsa Manch,0,10th Pass,17354856,60000,17294856
5628,384,Shiv Shankar Kumar,GAYA,Bharat Bhrashtachar Mitao Party,0,Graduate,1067800,0,1067800
5629,2960,Shiv Singh Kushawah,GWALIOR,Mahanwadi Party,0,8th Pass,5469000,0,5469000
5630,5872,Shiva Krishnamurthy Iyar,KALYAN,IND,0,Post Graduate,17557000,0,17557000
5631,2831,Shiva Mahto,GIRIDIH,IND,0,8th Pass,2050000,0,2050000
5632,563,Shivagoudappa Balappa Khanagoudar,BELGAUM,IND,0,Graduate Professional,1828000,0,1828000
5633,3638,Shivaji Pandurang Adhav,PUNE,IND,0,Graduate Professional,2459700,715000,1744700
5634,3293,Shivakumar,TUMKUR,IND,0,10th Pass,1850000,0,1850000
5635,180,Shivakumar Chakari Urf Talawar,HAVERI,IND,0,Post Graduate,1180000,0,1180000
5636,3799,Shivakumar Navalisiddappa Tontapur,KOPPAL,AAP,0,Graduate,2725000,460000,2265000
5637,1215,Shivalingaiah,MANDYA,BJP,0,Doctorate,130363533,16531000,113832533
5638,3758,Shivamallu,CHAMARAJANAGAR,BSP,0,Post Graduate,1471630,266375,1205255
5639,1199,Shivashankar. G. R.,BANGALORE SOUTH,AIFB,0,Post Graduate,32522829,7800000,24722829
5640,4403,Shive Prasad Verma,HARDOI,BSP,6,8th Pass,26102946,5572545,20530401
5641,4478,Shivendra Kumar,KATIHAR,BSP,0,Post Graduate,495400,118033,377367
5642,6745,Shivkant,UNNAO,IND,0,12th Pass,26500,0,26500
5643,3552,Shivkhandeshwar Narayan Dahge,LATUR,Bharatiya Jawala Shakti Paksha,0,10th Pass,1032000,30000,1002000
5644,5423,Shivkumar Singh Shyam,SURGUJA,Rashtriya Gondvana Party,0,Post Graduate,235245,0,235245
5645,6751,Shivnath,UNNAO,IND,0,10th Pass,167000,0,167000
5646,1248,Shivnath Sav,KODARMA,IND,0,8th Pass,911000,121000,790000
5647,5100,Shivpal Singh Gujjar,DAUSA,IND,2,12th Pass,252107430,11833122,240274308
5648,182,Shobha Karandlaje,UDUPI CHIKMAGALUR,BJP,0,Post Graduate,72089452,38119792,33969660
5649,3470,Shobharam Mali,PALI,Jai Maha Bharath Party,0,10th Pass,2690500,0,2690500
5650,1941,Shoby Joseph,IDUKKI,IND,1,Others,10500,151600,0
5651,4824,Shoiab Khan,VIDISHA,Prajatantrik Samadhan Party,0,12th Pass,50000,0,50000
5652,2151,Shravan,BIDAR,Rashtriya Samaj Paksha,0,12th Pass,503900,50000,453900
5653,2028,Shravan Kumar Asija,HISAR,IND,0,12th Pass,2380000,0,2380000
5654,2774,Shree Kant Labh,PATNA SAHIB,Samajwadi Janata Party (Rashtriya),2,Post Graduate,57881,0,57881
5655,1077,Shreekant Kabadi,DHARWAD,IND,0,Graduate,9950010,427000,9523010
5656,4240,Shrelal Khare,KARAULI-DHOLPUR,Jai Maha Bharath Party,0,Literate,580000,0,580000
5657,501,Shri Chand Tanwar,SOUTH DELHI,CPI,0,8th Pass,7002415,0,7002415
5658,79,Shri Chandra Mohan Patowari,BARPETA,BJP,0,Post Graduate,12110465,1977898,10132567
5659,3590,Shri Chavan Ashokrao Shankarrao,NANDED,INC,0,Post Graduate,388758910,30513286,358245624
5660,2975,Shri Dhar Khare,KHAJURAHO,IND,0,8th Pass,5271817,0,5271817
5661,4436,Shri Manash Borah,GAUHATI,INC,0,Graduate Professional,44721819,19121889,25599930
5662,2505,Shri Parikshit Debbarma,TRIPURA EAST,BJP,0,10th Pass,1382000,30900,1351100
5663,1532,Shri Ram,SATNA,IND,0,Post Graduate,5309000,0,5309000
5664,765,Shri Subhash Shukla,CHHINDWARA,SP,0,12th Pass,380000,0,380000
5665,3485,Shridhar Jakhuji Darekar,AHMEDNAGAR,IND,0,Graduate Professional,15269913,864552,14405361
5666,1833,Shridhar Narayankar,BIJAPUR,AAP,0,Others,9261841,2133500,7128341
5667,2540,Shridhar Salve,NAGPUR,IND,0,12th Pass,300000,0,300000
5668,6824,Shrikant Shah,DURG,JD(U),1,10th Pass,994309,0,994309
5669,3885,Shrikant Vishnu Gadale,BEED,IND,0,10th Pass,45071,0,45071
5670,3240,Shrikanta Kumar Jena,BALASORE,INC,0,Graduate,11729649,5454370,6275279
5671,4724,Shrilal Kisku,DUMKA,IND,0,Graduate Professional,3050000,82000,2968000
5672,2219,Shrilatha Shetty,SHIMOGA,IND,0,10th Pass,1268000,337000,931000
5673,5299,Shrimali Ashokbhai Balchandbhai,BANASKANTHA,IND,0,10th Pass,284071,0,284071
5674,1813,Shrimant Balasaheb Patil,CHIKKODI,JD(S),5,Graduate,223524192,136392288,87131904
5675,5659,Shrinath Mithanthaya,THANE,Hindustan Janta Party,0,Post Graduate,50603500,11822000,38781500
5676,562,Shrinik Annasaheb Jangate,CHIKKODI,IND,0,12th Pass,500500,0,500500
5677,1979,Shripad Yesso Naik,NORTH GOA,BJP,0,Graduate,37019154,837843,36181311
5678,6663,Shripal,HAMIRPUR,Bundelkhand Congress,0,5th Pass,672500,0,672500
5679,3865,Shrirang Baburao Pakhare,SANGLI,IND,0,5th Pass,550000,0,550000
5680,867,Shruti Choudhry,BHIWANI-MAHENDRAGARH,INC,0,Graduate Professional,1083115000,106873000,976242000
5681,6320,Shruti Mishra,CUDDALORE,Union Party of India,0,Graduate Professional,5205760,0,5205760
5682,6041,Shukchand Murmu,HOOGHLY,Jharkhand Disom Party,0,10th Pass,3000,0,3000
5683,2101,Shushila,FARIDABAD,IND,0,10th Pass,40072745,0,40072745
5684,5483,Shushila Singh,BANDA,Bhartiya Shakti Chetna Party,0,5th Pass,1921772,0,1921772
5685,2269,Shuvadip Datta,SILCHAR,IND,0,12th Pass,6123000,365707,5757293
5686,2651,Shweta Pathak,BUXAR,AAP,0,Graduate,6953992,0,6953992
5687,5309,Shyal Bhartiben Dhirubhai,BHAVNAGAR,BJP,0,Graduate Professional,7748925,3072058,4676867
5688,1262,Shyam Lal Ram,PALAMAU,IND,0,Graduate,31205,0,31205
5689,2422,Shyam Lal Salvi,BHILWARA,IND,0,Post Graduate,999000,55000,944000
5690,2652,Shyam Lal Singh Kushwaha,BUXAR,JD(U),0,10th Pass,81811000,1932000,79879000
5691,2773,Shyam Nandan Prasad,PATNA SAHIB,IND,1,Doctorate,36572000,943000,35629000
5692,3713,Shyam Sundar Hansdah,MAYURBHANJ,INC,0,Graduate,32158487,9116999,23041488
5693,2401,Shyam Sunder Sharma,KOTA,IND,0,Graduate,1078797,0,1078797
5694,2599,Shyamkumar Bapurao Lokhande,YAVATMAL-WASHIM,IND,0,Graduate,3564000,0,3564000
5695,1527,Shyamlal Kushwaha,SATNA,GGP,0,Post Graduate,2689000,0,2689000
5696,1882,Shylock P.V.,PONNANI,AAP,1,Graduate,3748638,3000000,748638
5697,1158,Siba Hati,KALAHANDI,SP,0,8th Pass,1474000,100000,1374000
5698,1173,Sibasankar Ulaka,KORAPUT,BJP,1,Others,16500000,1750000,14750000
5699,4353,Sibendra Nath Sarkar,BALURGHAT,IND,1,8th Pass,419006,0,419006
5700,359,Siddappa Ganji,BIJAPUR,IND,0,12th Pass,128000,0,128000
5701,2152,Siddaramappa,BIDAR,IND,0,10th Pass,102000,0,102000
5702,3775,Siddesh,DAVANAGERE,IND,0,12th Pass,19035000,400000,18635000
5703,3866,Siddha Shivappa Bhosale,SANGLI,IND,0,5th Pass,126813,0,126813
5704,2967,Siddharth Kushwaha,KHAJURAHO,SP,1,Graduate,16254183,3200000,13054183
5705,1481,Siddharth Raut,CHANDRAPUR,Prabuddha Republican Party,0,Post Graduate,3927422,1000000,2927422
5706,3613,Siddik Ibrahim Boudiwali,OSMANABAD,IND,0,10th Pass,690000,50000,640000
5707,118,Sidhant Mohapatra,BERHAMPUR,BJD,0,Post Graduate,16462430,1183828,15278602
5708,3705,Sidram Krishna Dhobale,SOLAPUR,IND,0,5th Pass,66447,0,66447
5709,5247,Sikandar Tanti,BHAGALPUR,IND,0,8th Pass,805834,0,805834
5710,7663,Sikander Singh,GURDASPUR,IND,0,12th Pass,1500,0,1500
5711,714,Silvi Sunil,IDUKKI,AAP,0,Others,3080470,45000,3035470
5712,1239,Sima Chandravansi,CHATRA,AAP,0,Graduate Professional,1535000,120000,1415000
5713,3361,Sima Dharmanna Manikadi,MAVAL,Prabuddha Republican Party,0,5th Pass,0,0,0
5714,7761,Simarjeet Singh Bains,LUDHIANA,IND,2,Graduate,137823395,0,137823395
5715,7760,Simerjit Singh,LUDHIANA,IND,0,10th Pass,175000,0,175000
5716,7684,Simranjit Singh Mann,KHADOOR SAHIB,Shiromani Akali Dal (Amritsar)(Simranjit Sing,1,Graduate,190748401,1500000,189248401
5717,7312,Sindhi Mayyudeen Umarbhai,BHARUCH,IND,0,10th Pass,8501000,185000,8316000
5718,4549,Singareddy Ravindra Reddy,NIZAMABAD,Yuvajana Sramika Rythu Congress Party,0,Post Graduate,15940000,8000000,7940000
5719,5897,Singh Ashok Chandrapal,MUMBAI NORTH,BSP,0,Graduate,20480514,97109,20383405
5720,6026,Siraj Syed,BIRBHUM,INC,0,Graduate,6670489,815045,5855444
5721,4857,Siraj Uddin Ajmal,BARPETA,AIUDF,0,Graduate,670806607,0,670806607
5722,1112,Sirsat Haridas Ankush,AMRAVATI,IND,0,5th Pass,686000,70000,616000
5723,2029,Sita Ram,HISAR,IND,0,Graduate,1200500,400000,800500
5724,1599,Sita Ram Sareyam,CHHINDWARA,IND,0,10th Pass,180000,0,180000
5725,2857,Sita Ram Tudu,JAMSHEDPUR,SUCI(C),0,12th Pass,373970,0,373970
5726,2056,Sitender Singh,SONIPAT,IND,0,Post Graduate,50000,0,50000
5727,7155,Sivagurunathan .K,RAMANATHAPURAM,BSP,0,Post Graduate,695000,0,695000
5728,5679,Sivaji.S.M,NAMAKKAL,IND,0,5th Pass,0,0,0
5729,6871,Sivakumar . V,CHENNAI NORTH,SUCI(C),0,Others,266000,0,266000
5730,7464,Sivakumar.V,THANJAVUR,IND,0,10th Pass,6607342,2000000,4607342
5731,7583,Sivananenthaperumal.S.,TIRUNELVELI,DMDK,0,10th Pass,13577518,4272637,9304881
5732,7121,"Sivaperumal, K.",PERAMBALUR,IND,0,12th Pass,391003,0,391003
5733,7409,"Sivaprakasam, R.S.",VELLORE,IND,1,12th Pass,250500000,127200000,123300000
5734,6883,Sivashanmuga Perumal. S,CHENNAI NORTH,IND,0,Post Graduate,1866500,0,1866500
5735,5123,Siya Ram,TONK-SAWAI MADHOPUR,IND,0,8th Pass,151000,0,151000
5736,4282,Siya Ram Paswan,ETAWAH,Al-Hind Party,0,12th Pass,514030,40000,474030
5737,2982,Siyaram Singh Choudri,MORENA,IND,0,10th Pass,162500,0,162500
5738,6069,Sk Hasan Nawaj,ULUBERIA,AIUDF,0,Graduate Professional,7071618,0,7071618
5739,4833,Sk Nurul Islam,JANGIPUR,AITC,0,12th Pass,7489730,480000,7009730
5740,6019,Sk. Saidul Haque,BARDHAMAN-DURGAPUR,CPI(M),0,Post Graduate,11395974,0,11395974
5741,3334,Sk. Saleem,PARBHANI,Majlis Bachao Tahreek,0,5th Pass,60000,0,60000
5742,2779,Smt. Amrit Barsha,UDHAMPUR,SP,0,12th Pass,1500000,0,1500000
5743,4633,Smt. Basmati Kshatriyaa,RAIPUR,IND,0,8th Pass,337000,0,337000
5744,82,Smt. Bijoya Chakraborty,GAUHATI,BJP,0,Post Graduate,12574493,0,12574493
5745,3614,Smt. Jadhav Ujvala Eknath,OSMANABAD,IND,0,Graduate,1508000,600000,908000
5746,104,Smt. Kamla Patle,JANJGIR-CHAMPA,BJP,0,12th Pass,18224350,0,18224350
5747,72,Smt. Kirron Kher,CHANDIGARH,BJP,0,Post Graduate,335343871,1886187,333457684
5748,68,Smt. Meenakshi Lekhi,NEW DELHI,BJP,0,Graduate Professional,349916470,3275562,346640908
5749,4632,Smt. Meera Sharma,RAIPUR,IND,0,Post Graduate,210000,0,210000
5750,4100,Smt. Mridula Barkakoty,NOWGONG,AGP,0,Post Graduate,8081937,752111,7329826
5751,776,Smt. Prabhatai Madhukar Parlewar,BULDHANA,Narayani Sena,0,Post Graduate,11619000,0,11619000
5752,344,Smt. Priya K S,ATTINGAL,Welfare Party Of India,0,Post Graduate,4530512,0,4530512
5753,1702,Smt. Seema,GAUTAM BUDHHA NAGAR,Rashtriya Naujawan Dal,0,12th Pass,12201000,0,12201000
5754,956,Smt. Shobha Surendran,PALAKKAD,BJP,4,12th Pass,2027210,0,2027210
5755,230,Smt. Sumeeti,GAUTAM BUDHHA NAGAR,IND,0,8th Pass,1201712,675000,526712
5756,2890,Snehlata Jojo,SINGHBHUM,IND,0,Graduate Professional,2444000,0,2444000
5757,4759,Sobhal Singh,DEWAS,Samata Samadhan Party,0,5th Pass,445000,0,445000
5758,4758,Sodan Singh Dalmiya,DEWAS,Bahujan Mukti Party,0,Post Graduate,22000,0,22000
5759,7345,Sodha Salimbhai Nurmamadbhai,JAMNAGAR,IND,0,5th Pass,565130,0,565130
5760,153,Sohail Anwer,NAWADA,BSP,0,Literate,415000,85000,330000
5761,3450,Sohan Lal Goyal,JODHPUR,IND,0,Graduate,13682000,277000,13405000
5762,4751,Sohan Lal Uikey,BETUL,BSP,0,Post Graduate,271560,75000,196560
5763,5660,Sohanlal Purohit,THANE,IND,0,Others,1131348,300,1131048
5764,2830,Sohrab Shah,GIRIDIH,Bahujan Mukti Party,0,Literate,50000,0,50000
5765,4163,Sokol Hansda,DUMKA,BSP,0,10th Pass,1834000,0,1834000
5766,3892,Solanke Parmeshwar Kalyanrao,BEED,IND,0,Not Given,1683000,70000,1613000
5767,3893,Solanke Prkash Bhagwanrao,BEED,IND,0,5th Pass,1593500,0,1593500
5768,4564,Solanki Bharatbhai Madhavsinh,ANAND,INC,0,Graduate Professional,60484100,2334855,58149245
5769,6550,Solanki Chhaganbhai Kevalabhai,SABARKANTHA,IND,0,Post Graduate,2805000,0,2805000
5770,7294,Solanki Dineshkumar Aljibhai,BANASKANTHA,IND,1,12th Pass,840892,0,840892
5771,5342,Solanki Haribhai Boghabhai,JUNAGADH,Bahujan Mukti Party,0,Others,1695000,0,1695000
5772,7270,Solanki Rameshbhai Danabhai,AHMEDABAD WEST,IND,0,10th Pass,172000,0,172000
5773,7295,Solanki Saybabhai Nanabhai,BANASKANTHA,IND,0,5th Pass,180500,0,180500
5774,7271,Solanki Vitthalbhai Maganbhai,AHMEDABAD WEST,IND,0,12th Pass,430000,0,430000
5775,1324,Solomon George,NEW DELHI,BSP,0,Post Graduate,1501750,0,1501750
5776,4827,Som Hemram,BALURGHAT,Jharkhand Disom Party,0,Graduate,50500,0,50500
5777,2444,Soma Lal Koted,BANSWARA,Bahujan Mukti Party,0,12th Pass,12080300,0,12080300
5778,1913,Soman Pillai,THRISSUR,Indian Gandhiyan Party,0,Not Given,0,0,0
5779,382,Somaru Paswan,AURANGABAD,IND,0,Literate,3269500,0,3269500
5780,1938,Somini Prabhakaran,IDUKKI,IND,0,10th Pass,67800,10000,57800
5781,354,Somkuvar Vijay Sitaram,NAGPUR,IND,0,Not Given,104000,0,104000
5782,7637,Sonal Kellogg,NAVSARI,Voters Party,0,Post Graduate,2026644,41395,1985249
5783,3691,Sonali Chandrashekhar Thorat,SHIRUR,IND,0,8th Pass,630000,0,630000
5784,7266,Sonara Amrutbhai Khodabhai,AHMEDABAD WEST,Bahujan Suraksha Dal,0,5th Pass,824810,85000,739810
5785,3707,Sonawane Shivaji Chandrakant,SOLAPUR,IND,1,10th Pass,1289714,0,1289714
5786,5627,Sonawane Vandana Shivaji,RAVER,IND,0,Graduate,20000,0,20000
5787,888,Soni Soree,BASTAR,AAP,2,12th Pass,195000,250000,0
5788,6803,Sonia Das,HOWRAH,IND,0,Graduate,33227,0,33227
5789,5781,Sonia Gandhi,RAE BARELI,INC,0,Post Graduate,92895288,0,92895288
5790,1705,Sonia Sharma,GAUTAM BUDHHA NAGAR,Akhil Bharatiya Samajwadi Congress,0,Graduate,3327000,160000,3167000
5791,7247,Sonkamble Gajanan Tukaram,MUMBAI NORTH WEST,IND,0,12th Pass,128100,0,128100
5792,3697,Sonkamble Gautam Vijaykumar,SOLAPUR,Bharipa Bahujan Mahasangh,0,Graduate Professional,1729000,200000,1529000
5793,5871,Sonkamble Sulochana Dharmendra,KALYAN,Republican Bahujan Sena,1,Literate,1289000,0,1289000
5794,3324,Sontakke Laxman Kishan,NANDED,IND,0,12th Pass,10000,0,10000
5795,6427,Sonu Sarsal Valmiki,SECUNDERABAD,Telangana Communist Party of India,0,5th Pass,330184,0,330184
5796,535,Soso Lorho,OUTER MANIPUR,NPF,0,Graduate,13445800,0,13445800
5797,4369,Soumitra Ray,MALDAHA UTTAR,AITC,0,Graduate,5516468,0,5516468
5798,6043,Soumitra Sengupta,HOWRAH,SUCI(C),0,Graduate,21428,0,21428
5799,7071,Soundarajan.M,KRISHNAGIRI,IND,0,10th Pass,1608000,0,1608000
5800,6866,Soundarapandian .M,CHENNAI NORTH,DMDK,0,12th Pass,111177861,21244538,89933323
5801,7544,Soundhirapandian,VIRUDHUNAGAR,IND,0,5th Pass,705000,0,705000
5802,1878,Sreedharan,MALAPPURAM,IND,0,5th Pass,409000,0,409000
5803,1893,Sreejith,PALAKKAD,IND,0,Post Graduate,304185,158610,145575
5804,1809,Sreemathi Puthalath,KANNUR,IND,0,10th Pass,4840148,0,4840148
5805,309,Sreeni Jacob,KOTTAYAM,BSP,0,12th Pass,4000,0,4000
5806,1293,Sreerupa Mitra Chaudhury,SOUTH DELHI,AITC,0,Post Graduate,11823944,3788624,8035320
5807,3287,Sri Baijayant Panda,KENDRAPARA,BJD,0,Graduate Professional,312432726,300000,312132726
5808,2593,Sri Basavanagideva Sharanaru,CHITRADURGA,IND,0,Post Graduate,489561,0,489561
5809,2644,Sri Bhagwan Singh Kushwaha,ARRAH,RJD,1,10th Pass,7973528,2039416,5934112
5810,4440,Sri Biju Phukan,GAUHATI,AITC,0,Graduate,685000,0,685000
5811,2502,Sri Bikash Debbarma,TRIPURA EAST,Jai Maha Bharath Party,0,10th Pass,350000,1900000,0
5812,4432,Sri Dhiraj Medhi,GAUHATI,IND,0,10th Pass,23640000,120000,23520000
5813,2504,Sri Karna Bijoy Jamatia,TRIPURA EAST,AAP,0,10th Pass,8410000,0,8410000
5814,4433,Sri Padmeshwar Phukan,GAUHATI,IND,0,10th Pass,7324771,0,7324771
5815,2506,Sri. Hariharan K S,ATTINGAL,IND,0,Graduate Professional,2401400,0,2401400
5816,1972,Sri. Vakkom G Ajith,ATTINGAL,SHS,0,12th Pass,1120000,0,1120000
5817,342,Sri.Manoj Kumar,ATTINGAL,SDPI,2,Others,284000,199789,84211
5818,1971,Sri.Sambath Anilkumar,ATTINGAL,IND,0,8th Pass,3262,17000,0
5819,5518,Sridevi,FATEHPUR,IND,0,Illiterate,1990000,6000,1984000
5820,7447,Sridevi.S,TIRUCHIRAPPALLI,IND,0,12th Pass,735000,0,735000
5821,7379,"Sridhar, C. Thiru",SRIPERUMBUDUR,Ulzaipali Makkal Katchy,0,Post Graduate,1665000,248000,1417000
5822,6282,"Sridhar, R.S",ARAKKONAM,IND,0,Graduate,2006000,100000,1906000
5823,7391,"Sridhar,M.Thiru",SRIPERUMBUDUR,IND,0,10th Pass,90000,0,90000
5824,6986,"Sridharan, S.",COIMBATORE,IND,0,10th Pass,140000,0,140000
5825,6046,Sridip Bhattacharya,HOWRAH,CPI(M),57,Graduate Professional,225600,10000,215600
5826,833,Srihari Patanaik,BERHAMPUR,IND,0,12th Pass,976119,723600,252519
5827,1062,Srikant Arakeri,BIJAPUR,Karunaadu Party,0,Graduate,875500,390000,485500
5828,825,Srilokanath Ratha,ASKA,INC,0,Post Graduate,39978228,0,39978228
5829,6222,Srinivas Reddy Lingampally,KARIMNAGAR,IND,0,12th Pass,120000,0,120000
5830,2236,Srinivasa,UDUPI CHIKMAGALUR,IND,0,5th Pass,2452000,2060000,392000
5831,7011,Srinivasan C.,KANCHEEPURAM,IND,0,Post Graduate,2957000,0,2957000
5832,7362,Srinivasan. D,TIRUVALLUR,SP,0,Graduate Professional,425000,0,425000
5833,6885,Srinivasan. J,CHENNAI NORTH,IND,0,Graduate Professional,585030,375000,210030
5834,6877,Srinivason .S,CHENNAI NORTH,AAP,0,Graduate,30560936,1350000,29210936
5835,5707,Sriprakash Jaiswal,KANPUR,INC,0,12th Pass,44400261,0,44400261
5836,669,Ssomendar Dhaka,BAGHPAT,AAP,0,Graduate Professional,6488116,250000,6238116
5837,4717,Stephen Besra,DUMKA,Jharkhand Disom Party,0,10th Pass,1457179,250000,1207179
5838,7683,Stephen Masih,KHADOOR SAHIB,SARVAJAN SAMAJ PARTY (D),0,Graduate,763500,0,763500
5839,163,Subal Bhowmik,TRIPURA WEST,IND,1,Graduate Professional,4620411,0,4620411
5840,3390,Subarnamala Deb Barma,TRIPURA EAST,Amra Bangalee,0,8th Pass,7485,0,7485
5841,3254,Subas Chandra Mallick,JAJPUR,SUCI(C),0,Graduate,6000,0,6000
5842,3031,Subash Biswas,JALPAIGURI,IND,0,5th Pass,2117232,0,2117232
5843,576,Subash Chander,JAMMU,All J & K Kisan Majdoor Party,0,8th Pass,606100,0,606100
5844,788,Subash Chouhan,BARGARH,BJP,0,Graduate,455867,0,455867
5845,6979,"Subash, K.R.",COIMBATORE,IND,0,10th Pass,5818000,1950000,3868000
5846,7171,Subbiah .M,RAMANATHAPURAM,IND,0,10th Pass,837800,0,837800
5847,512,Subhas Sen,DIBRUGARH,CPI(ML)L,0,12th Pass,7032268,0,7032268
5848,2131,Subhash Bhimsha Sindankera,BIDAR,IND,0,5th Pass,306000,0,306000
5849,1656,Subhash Chand Kashyap,BAGHPAT,IND,0,Post Graduate,2539312,200000,2339312
5850,2415,Subhash Chandra Baheria,BHILWARA,BJP,0,Graduate,142870042,8665902,134204140
5851,7916,Subhash Chandra Lehri,LUCKNOW,IND,0,Graduate,863214,200000,663214
5852,1776,Subhash Chikbaraik,ALIPURDUARS,SUCI(C),0,10th Pass,1344,0,1344
5853,3372,Subhash Gopalrao Bodhe,MAVAL,IND,0,8th Pass,5030000,500000,4530000
5854,7702,Subhash Goria,JALANDHAR,SHS,0,10th Pass,3611885,1000000,2611885
5855,5178,Subhash Kalyanrao Lomte,AURANGABAD,AAP,0,Post Graduate,11681447,258000,11423447
5856,4848,Subhash Krishna Goswami,MALDAHA UTTAR,BJP,0,12th Pass,2236912,0,2236912
5857,4425,Subhash Maharia,SIKAR,IND,0,Graduate,74415150,3285722,71129428
5858,3673,Subhash Nivrutti Shilewant,SATARA,IND,0,12th Pass,34500,15000,19500
5859,627,Subhash Paswan,JAMUI,IND,0,Not Given,163000,0,163000
5860,4200,Subhash Patel,KHARGONE,BJP,0,Post Graduate,36138699,2300000,33838699
5861,7201,Subodh G. Ranjan,MUMBAI NORTH,IND,0,12th Pass,2621363,0,2621363
5862,2877,Subodh Kant Sahai,RANCHI,INC,1,Graduate Professional,258895068,3355000,255540068
5863,5038,Subodh Kumar,KANNAUJ,Peace Party,1,12th Pass,1686914,0,1686914
5864,4683,Subodh Kumar Gupta,DURG,RPI(A),0,12th Pass,11733950,600,11733350
5865,4465,Subodh Narayan Jha,BANKA,AITC,0,Graduate,7726666,2250000,5476666
5866,4735,Subodh Prasad,GODDA,AJSUP,0,Post Graduate,9435161,183000,9252161
5867,2866,Subodh Purty,KHUNTI,BSP,0,8th Pass,1060018,125000,935018
5868,7123,"Subramani, D.",PERAMBALUR,IND,0,12th Pass,2880137,0,2880137
5869,5681,Subramani.S,NAMAKKAL,IND,0,10th Pass,475000,0,475000
5870,7596,Subramanian @ S.S.S.Mani.S,TIRUNELVELI,IND,1,12th Pass,1408761,0,1408761
5871,7595,Subramanian.K,TIRUNELVELI,IND,0,5th Pass,250000,0,250000
5872,7111,"Subramaniyam, P.",NILGIRIS,IND,0,Literate,1005000,0,1005000
5873,5439,Subramaniyan A,TIRUVANNAMALAI,INC,0,Graduate Professional,10376045,864317,9511728
5874,3941,Subramaniyan G.R,NAMAKKAL,INC,0,Post Graduate,60136119,26717382,33418737
5875,2608,Subramanya Gowda K.,DAKSHINA KANNADA,IND,0,10th Pass,3695467,940000,2755467
5876,5029,Subrat Pathak,KANNAUJ,BJP,0,Graduate,23011868,9497355,13514513
5877,4852,Subrata Adhikary,RAIGANJ,IND,0,10th Pass,11228268,345538,10882730
5878,953,Subu Kechi,ARUNACHAL WEST,IND,1,Graduate Professional,785000,0,785000
5879,7658,Sucha Singh Chhotepur,GURDASPUR,AAP,0,Graduate,31270000,0,31270000
5880,7680,Sucha Singh Mann,KHADOOR SAHIB,BSP,0,8th Pass,15839056,2287814,13551242
5881,3337,Sucharita Mohanty,PURI,INC,0,Post Graduate,36546329,59551,36486778
5882,481,Sudarshan Bhagat,LOHARDAGA,BJP,0,Graduate,9031009,178967,8852042
5883,1084,Sudatta,DAKSHINA KANNADA,IND,0,10th Pass,326800,50000,276800
5884,2690,Suday Yadav,JAHANABAD,IND,0,10th Pass,4495000,0,4495000
5885,4495,Sudeep Roy,PURNIA,AAP,0,Post Graduate,24764655,0,24764655
5886,2876,Sudesh Kumar Mahto,RANCHI,AJSUP,0,Post Graduate,72986000,28544000,44442000
5887,1836,Sudhakar Kanamadi,BIJAPUR,BSP,0,Graduate,13314500,527933,12786567
5888,2596,Sudhakar Namdeorao Ghayawan,YAVATMAL-WASHIM,Republican Party of India (Khobragade),0,12th Pass,4025000,400000,3625000
5889,5875,Sudhakar Narayan Shinde,KALYAN,Ambedkarite Party of India,1,Post Graduate,28647744,0,28647744
5890,6953,Sudhamanirathinem,CHIDAMBARAM,Pattali Makkal Katchi,0,Post Graduate,24370129,0,24370129
5891,673,Sudhan Kumar,GHAZIABAD,SP,0,Graduate,180682500,0,180682500
5892,1235,Sudhanshu Suman,CHATRA,IND,0,Post Graduate,41861206,2258169,39603037
5893,63,Sudhansu Shekhar Bhaskar,JAMUI,RJD,0,Doctorate,13950638,1206926,12743712
5894,6332,Sudharshnar.K,DINDIGUL,IND,0,Graduate,3051385,0,3051385
5895,2237,Sudheer Kanchan,UDUPI CHIKMAGALUR,IND,0,Post Graduate,6657000,0,6657000
5896,164,Sudhindra Chandra Dasgupta,TRIPURA WEST,BJP,0,Graduate,2385517,0,2385517
5897,541,Sudhir Baban Surve,BULDHANA,AAP,0,Graduate,62153,0,62153
5898,2076,Sudhir Chandwas,BHIWANI-MAHENDRAGARH,IND,0,Graduate Professional,460000,0,460000
5899,4800,Sudhir Gautam,MANDSOUR,IND,0,5th Pass,371500,0,371500
5900,4203,Sudhir Gupta,MANDSOUR,BJP,0,Post Graduate,57429237,3058993,54370244
5901,3266,Sudhir Kumar Samal,DHENKANAL,INC,3,8th Pass,85901162,17484885,68416277
5902,7183,Sudhish L K,SALEM,DMDK,6,Graduate,339159159,96626000,242533159
5903,4384,Sudiip Ranjan Sen,RAIGANJ,SP,0,Others,649554210,226517331,423036879
5904,1912,Sufeera K. P.,THRISSUR,SDPI,1,8th Pass,104500,36000,68500
5905,7410,"Sugumar, K.",VELLORE,IND,0,Graduate,221700,0,221700
5906,1978,Suhas Naik,NORTH GOA,CPI,1,Graduate Professional,4483000,15000,4468000
5907,3674,Suhas Vishwasrao Deshmukh,SATARA,IND,0,Graduate,214884,0,214884
5908,6071,Sujata Dutta,ULUBERIA,Bahujan Mukti Party,0,10th Pass,0,0,0
5909,1792,Sujay Ghatak,DARJEELING,INC,0,Graduate,4787759,730303,4057456
5910,1338,Sujeet Jha,NEW DELHI,Bhartiya Janta Dal (Integrated),0,12th Pass,220000,40000,180000
5911,4757,Sujeet Sangte,DEWAS,AAP,0,12th Pass,622739,2225000,0
5912,3991,Sujit Kumar Ghosh,MURSHIDABAD,BJP,0,Graduate,3292077,0,3292077
5913,3222,Sujit Kumar Lugun,KEONJHAR,IND,0,12th Pass,5389000,64000,5325000
5914,2247,Sujit Mallick,KARIMGANJ,IND,0,10th Pass,200042,0,200042
5915,2262,Sukamal Das,SILCHAR,IND,0,8th Pass,25000,0,25000
5916,97,Sukanta Kumar Panigrahi,KANDHAMAL,BJP,2,Post Graduate,580000,120000,460000
5917,3428,Sukh Dev,JALORE,Awami Aamjan Party,0,5th Pass,2579600,80000,2499600
5918,5295,Sukhadiay Nathabhai Vallabhabhai,AMRELI,AAP,2,5th Pass,10587475,65000,10522475
5919,1588,Sukharam Astkar Lanji,BALAGHAT,IND,0,Post Graduate,2102000,0,2102000
5920,1783,Sukhbilas Barma,JALPAIGURI,INC,0,Doctorate,26547600,0,26547600
5921,445,Sukhbir Singh,SONIPAT,IND,0,Post Graduate,35860077,2625000,33235077
5922,2075,Sukhbir Singh,BHIWANI-MAHENDRAGARH,IND,0,10th Pass,234171,0,234171
5923,4246,Sukhbir Singh Jaunapuria,TONK-SAWAI MADHOPUR,BJP,0,12th Pass,714124612,0,714124612
5924,7685,Sukhchain Chand,KHADOOR SAHIB,Democratic Bharatiya Samaj Party,2,10th Pass,360000,0,360000
5925,5809,Sukhdev,UNNAO,Manavtawadi Samaj Party,0,Graduate Professional,4625523,120000,4505523
5926,7821,Sukhdev Ram Sharma,SANGRUR,CPI,0,10th Pass,8886669,0,8886669
5927,7832,Sukhdev Singh,SANGRUR,IND,0,Post Graduate,7126030,2528000,4598030
5928,7689,Sukhdev Singh Chohan,KHADOOR SAHIB,IND,0,8th Pass,615500,0,615500
5929,7820,Sukhdev Singh Dhindsa,SANGRUR,SAD,0,Graduate,87588083,2000000,85588083
5930,3904,Sukhnandan Deshkar,MAHASAMUND,IND,0,8th Pass,7750000,465000,7285000
5931,1273,Sukhveer,FARIDABAD,Rashtriya Bahujan Congress Party,0,5th Pass,1303736,0,1303736
5932,6652,Sukhvindra Singh,DHAURAHRA,Nav Bharat Democratic Party,0,10th Pass,150025,0,150025
5933,7690,Sukhwant Singh,KHADOOR SAHIB,IND,0,10th Pass,800000,7000,793000
5934,7803,Sukhwinder Singh,BATHINDA,Bahujan Mukti Party,0,12th Pass,241500,0,241500
5935,7653,Sukhwinder Singh,GURDASPUR,BSP,0,Graduate,22213245,1505787,20707458
5936,7700,Sukhwinder Singh Kotli,JALANDHAR,BSP,0,10th Pass,2926365,715175,2211190
5937,7748,Sukhwinder Singh Sekhon,LUDHIANA,CPI(M),0,Graduate,4941720,35000,4906720
5938,6797,Sukumar Baral,HOWRAH,Bahujan Mukti Party,0,12th Pass,3150000,22500,3127500
5939,3285,Sukumar Mallick,KENDRAPARA,IND,0,12th Pass,297207,0,297207
5940,2395,Suleman,JHALAWAR-BARAN,IND,0,8th Pass,150000,0,150000
5941,1014,Sulochana Devi,NAWADA,IND,0,Literate,7275000,800000,6475000
5942,6066,Sultan Ahmed,ULUBERIA,AITC,0,Graduate,22792936,10878739,11914197
5943,4700,Suman Banerjee,DHANBAD,IND,0,8th Pass,3117000,27000,3090000
5944,5250,Suman Kumar,BHAGALPUR,IND,0,Graduate,492000,0,492000
5945,450,Suman Singh,SONIPAT,BSP,0,10th Pass,21283460,450000,20833460
5946,6708,Suman Verma,LUCKNOW,Bhartiya Shakti Chetna Party,0,8th Pass,156791,21000,135791
5947,1285,Sumant Kumar,SOUTH DELHI,IND,1,Graduate,26172006,250729,25921277
5948,2345,Sumedha Nand Saraswati,SIKAR,BJP,0,Others,34311,0,34311
5949,5811,Sumit Tewari,UNNAO,Nav Bharat Democratic Party,0,Graduate Professional,5607986,218321,5389665
5950,4765,Sumitra Mahajan,INDORE,BJP,0,Post Graduate,18732234,3539000,15193234
5951,3891,Sumitrabai Dashrath Pawar,BEED,IND,0,Illiterate,0,0,0
5952,5936,Sundar Balkrishnan,MUMBAI SOUTH CENTRAL,AAP,0,Post Graduate,30571000,0,30571000
5953,6886,Sundar. G,CHENNAI NORTH,IND,0,5th Pass,221000,0,221000
5954,3943,Sundaram P.R,NAMAKKAL,AIADMK,0,Graduate,126539914,92677412,33862502
5955,7065,Sundaram.S,KRISHNAGIRI,United Communist Party of India,0,10th Pass,184000,78000,106000
5956,7454,Sundarraj.S,TIRUCHIRAPPALLI,IND,0,Graduate,2661024,0,2661024
5957,2030,Sunder,HISAR,IND,0,Literate,10170500,300000,9870500
5958,735,Sunder Lal Tiwari,REWA,INC,0,Graduate Professional,45035366,349790,44685576
5959,5017,Sunhari Lal,HATHRAS,AAP,0,10th Pass,24391902,7734490,16657412
5960,3150,Sunil,NAGINA,IND,0,10th Pass,942300,0,942300
5961,3461,Sunil,NAGAUR,IND,0,8th Pass,254232,0,254232
5962,2417,Sunil Agiwal,BHILWARA,AAP,0,Graduate Professional,43218483,11297000,31921483
5963,3648,Sunil Alias Yashwant Vasant Pednekar,RATNAGIRI SINDHUDURG,IND,0,10th Pass,1697200,125000,1572200
5964,2290,Sunil Bhadrawal,GANGANAGAR,Lok Dal,0,Graduate,1193000,0,1193000
5965,4400,Sunil Bharti,HARDOI,Rashtriya Ambedkar Dal,0,10th Pass,286500,0,286500
5966,2906,Sunil Borse,BHOPAL,BSP,0,10th Pass,5058000,800000,4258000
5967,812,Sunil Chandra Naik,KALAHANDI,Odisha Jan Morcha,0,Graduate Professional,2900000,0,2900000
5968,1317,Sunil Chhikara,NORTH WEST DELHI,IND,3,Graduate Professional,32150000,0,32150000
5969,1448,Sunil Dattu Pendor,NAGPUR,Bahujan Mukti Party,0,Post Graduate,1218560,0,1218560
5970,1120,Sunil David Amravati,AMRAVATI,Bahujan Mukti Party,0,Graduate Professional,21139,0,21139
5971,6592,Sunil Digambar Kulkarni,VADODARA,AAP,0,Others,12110000,2680000,9430000
5972,1631,Sunil Dutt,MEERUT,IND,0,12th Pass,10218400,0,10218400
5973,1719,Sunil Gautam,GAUTAM BUDHHA NAGAR,IND,2,8th Pass,37800,0,37800
5974,6724,Sunil Gautam,MOHANLALGANJ,AAP,0,Graduate,1307500,418000,889500
5975,2945,Sunil Gopal,GWALIOR,SUCI(C),0,Graduate Professional,119963,0,119963
5976,6149,Sunil Jakhar,FIROZPUR,INC,0,Post Graduate,253069342,0,253069342
5977,6755,Sunil Kumar,BEGUSARAI,AAP,0,Post Graduate,21040706,150000,20890706
5978,1295,Sunil Kumar,SOUTH DELHI,IND,0,10th Pass,3125000,0,3125000
5979,3088,Sunil Kumar,BAREILLY,AAP,0,Graduate,1919000,0,1919000
5980,2758,Sunil Kumar,PATALIPUTRA,Samajwadi Janata Party (Rashtriya),0,12th Pass,800000,150000,650000
5981,1269,Sunil Kumar,ROHTAK,AITC,0,Graduate,339277,0,339277
5982,4731,Sunil Kumar Gupta,GODDA,IND,0,10th Pass,1285001,0,1285001
5983,657,Sunil Kumar Kasana,KAIRANA,AAP,0,12th Pass,20795589,1250000,19545589
5984,6007,Sunil Kumar Mondal,BARDHAMAN PURBA,AITC,0,Graduate Professional,11841000,1420000,10421000
5985,6017,Sunil Kumar Purkait,BARDHAMAN-DURGAPUR,SUCI(C),0,12th Pass,678858,0,678858
5986,1230,Sunil Kumar Singh,CHATRA,BJP,0,Post Graduate,174744806,950052,173794754
5987,2753,Sunil Kumar Singh,PATALIPUTRA,IND,0,Post Graduate,123369500,61000,123308500
5988,7910,Sunil Massey,JHANSI,SHS,0,12th Pass,3113,0,3113
5989,3030,Sunil Pandit,DARJEELING,Rashtriya Janasachetan Party,0,8th Pass,848600,0,848600
5990,6703,Sunil Singh,LUCKNOW,Lok Dal,0,Graduate Professional,50412000,11932000,38480000
5991,1550,Sunil Soni,SIDHI,Bahujan Sangharshh Dal,0,12th Pass,281653,0,281653
5992,4729,Sunil Soren,DUMKA,BJP,1,12th Pass,2944200,0,2944200
5993,1307,Sunil Sourabh,WEST DELHI,IND,0,Post Graduate,4963000,0,4963000
5994,2628,Sunil.V.J,BANGALORE NORTH,IND,0,10th Pass,3845084,641000,3204084
5995,339,Sunilkrishnan,ATTINGAL,IND,2,Post Graduate,5310000,0,5310000
5996,656,Sunita,KAIRANA,JD(U),0,Graduate,120000,0,120000
5997,1342,Sunita Chaudhary,NEW DELHI,JKNPP,0,10th Pass,2129016,3180,2125836
5998,3056,Sunita Shakya,AONLA,BSP,0,12th Pass,46011233,0,46011233
5999,3215,Sunita Sujata Nagpal,SHAHJAHANPUR,Peace Party,0,Graduate,77086,0,77086
6000,3706,Sunita Vijaykumar Ughade,SOLAPUR,IND,0,Literate,133900,225000,0
6001,3348,Sunjoy Hans,BHUBANESWAR,Aama Odisha Party,0,10th Pass,659112136,143674099,515438037
6002,3272,Suparno Satpathy,DHENKANAL,Aama Odisha Party,0,Graduate,48872009,702378,48169631
6003,2606,Supreeth Kumar Poojary,DAKSHINA KANNADA,Hindustan Janta Party,0,10th Pass,1388000,142250,1245750
6004,3386,Supriya Sule,BARAMATI,NCP,0,Graduate,1139090851,0,1139090851
6005,4748,Surae Soren,RAJMAHAL,IND,0,Doctorate,566012,0,566012
6006,3723,Suraiya Zaithoon,BANGALORE CENTRAL,IND,1,Others,85000,0,85000
6007,4232,Suraj Bhan,DAUSA,SP,0,Post Graduate,5582551,0,5582551
6008,6800,Suraj Narayan Singh,HOWRAH,AAP,0,Post Graduate,12789723,2765000,10024723
6009,3530,Suraj Vishwanath Kondarwad,HINGOLI,IND,0,Graduate Professional,0,0,0
6010,4090,Surat Jaman Mondal,DHUBRI,SUCI(C),0,Others,328926,7471,321455
6011,3651,Surekha Alias Suraiyya Shahin Shaikh,SANGLI,Maharashtra Vikas Aghadi,0,Graduate,300000,0,300000
6012,4844,Suren Murmu,MALDAHA UTTAR,IND,0,8th Pass,533000,0,533000
6013,893,Surender Kumar,CHANDIGARH,Bahujan Mukti Party,0,Graduate,304607,151340,153267
6014,200,Surender Kumar,SIRSA,IND,0,12th Pass,131500,0,131500
6015,979,Surender Singh,CHANDNI CHOWK,IND,0,Graduate,7902603,0,7902603
6016,3762,Surendra B. P.,CHAMARAJANAGAR,Sarva Janata Party,0,Graduate,272500,0,272500
6017,3421,Surendra Kumar Jain,AJMER,IND,0,Graduate,1242221,0,1242221
6018,2342,Surendra Kumar Phulwariya,SIKAR,IND,4,Post Graduate,70250,0,70250
6019,2347,Surendra Kumar Punia,SIKAR,AAP,0,Graduate Professional,15949561,3984000,11965561
6020,4145,Surendra Lal Singh,SURGUJA,CPI(M),0,Post Graduate,97692,33620,64072
6021,4817,Surendra Mehar,UJJAIN,IND,2,10th Pass,282100,0,282100
6022,6687,Surendra Mohan Agarwal,KANPUR,SP,4,12th Pass,31375148,1025487,30349661
6023,5027,Surendra Nath,KANNAUJ,Bahujan Mukti Party,0,Graduate,1998000,0,1998000
6024,2670,Surendra Prasad Yadav,JAHANABAD,RJD,3,Not Given,49462901,1022720,48440181
6025,152,Surendra Rajvanshi,NAWADA,SP,0,Graduate,3385189,0,3385189
6026,146,Surendra Ram,SASARAM,IND,0,5th Pass,9289000,200000,9089000
6027,3044,Surendra Singh,AMROHA,IND,0,Post Graduate,36813206,0,36813206
6028,4578,Surendrabhai Simabhai Gamit,BARDOLI,IND,0,10th Pass,31216000,0,31216000
6029,1797,Surendrajeet Singh Ahluwalia,DARJEELING,BJP,0,Graduate Professional,23377223,443035,22934188
6030,1977,Suresh,ATTINGAL,IND,0,10th Pass,56000,0,56000
6031,1974,Suresh,ATTINGAL,IND,0,8th Pass,2360000,0,2360000
6032,1731,Suresh,BULANDSHAHR,Jai Maha Bharath Party,0,8th Pass,126500,0,126500
6033,3846,Suresh,KOPPAL,IND,0,5th Pass,1600000,70000,1530000
6034,4250,Suresh,TONK-SAWAI MADHOPUR,BSP,0,Graduate,2065000,0,2065000
6035,1181,Suresh Angadi,BELGAUM,BJP,1,Graduate Professional,417003065,366283849,50719216
6036,3494,Suresh Baburao Veer,BARAMATI,IND,0,10th Pass,3425000,15000,3410000
6037,4985,Suresh Chand Saaraswat,FARRUKHABAD,IND,0,Post Graduate,22245,0,22245
6038,5784,Suresh Chandra Mishra,RAE BARELI,Manavtawadi Samaj Party,0,12th Pass,2545709,0,2545709
6039,7540,Suresh Gandhi,VIRUDHUNAGAR,IND,0,12th Pass,1231198,0,1231198
6040,7203,Suresh Giga Dabhi,MUMBAI NORTH CENTRAL,IND,0,Literate,2057768,2103322,0
6041,5182,Suresh Gopinath Mhatre,BHIWANDI,MNS,2,12th Pass,26619897,1283975,25335922
6042,5626,Suresh Hiraman Ingale,RAVER,IND,0,Post Graduate,390000,115000,275000
6043,5191,Suresh Kaluram Jadhav,BHIWANDI,IND,0,8th Pass,2264906,115000,2149906
6044,3385,Suresh Khopade,BARAMATI,AAP,0,Graduate Professional,31870466,0,31870466
6045,5274,Suresh Kumar Ajad,SUPAUL,Jai Hind Party,0,Post Graduate,1051233,30000,1021233
6046,7804,Suresh Kumar Goyal,BATHINDA,Janral Samaj Party,0,Others,1506952,123000,1383952
6047,4556,Suresh Kumar Shetkar,ZAHIRABAD,INC,0,Graduate,29458057,324258,29133799
6048,7366,Suresh Kumar. S,TIRUVALLUR,IND,0,8th Pass,212000,0,212000
6049,7597,Suresh Kumar.S,TIRUNELVELI,IND,0,Graduate Professional,320000,250000,70000
6050,2172,Suresh Maharudrappa Mundargi,HAVERI,Rani Chennamma Party,0,10th Pass,1162000,0,1162000
6051,1672,Suresh Pal,GHAZIABAD,Bharatiya Sarvodaya Kranti Party,0,12th Pass,63170,0,63170
6052,3867,Suresh Parth Mane (Nana),SANGLI,IND,0,12th Pass,154500,0,154500
6053,1143,Suresh Pujari,SAMBALPUR,BJP,0,Post Graduate,8684372,0,8684372
6054,5260,Suresh Rai,KATIHAR,Rashtravadi Janata Party,0,8th Pass,672000,80000,592000
6055,1504,Suresh Rajaram Mukhmale,YAVATMAL-WASHIM,Maharashtra Vikas Aghadi,0,12th Pass,3280000,0,3280000
6056,3570,Suresh Shamrao Ghadge,MADHA,AITC,0,Literate,3000000,0,3000000
6057,4218,Suresh Sharma,ALWAR,Jago Party,0,10th Pass,275000,0,275000
6058,2882,Suresh Toppo,RANCHI,Jharkhand Disom Party,0,Graduate,427491,0,427491
6059,2541,Suresh Udhavrao Shinde,NAGPUR,IND,0,Graduate Professional,2545000,0,2545000
6060,3507,Sureshdada Patil,HATKANANGLE,IND,0,Graduate,47349446,12294173,35055273
6061,898,Surinder Bhardwaj,CHANDIGARH,JD(U),0,Graduate,419506,0,419506
6062,7672,Surinder Kumar Khosla,AMRITSAR,IND,0,10th Pass,1988000,200000,1788000
6063,2089,Surinder Kumar Khullar,GURGAON,IND,0,Graduate,15164593,3641000,11523593
6064,409,Surinder Pal Singh,AMBALA,AAP,0,Post Graduate,15369639,2104283,13265356
6065,7666,Surinder Singh,AMRITSAR,Democratic Congress Party,0,Not Given,42000,0,42000
6066,5623,Surwade Jairam Girdhar,RAVER,IND,0,Post Graduate,9555000,0,9555000
6067,2455,Surya Bhavani Singh Chawada,RAJSAMAND,IND,0,Graduate Professional,3121717,225545,2896172
6068,3529,Suryawanshi Ashok Bhagwanrao,HINGOLI,IND,0,Graduate Professional,10055500,175000,9880500
6069,3309,Suryawanshi Dattaram Balaji,NANDED,IND,0,8th Pass,7263132,841037,6422095
6070,3553,Suryawansi Sidharth Tukaram,LATUR,Bahujan Mukti Party,0,Doctorate,3537300,627000,2910300
6071,2707,Suryoday Paswan,MUNGER,Sankhyanupati Bhagidari Party,0,Graduate,627000,0,627000
6072,6073,Susanta Kumar Dalui,ULUBERIA,IND,0,10th Pass,1407093,204956,1202137
6073,3252,Susanta Kumar Jena,BHADRAK,IND,0,10th Pass,15000,0,15000
6074,3639,Sushama Pandurang Gaikwad,PUNE,IND,0,10th Pass,30300,0,30300
6075,3508,Sushant Santosh Dige,HATKANANGLE,IND,0,12th Pass,2135600,610000,1525600
6076,427,Sushil Kaushik,HISAR,IND,0,Post Graduate,51500,0,51500
6077,6753,Sushil Kumar,BEGUSARAI,IND,0,10th Pass,687780,0,687780
6078,7812,Sushil Kumar Jindal,BATHINDA,IND,0,10th Pass,100000,0,100000
6079,371,Sushil Kumar Singh,AURANGABAD,BJP,5,Post Graduate,127845854,7321626,120524228
6080,430,Sushil Nidhi,HISAR,IND,0,12th Pass,2306220,800000,1506220
6081,5772,Sushila Saroj,MOHANLALGANJ,SP,1,Graduate Professional,66958969,0,66958969
6082,3615,Sushilkumar Vinayak Padule,OSMANABAD,IND,0,10th Pass,25500,0,25500
6083,489,Sushma Mehta,PALAMAU,CPI(ML)L,6,12th Pass,2305547,651713,1653834
6084,4818,Sushma Swaraj,VIDISHA,BJP,0,Graduate Professional,175516422,6500000,169016422
6085,1124,Sushma Vitthal Nagpure,BHANDARA-GONDIYA,IND,0,12th Pass,1060000,0,1060000
6086,2255,Sushmita Dev,SILCHAR,INC,1,Post Graduate,87495844,12008613,75487231
6087,108,Sushree Saroj Pandey,DURG,BJP,0,Doctorate,3200925,508039,2692886
6088,7336,Sutariya Dipikaben Jitendrakumar,GANDHINAGAR,IND,0,Graduate,643369,0,643369
6089,7346,Suthar Hansaben Harsukbhai (Gorecha),JAMNAGAR,IND,0,5th Pass,5000,0,5000
6090,6384,Sutharapu Padmaiah,CHEVELLA,Andhra Pradesh Rashtra Samaikya Samithi Party,0,Graduate,5359000,0,5359000
6091,7872,Sutharapu Padmaiah,MALKAJGIRI,Andhra Pradesh Rashtra Samaikya Samithi Party,0,Graduate,5359000,0,5359000
6092,6029,Suttam Das,BIRBHUM,IND,0,5th Pass,20000,0,20000
6093,6712,Swadesh Kumar,MISRIKH,IND,0,12th Pass,616631,0,616631
6094,61,Swadesh Ohri,NEW DELHI,Atulya Bharat Party,0,12th Pass,25102378,0,25102378
6095,5504,Swami Dayal,DHAURAHRA,Shreshthatam Rashtra Party,0,5th Pass,21000,0,21000
6096,5810,Swami Sachchidanand Hari Sakshi,UNNAO,BJP,8,Doctorate,32137597,0,32137597
6097,4382,Swapan Kumar Das,RAIGANJ,BSP,0,10th Pass,4233000,0,4233000
6098,4377,Swapan Kumar Mandal,MURSHIDABAD,Amra Bangalee,0,10th Pass,734500,0,734500
6099,6014,Swapan Malik,BARDHAMAN PURBA,JMM,0,Literate,14600,0,14600
6100,6152,Swaran Singh,FIROZPUR,IND,0,Graduate,11175000,1320000,9855000
6101,6119,Swaran Singh,BATHINDA,IND,0,Graduate,11175000,1320000,9855000
6102,4099,Swarnalata Chaliha,MANGALDOI,SUCI(C),0,Post Graduate,96500,0,96500
6103,1992,Swati Kerkar,SOUTH GOA,AAP,0,12th Pass,693648,0,693648
6104,2509,Syamalakumari,THIRUVANANTHAPURAM,IND,0,5th Pass,0,0,0
6105,6212,Syed Abdul Gaffer,HYDERABAD,IND,0,12th Pass,109250,0,109250
6106,4690,Syed Abid Ahmad Shah,ANANTNAG,JKNPP,0,10th Pass,20974,0,20974
6107,4459,Syed Alamdar Hussain,ARARIA,IND,0,12th Pass,3610000,0,3610000
6108,6706,Syed Ali Husain,LUCKNOW,IND,0,Literate,1462000,0,1462000
6109,3798,Syed Arif,KOPPAL,BSP,1,12th Pass,10000,5000,5000
6110,854,Syed Asif Bukhaari,BANGALORE CENTRAL,IND,0,12th Pass,325897,0,325897
6111,6207,Syed Hashmathullah Quadri,CHEVELLA,IUML,0,10th Pass,42927651,1030000,41897651
6112,6705,Syed Jawed Ahmad Jafri,LUCKNOW,AAP,0,12th Pass,266571149,63035459,203535690
6113,3041,Syed Kalbe Rushaid Rizvi,AMROHA,AAP,0,Others,5709549,25000,5684549
6114,6426,Syed Madani Quadri,SECUNDERABAD,IND,0,12th Pass,50000,0,50000
6115,3746,Syed Mehaboob,BANGALORE SOUTH,JD(U),0,12th Pass,5572310,0,5572310
6116,6314,Syed Mohideen.A.G.,CUDDALORE,AAP,0,Graduate,23090724,3340000,19750724
6117,7895,Syed Mustafa Mahmood,HYDERABAD,Majlis Bachao Tahreek,0,12th Pass,400000,0,400000
6118,4189,Syed Nizam Ahmed,INDORE,IND,0,12th Pass,2425000,0,2425000
6119,3753,Syed Rafiq Ahmed,BANGALORE SOUTH,IND,0,5th Pass,1981000,0,1981000
6120,6448,Syed Sajid Ali,SECUNDERABAD,Yuvajana Sramika Rythu Congress Party,1,Graduate Professional,3671549,0,3671549
6121,3183,Syed Salman Ali,RAMPUR,AAP,0,Graduate,2118955,0,2118955
6122,5268,Syed Shah Iqbal Alam,PURNIA,Bhartiya Ekta Manch Party,0,12th Pass,18201000,0,18201000
6123,4075,Syed Shahnawaz Hussain,BHAGALPUR,BJP,0,10th Pass,47044000,14007000,33037000
6124,2140,Syed Waheed,BIDAR,Bahujan Mukti Party,1,10th Pass,1425000,0,1425000
6125,2318,Syopat Ram,CHURU,Bharatiya Sant Mat Party,0,10th Pass,202400,0,202400
6126,1922,T D Baburajan,CHALAKUDY,IND,0,12th Pass,5278500,180000,5098500
6127,1953,T S Balakrishnan,ALAPPUZHA,IND,0,12th Pass,50,0,50
6128,3771,T V Manjunatha Gowda,CHIKKBALLAPUR,IND,0,10th Pass,7718000,300000,7418000
6129,2583,T. Dayananda,CHITRADURGA,IND,0,5th Pass,3483000,30000,3453000
6130,6918,T. Dhanasekar,CHENNAI SOUTH,National Organisation Congress,0,Graduate Professional,3060000,0,3060000
6131,3751,T. E. Moses,BANGALORE SOUTH,IND,0,Not Given,7963850,0,7963850
6132,296,T. L. Santhosh,THRISSUR,IND,6,Not Given,7597000,530000,7067000
6133,6942,T. Ponnusamy,CHENNAI SOUTH,IND,0,8th Pass,247855,0,247855
6134,6861,T. Ravikumar,CHENNAI CENTRAL,IND,0,8th Pass,116000,0,116000
6135,278,T.Ayyappan,PONNANI,BSP,0,Post Graduate,3324000,0,3324000
6136,3292,T.Bhavana,CHITRADURGA,IND,0,10th Pass,100000,0,100000
6137,6447,T.Bheemsen,SECUNDERABAD,TRS,0,Graduate Professional,36454841,6000000,30454841
6138,3779,T.D. Jagadeesha,HASSAN,IND,0,10th Pass,20000,0,20000
6139,6951,T.K. Ramajayam,CHENNAI SOUTH,IND,0,Graduate Professional,5312700,0,5312700
6140,6930,T.K.S.Elangovan,CHENNAI SOUTH,DMK,0,Post Graduate,20482886,675903,19806983
6141,1937,T.K.Tomy,IDUKKI,CPI(ML) Red star,0,Others,404000,0,404000
6142,3964,T.N.Bharath Nachiappan,MADURAI,INC,0,Post Graduate,5559753,0,5559753
6143,6364,T.Ramachandiran,KALLAKURICHI,IND,0,5th Pass,52095,0,52095
6144,7489,T.Ramasamy,MADURAI,IND,0,5th Pass,118530,0,118530
6145,2635,T.S.Chaitanya,BANGALORE NORTH,IND,0,Others,1203291,0,1203291
6146,7427,T.S.Senthilkumar,TIRUPPUR,IND,0,10th Pass,130600,0,130600
6147,954,T.Siddique,KASARAGOD,INC,7,Graduate Professional,6779637,1849149,4930488
6148,3834,T.Sivagnanasambandan,CUDDALORE,IND,0,Post Graduate,8496700,30000,8466700
6149,2580,T.Somesh,CHITRADURGA,IND,0,5th Pass,5488000,0,5488000
6150,952,Taba Taku,ARUNACHAL WEST,Lok Bharati,0,Graduate,6200000,0,6200000
6151,1415,Tadas Vilas Krushnaji,WARDHA,IND,0,Graduate,3118896,0,3118896
6152,6450,Tagaram Shankar Lal,PEDDAPALLE,BSP,2,Post Graduate,690600,0,690600
6153,405,Takam Sanjoy,ARUNACHAL WEST,INC,0,Graduate,105915042,0,105915042
6154,4746,Tala Hansda,RAJMAHAL,IND,0,8th Pass,1714000,0,1714000
6155,6473,Talari Ramulu,NIZAMABAD,BSP,0,12th Pass,500000,0,500000
6156,6963,"Tamilnadu Selvam, Era.",COIMBATORE,BSP,0,5th Pass,35000,0,35000
6157,6980,"Tamilselvan, K.",COIMBATORE,IND,0,Graduate Professional,425000,0,425000
6158,7458,Tamilselvi.S,THANJAVUR,CPI(M),0,Post Graduate,221758,0,221758
6159,3985,Tamradwaj Sahu,DURG,INC,0,12th Pass,21002226,1777720,19224506
6160,3653,Tanajirao Jagannath Jadhav(Chinchanikar),SANGLI,IND,0,Graduate,203614,76363,127251
6161,7779,Tandale Ambaji Rao,ZAHIRABAD,IND,0,5th Pass,1925935,35544,1890391
6162,143,Tanish Orang,LAKHIMPUR,CPI(ML)L,0,8th Pass,295642,0,295642
6163,4685,Tanveer Hussain Khan,ANANTNAG,IND,0,Graduate Professional,23200000,0,23200000
6164,4147,Tanvir Maqbool Dar,ANANTNAG,AAP,0,Graduate Professional,16821474,3959860,12861614
6165,4908,Tapan Dasgupta,VADODARA,SUCI(C),0,Graduate Professional,191809,0,191809
6166,8355,Tapan Kumar Saha,BOLPUR,INC,0,Graduate,4778715,576297,4202418
6167,2661,Taphir Husain,BUXAR,Hindustan Vikas Dal,0,5th Pass,310000,0,310000
6168,247,Tapir Gao,ARUNACHAL EAST,BJP,0,Post Graduate,82370000,300000,82070000
6169,4639,Tara Singh,RAIGARH,AAP,0,Graduate,5623449,300000,5323449
6170,7705,Tara Singh Gill,JALANDHAR,Bahujan Samaj Party (Ambedkar),0,5th Pass,766660,400000,366660
6171,1144,Tarani Bhoi,SAMBALPUR,Paschimanchal Vikas Party,0,10th Pass,2587176,547876,2039300
6172,4694,Tarch Murmu,DHANBAD,IND,0,Graduate,1909310,0,1909310
6173,6815,Tariq Hameed Karra,SRINAGAR,JKPDP,0,Graduate Professional,984556436,1500000,983056436
6174,989,Tariq Mirza,CHANDNI CHOWK,RPI(A),0,8th Pass,110000,0,110000
6175,4966,Tariq Parvez,FARRUKHABAD,AAP,0,12th Pass,1141000,0,1141000
6176,3616,Tarkase Pushpa,OSMANABAD,Hindusthan Nirman Dal,0,10th Pass,75000,0,75000
6177,7714,Tarsem Peter,JALANDHAR,IND,0,Graduate,401029,0,401029
6178,3429,Tarun Kumar,JALORE,IND,0,10th Pass,255000,0,255000
6179,2248,Tarun Kumar Das,KARIMGANJ,AAP,0,10th Pass,391000,0,391000
6180,4631,Tarzan Jangde,RAIPUR,IND,0,12th Pass,580000,0,580000
6181,4456,Taslim Uddin,ARARIA,RJD,4,Literate,42368468,1026919,41341549
6182,3853,Tate Ashok Santram,BEED,Ambedkarist Republican Party,0,12th Pass,25000,0,25000
6183,3263,Tathagata Satpathy,DHENKANAL,BJD,7,Others,35434099,0,35434099
6184,6001,Tatkare Sunil Dattatrey,RAIGAD,NCP,0,Others,100643136,2482602,98160534
6185,5993,Tatkare Sunil Sham,RAIGAD,IND,0,12th Pass,726710,0,726710
6186,3388,Tatyaso Sitaram Tele,BARAMATI,JD(S),1,Literate,1366907,500000,866907
6187,5313,Taviyad Dr. Prabhaben Kishorsinh,DAHOD,INC,0,Post Graduate,22778000,0,22778000
6188,3133,Teaj Singh Saini,MORADABAD,Rashtriya Samanta Dal,0,Illiterate,480000,0,480000
6189,4630,Teekam Kumar Tondre,RAIPUR,IND,0,12th Pass,215500,0,215500
6190,6780,Tej Bahadur Singh,KHAGARIA,Proutist Sarva Samaj,0,Graduate,2864479,0,2864479
6191,1286,Tej Pal Singh,SOUTH DELHI,IND,0,10th Pass,2755320,0,2755320
6192,3144,Tej Singh,NAGINA,Ambedkar Samaj Party,0,Graduate,38907469,0,38907469
6193,3879,Tejas Ankush Ghumare,BEED,IND,1,Literate,20000,0,20000
6194,7935,Tejavath Bellaiah Naik,NALGONDA,AAP,0,Graduate Professional,8320000,500000,7820000
6195,2404,Tejpal,KOTA,IND,0,Graduate,2112136,0,2112136
6196,232,Tejpal Singh,RAMPUR,IND,0,12th Pass,477625,0,477625
6197,2364,Tek Chand Sonwal,JAIPUR RURAL,Ambedkarite Party of India,0,12th Pass,3396640,0,3396640
6198,2491,Tek Nath Dhakal,SIKKIM,Sikkim Krantikari Morcha,0,Post Graduate,37669202,0,37669202
6199,7941,Tellam Venkata Rao,MAHABUBABAD,Yuvajana Sramika Rythu Congress Party,0,Post Graduate,7087000,2100000,4987000
6200,7931,Tera Chinnapa Reddy,NALGONDA,TDP,5,Doctorate,1269815389,34399714,1235415675
6201,364,Tetari Devi,SASARAM,CPI(ML)L,0,Literate,2138858,0,2138858
6202,2841,Tetri Urf Sheela Devi,HAZARIBAGH,BSP,0,10th Pass,5412000,3000,5409000
6203,7453,"Thaddaus Fernandez,",TIRUCHIRAPPALLI,IND,0,Post Graduate,5841080,0,5841080
6204,4020,Thaddeus Lakra,RANCHI,IND,0,Graduate,5210000,0,5210000
6205,52,Thakare Rameshwar (Rameshwar) Sundarlal,BHANDARA-GONDIYA,SP,0,10th Pass,3700102,74000,3626102
6206,4576,Thakor Babaji Ravaji,BANASKANTHA,IND,0,Graduate,12668381,0,12668381
6207,7632,Thakor Babuji Dhanaji,MAHESANA,IND,1,5th Pass,445500,0,445500
6208,7631,Thakor Baldevji Maganji,MAHESANA,IND,0,5th Pass,8124000,0,8124000
6209,7298,Thakor Bhupatji Ravaji,BANASKANTHA,IND,0,10th Pass,927000,0,927000
6210,4594,Thakor Chandrasinh Javansinh,GANDHINAGAR,IND,0,8th Pass,3726000,0,3726000
6211,5355,Thakor Kevalji Nathaji,MAHESANA,BSP,1,Literate,5068662,557000,4511662
6212,7630,Thakor Mansangji Punjaji,MAHESANA,Bahujan Mukti Party,4,5th Pass,3063558,900000,2163558
6213,4595,Thakor Ravaji Juhaji,GANDHINAGAR,Vishva Hindustani Sangathan,0,Literate,3416000,0,3416000
6214,5352,Thakor Samaratji Balvantsinh,MAHESANA,IND,0,12th Pass,1347000,0,1347000
6215,6598,Thakriya Ratilal Vajirbhai,VALSAD,BSP,0,5th Pass,1395000,239575,1155425
6216,6458,Thallapalli Srinivas,PEDDAPALLE,IND,1,Post Graduate,420000,0,420000
6217,6998,Thamaraiselvan.R,DHARMAPURI,DMK,0,Not Given,16722502,0,16722502
6218,3947,Thambidurai.M,KARUR,AIADMK,2,Doctorate,132457262,51481886,80975376
6219,7053,"Thamilalagan, A.",KARUR,IND,0,Post Graduate,290000,0,290000
6220,7471,Thamilarima S,SIVAGANGA,AAP,0,Graduate,41412999,0,41412999
6221,7504,"Thangadurai, V.",THENI,BSP,1,10th Pass,1030000,0,1030000
6222,6333,Thangapandian.R,DINDIGUL,IND,3,12th Pass,700000,0,700000
6223,6923,Thangaraj,CHENNAI SOUTH,IND,0,Graduate,25500,0,25500
6224,7001,Thangaraj V,ERODE,IND,0,5th Pass,500,0,500
6225,7096,Thangasamy. V,NAGAPATTINAM,BSP,0,8th Pass,10500,0,10500
6226,534,Thangso Baite,OUTER MANIPUR,INC,0,Post Graduate,5947000,880000,5067000
6227,7542,Thanuskodi,VIRUDHUNAGAR,IND,0,Others,2772100,562000,2210100
6228,7173,Thennarasu .P,RAMANATHAPURAM,IND,0,Others,460000,0,460000
6229,1887,Thennilapuram Radhakrishnan,PALAKKAD,Welfare Party Of India,0,10th Pass,2994408,270000,2724408
6230,7585,Thevendran.T.,TIRUNELVELI,BSP,0,Graduate,673797,0,673797
6231,7172,Thiagarajan .R,RAMANATHAPURAM,IND,0,Graduate Professional,850000,0,850000
6232,5703,Thiagarajan K,SALEM,IND,0,12th Pass,856000,100000,756000
6233,3807,Thimmappa Uppar,KOPPAL,Bharatiya Dr. B.R.Ambedkar Janta Party,0,10th Pass,1000423,0,1000423
6234,3813,Thimme Gowda,MYSORE,Sarva Janata Party,0,Literate,1272000,0,1272000
6235,6308,Thirumaavalavan,CHIDAMBARAM,Viduthalai Chiruthaigal Katchi,3,Post Graduate,9195241,1627119,7568122
6236,6317,Thirunavukkarasu,CUDDALORE,IND,0,Post Graduate,15000,0,15000
6237,7084,Thirunavukkarasu. R,MAYILADUTHURAI,IND,0,Post Graduate,43925000,0,43925000
6238,7156,Thirunnavukkarasar .Su,RAMANATHAPURAM,INC,1,Post Graduate,34748520,469666,34278854
6239,7412,"Thirupathy, T.",VELLORE,IND,0,Post Graduate,6934775,0,6934775
6240,6957,"Thirusangu, A",CHIDAMBARAM,IND,0,5th Pass,412000,0,412000
6241,2510,Thomas Joseph,THIRUVANANTHAPURAM,RPI(A),0,10th Pass,7850000,872906,6977094
6242,2518,Thopaiah C,BANGALORE RURAL,BSP,0,5th Pass,1315000,200000,1115000
6243,3504,Thorat Anandrao Tukaram,HATKANANGLE,IND,0,Graduate,1740000,0,1740000
6244,3854,Thorat Dhanraj Vitthal,BEED,Maharashtra Parivartan Sena (T),0,10th Pass,700000,0,700000
6245,7188,Thorat Sunil Uttamrao,MUMBAI NORTH,AIFB,0,Graduate,1618000,0,1618000
6246,7119,"Thozhar Tamilselvan, P.",PERAMBALUR,United Communist Party of India,0,Literate,2015076,136382,1878694
6247,3748,Thulasappa Dasar,BANGALORE SOUTH,IND,0,Post Graduate,1280000,0,1280000
6248,1954,Thulaseedharan Pallickal,ALAPPUZHA,SDPI,2,12th Pass,118200,0,118200
6249,7279,Thummar Virjibhai Keshavbhai,AMRELI,INC,5,Graduate,48834257,5250474,43583783
6250,6403,Thuppari Narasimha Swamy,WARANGAL,Pyramid Party of India,0,10th Pass,457300,0,457300
6251,478,Tilakdhari Prasad Singh,KODARMA,INC,0,Graduate,4666034,0,4666034
6252,6768,Tiliya Devi,JHANJHARPUR,AAP,1,Literate,301462,25000,276462
6253,7085,Timothy.T,MAYILADUTHURAI,IND,0,5th Pass,542922,0,542922
6254,6054,Tirthankar Ray,SREERAMPUR,CPI(M),0,Graduate,248091,0,248091
6255,2294,Titar Singh,GANGANAGAR,IND,0,Literate,41500,0,41500
6256,2317,Toruram Meghwal,CHURU,Bahujan Mukti Party,1,Literate,881700,70000,811700
6257,7610,Tribhuvan Madhukar Padmakar,AURANGABAD,IND,0,12th Pass,2193000,0,2193000
6258,270,Trichur Nazeer,KOZHIKODE,IND,0,10th Pass,362347,0,362347
6259,5661,Triloki Ghurahu Yadav,THANE,IND,0,8th Pass,890224,0,890224
6260,4910,Tukadia G.R.,PORBANDAR,IND,0,Graduate Professional,5030500,0,5030500
6261,7224,Tukaram Baburao Mane,MUMBAI NORTH EAST,Bahujan Mukti Party,0,Others,27041300,60000,26981300
6262,3617,Tukaram Dasu Gangawane,OSMANABAD,IND,0,10th Pass,2580700,90000,2490700
6263,7912,Tula Ram,JHANSI,IND,0,10th Pass,231000,0,231000
6264,4513,Tuleshwar Singh,SURGUJA,AITC,0,Graduate,26048526,2483971,23564555
6265,7917,Tulla Veerender,CHEVELLA,TDP,0,Post Graduate,623975606,132516000,491459606
6266,1434,Tumane Gopal Ajabrao,RAMTEK,IND,0,12th Pass,17500,0,17500
6267,7233,Tupsoundarya Sunita Mohan,MUMBAI NORTH EAST,IND,0,12th Pass,1530000,0,1530000
6268,3618,Tupsundare Balaji Bapurao,OSMANABAD,IND,0,8th Pass,198000,0,198000
6269,6741,Turab Ali,SITAPUR,IND,0,Literate,433000,0,433000
6270,7305,Tusharbhai Amarsinhbhai Chaudhari,BARDOLI,INC,0,Doctorate,62430584,406995,62023589
6271,760,U K Choudhary (Munna Bhaiya),BALAGHAT,AAP,0,Post Graduate,54742608,1000000,53742608
6272,1417,Ubale Shrikrushna Champatrao,WARDHA,Ambedkarwadi Republican Party,1,Graduate Professional,919000,110000,809000
6273,2701,Uchit Kumar,MUNGER,IND,1,12th Pass,176574,0,176574
6274,3471,Udaram,PALI,IND,0,8th Pass,6512500,0,6512500
6275,3554,Udare Minakshi Mahadev,LATUR,IND,0,Graduate,525000,20000,505000
6276,1070,Udasi Shivakumar Channabasappa,HAVERI,BJP,0,Graduate Professional,576693538,54423645,522269893
6277,1761,Uday Alies Udayveer,BIJNOR,Bharatiya Momin Front,1,Not Given,1610000,0,1610000
6278,1299,Uday Kumar Singh,WEST DELHI,Bahujan Mukti Party,0,12th Pass,5144079,900000,4244079
6279,62,Uday Narain Choudhary,JAMUI,JD(U),0,Graduate,9827813,0,9827813
6280,134,Uday Pratap Singh,HOSHANGABAD,BJP,1,Graduate,133375092,3775714,129599378
6281,1602,Uday Pratap Singh,HOSHANGABAD,IND,0,Graduate,40000,0,40000
6282,4493,Uday Singh Urf Pappu Singh,PURNIA,BJP,4,12th Pass,1466364725,123100000,1343264725
6283,7022,Udayakumar S.P.,KANNIYAKUMARI,AAP,382,Doctorate,52080000,297000,51783000
6284,1701,Udayveer,GAUTAM BUDHHA NAGAR,Rashtriya Janta Party,0,Illiterate,7271300,124123,7147177
6285,4087,Uddhab Barman,BARPETA,CPI(M),0,Graduate Professional,318400,0,318400
6286,3679,Uddhavrao Balwant Gaikwad,SHIRDI,IND,0,5th Pass,200900,0,200900
6287,3335,Udhav Rangrao Pawar (Patil),PARBHANI,IND,0,Graduate,2411162,675000,1736162
6288,6322,Udhaya Kumar .M,DINDIGUL,AIADMK,0,Post Graduate,27810000,2800000,25010000
6289,69,Udit Raj,NORTH WEST DELHI,BJP,1,Doctorate,44902363,0,44902363
6290,5055,Udyan Sharma,MATHURA,Peace Party,2,Graduate,125350000,1618244,123731756
6291,5858,Ugle Ram Haribhau,JALNA,Rashtriya Sant Sandesh Party,0,10th Pass,17863200,0,17863200
6292,4961,Ujiyare Lal Dohare,ETAWAH,AAP,0,Post Graduate,92802808,2000000,90802808
6293,7009,Ulaganathan .A,KANCHEEPURAM,IND,0,12th Pass,418000,0,418000
6294,1505,Ulhas Vasramji Jadhao,YAVATMAL-WASHIM,IND,0,Graduate Professional,5394200,850000,4544200
6295,5547,Uma Bharti,JHANSI,BJP,13,5th Pass,14376218,0,14376218
6296,7153,Uma Mageswari R.T.,RAMANATHAPURAM,CPI,0,12th Pass,688550,1165000,0
6297,4719,Uma Nath Kole,DUMKA,IND,0,10th Pass,350527,0,350527
6298,190,Umadevi. M,BANGALORE SOUTH,SUCI(C),1,Post Graduate,469430,0,469430
6299,154,Umakant Rahi,NAWADA,Shoshit Samaj Dal,0,Post Graduate,2610034,0,2610034
6300,3968,Umakant Yadav,BANKA,Bahujan Mukti Party,0,Graduate Professional,3015000,0,3015000
6301,4182,Umang Singhar,DHAR,INC,0,Graduate,27003369,710226,26293143
6302,5694,Umarani S W/O Sivakumar,SALEM,IND,0,8th Pass,730000,0,730000
6303,3937,Umarani. S W/O Selvaraj,SALEM,DMK,0,Post Graduate,13571624,963005,12608619
6304,2079,Umed Singh,GURGAON,RASHTRIYA MORCHA PARTY,0,Others,30500,0,30500
6305,2009,Umed Singh,HISAR,IND,0,5th Pass,25250500,300000,24950500
6306,3205,Umed Singh,SHAHJAHANPUR,BSP,0,12th Pass,101502333,1404515,100097818
6307,7907,Umedbhai L. Patel,DADRA & NAGAR HAVELI,Bahujan Mukti Party,0,10th Pass,130000,0,130000
6308,1760,Umesh Alies Pani,BIJNOR,IND,0,8th Pass,545918,0,545918
6309,3686,Umesh Arjun Kanchan,SHIRUR,IND,0,8th Pass,91000,0,91000
6310,3625,Umesh Bhujang Masankhamb,PUNE,IND,0,12th Pass,2850400,1250000,1600400
6311,6774,Umesh Chandra Bharati,KHAGARIA,IND,0,Literate,565000,0,565000
6312,2821,Umesh Chandra Mehta,GIRIDIH,AJSUP,1,Doctorate,9368674,764290,8604384
6313,233,Umesh Gautam,BAREILLY,BSP,1,Doctorate,103318000,39530000,63788000
6314,2772,Umesh Kumar,PATNA SAHIB,SP,0,Graduate,1415000,0,1415000
6315,4629,Umesh Kumar Verma,RAIPUR,IND,0,Post Graduate,464935,0,464935
6316,3675,Umesh Mukund Waghmare,SATARA,IND,0,8th Pass,30000,0,30000
6317,7216,Umesh Sonba Avhad,MUMBAI NORTH CENTRAL,Maharashtra Parivartan Sena (T),0,10th Pass,50000,0,50000
6318,6520,Unadakat Prakash Valabhadas,PORBANDAR,IND,0,10th Pass,134100,0,134100
6319,5854,Unge Rambhau Kundlik,JALNA,IND,0,Post Graduate,9428900,105990,9322910
6320,2258,Upendra Chandra Das,SILCHAR,IND,0,8th Pass,695001,0,695001
6321,2848,Upendra Karmakar,JAMSHEDPUR,IND,0,5th Pass,330000,0,330000
6322,554,Upendra Kushwaha,KARAKAT,Rashtriya Lok Samta Party,4,Post Graduate,24829741,823834,24005907
6323,376,Upendra Nath,AURANGABAD,Bahujan Mukti Party,1,Post Graduate,9228000,0,9228000
6324,626,Upendra Ravidas,JAMUI,JMM,0,10th Pass,421280000,0,421280000
6325,4914,Upendra Singh,AGRA,INC,1,Post Graduate,18179036,330224,17848812
6326,4386,Upendra Singh,FIROZABAD,Bharatiya Kisan Parivartan Party,0,Graduate Professional,1396180,0,1396180
6327,7210,Upesh M. Baria,MUMBAI NORTH CENTRAL,IND,0,Post Graduate,29335000,0,29335000
6328,6221,Uppuleti Laxman,KARIMNAGAR,IND,0,5th Pass,30000,0,30000
6329,4095,Urkhao Gwra Brahma,KOKRAJHAR,IND,0,12th Pass,7766195,0,7766195
6330,2327,Urmila,JHUNJHUNU,Megh Desham Party,0,Graduate,353000,0,353000
6331,5524,Usha Maurya,FATEHPUR,INC,0,12th Pass,12445310,956000,11489310
6332,2082,Usha Rani Verma,GURGAON,IND,0,Post Graduate,5821000,917021,4903979
6333,375,Usha Sharan,AURANGABAD,Shoshit Samaj Dal,1,Literate,3900000,1000,3899000
6334,4401,Usha Verma,HARDOI,SP,0,Post Graduate,33409414,1100000,32309414
6335,7277,Usmanbhai Pirbhai Maghara,AMRELI,IND,0,Literate,1318800,0,1318800
6336,3519,Uttam Rathod,HINGOLI,IND,0,12th Pass,2500000,1180000,1320000
6337,3513,Uttamrao Pandurang Rathod,HINGOLI,Bahujan Mukti Party,0,Graduate Professional,8148200,458000,7690200
6338,569,V Govind,KOPPAL,IND,0,5th Pass,162000,0,162000
6339,1865,V M Raghavan,KOZHIKODE,IND,0,10th Pass,13000,0,13000
6340,1101,V Muniswamy,KOLAR,SP,0,Illiterate,403964,0,403964
6341,4056,V Rakkamuthu,SIVAGANGA,BSP,0,Illiterate,10000,0,10000
6342,349,V S Jayakumar,THIRUVANANTHAPURAM,IND,0,Graduate,2040500,1675000,365500
6343,1886,V S Shanavas,PALAKKAD,IND,4,10th Pass,1401101,333500,1067601
6344,471,V V Khalid,ANDAMAN & NICOBAR ISLANDS,IND,0,8th Pass,235000,0,235000
6345,7500,V Velusamy,MADURAI,DMK,9,Graduate Professional,38731336,3600000,35131336
6346,1195,V. Bala Krishnan,BANGALORE CENTRAL,AAP,0,Graduate Professional,1894253519,320000,1893933519
6347,6921,V. Balaji,CHENNAI SOUTH,BSP,0,12th Pass,443000,0,443000
6348,6860,V. Chandramohan,CHENNAI CENTRAL,IND,0,12th Pass,52000,0,52000
6349,604,V. Dhananjaya Kumar,UDUPI CHIKMAGALUR,JD(S),0,Graduate Professional,99477175,0,99477175
6350,7943,V. Gouri Nagamani,MAHABUBABAD,IND,0,10th Pass,4958000,2000000,2958000
6351,5580,V. Narayanasamy,PONDICHERRY,INC,0,Post Graduate,91869740,4206223,87663517
6352,4062,V. Rangarajan,PONDICHERRY,AAP,0,Graduate Professional,57938000,3400000,54538000
6353,5590,V. Vijaya,PONDICHERRY,IND,0,12th Pass,306000,230000,76000
6354,4327,V.Andichamy,MADURAI,IND,0,Graduate Professional,441200,0,441200
6355,6290,V.Anna Venkatesh,ARANI,Anaithindia Dravidar Samudaya Munnetra Kazhag,0,Graduate,835000,0,835000
6356,7867,V.Dinesh Reddy,MALKAJGIRI,Yuvajana Sramika Rythu Congress Party,0,Graduate,100729500,0,100729500
6357,6283,V.Elumalai,ARANI,AIADMK,0,Graduate Professional,70492462,25000,70467462
6358,7488,V.G.Ramdoss,MADURAI,IND,0,Graduate Professional,77071122,6290631,70780491
6359,955,V.K. Sajeeva,VADAKARA,BJP,2,Graduate Professional,2534579,1125903,1408676
6360,7494,V.Karuppaiah,MADURAI,IND,0,5th Pass,67000,0,67000
6361,181,V.Manjunath Bhandary,SHIMOGA,INC,0,Doctorate,194691247,89667657,105023590
6362,6304,V.Moorthy,ARANI,IND,0,5th Pass,380500,0,380500
6363,4285,V.P.Eswaran,KALLAKURICHI,DMDK,0,Post Graduate,98021861,5000000,93021861
6364,4348,V.Ravichandran,KARUR,Ulzaipali Makkal Katchy,0,12th Pass,280000,0,280000
6365,4300,V.Sathyabama,TIRUPPUR,AIADMK,2,Post Graduate,28108573,2475755,25632818
6366,1106,V.Srinivasa,KOLAR,IND,0,12th Pass,112000,0,112000
6367,1879,V.T.Ikramul Haque,PONNANI,SDPI,0,10th Pass,15185342,0,15185342
6368,7647,Vadaliya Kalubhai Malubhai,SURENDRANAGAR,IND,0,8th Pass,330500,0,330500
6369,7260,Vadhel Vijaykumar Manjibhai,AHMEDABAD EAST,Hindusthan Nirman Dal,0,10th Pass,212240,0,212240
6370,7099,Vadivel Ravanan,NAGAPATTINAM,Pattali Makkal Katchi,0,Illiterate,1283271,0,1283271
6371,6277,"Vadivel, A.",ARAKKONAM,IND,0,10th Pass,157800,0,157800
6372,4038,Vadivel.R,NAMAKKAL,Ulzaipali Makkal Katchy,0,12th Pass,136000,0,136000
6373,7131,"Vadivelu, P.",PERAMBALUR,IND,1,12th Pass,750000,0,750000
6374,4898,Vaghda Jivabhai Devabhai,PATAN,IND,0,5th Pass,6550000,1500000,5050000
6375,6616,Vaghela Bharatbhai Parsotambhai,ANAND,IND,0,12th Pass,6500,0,6500
6376,7340,Vaghela Kishorsinh Mohabbatsinh,GANDHINAGAR,IND,0,8th Pass,635850,125000,510850
6377,6500,Vaghela Liladharbhai Khodaji,PATAN,BJP,0,Graduate Professional,15384027,0,15384027
6378,7319,Vaghela Narendrabhai Savjibhai,BHAVNAGAR,IND,0,8th Pass,59000,0,59000
6379,7646,Vaghela Prakashbhai Bachubhai,SURENDRANAGAR,IND,0,5th Pass,27000,0,27000
6380,6551,Vaghela Shankersinh,SABARKANTHA,INC,0,Post Graduate,213576053,0,213576053
6381,3069,Vagish Pathak,BADAUN,BJP,0,Post Graduate,138995758,42644117,96351641
6382,7283,Vahora Firojbhai Walimahamad,ANAND,IND,0,8th Pass,14209,0,14209
6383,3589,Vaidy Hansraj Dadarao,NANDED,BSP,0,Graduate Professional,24105918,1000000,23105918
6384,7528,Vaiko,VIRUDHUNAGAR,MDMK,6,Post Graduate,36116391,137545,35978846
6385,5799,Vaishali Ali,SITAPUR,INC,0,Graduate Professional,43445878,0,43445878
6386,3370,"Vaishali Surendra Borde	",MAVAL,IND,0,Graduate Professional,78806,0,78806
6387,5953,Vaishali Surendra Borde,MUMBAI SOUTH CENTRAL,IND,0,Graduate Professional,78806,0,78806
6388,5451,Vaithiyanathan S,TIRUVANNAMALAI,IND,0,12th Pass,1120000,0,1120000
6389,6521,Vakil Vinzuda Ranjitbhai,PORBANDAR,IND,0,Graduate Professional,5284000,0,5284000
6390,7046,"Valaiyapathi, R.",KARUR,AAP,0,Graduate,12942916,0,12942916
6391,4051,Vallal Peruman,CHIDAMBARAM,INC,0,Graduate Professional,25721400,4625000,21096400
6392,7276,Valodara Vrajlal Jivabhai,AMRELI,IND,0,Literate,31000,0,31000
6393,5429,Vanaroja R,TIRUVANNAMALAI,AIADMK,0,Post Graduate,3700000,0,3700000
6394,5328,Vaniya Ajmalbhai Ramabhai,GANDHINAGAR,Bahujan Mukti Party,0,Graduate,10226914,0,10226914
6395,5339,Vaniya Gangajibhai,JAMNAGAR,IND,0,10th Pass,1780000,50000,1730000
6396,5365,Vankar Manilal Bhanabhai,PANCHMAHAL,IND,0,8th Pass,560000,50000,510000
6397,1852,Vappan,WAYANAD,BSP,0,Graduate Professional,3725000,888817,2836183
6398,3936,Varadan. M,KALLAKURICHI,IND,0,Post Graduate,1531000,975000,556000
6399,6080,Varikuppala Krishna,BHONGIR,IND,1,8th Pass,11976000,2400000,9576000
6400,7655,Varinder Singh,GURDASPUR,CPI,0,Graduate Professional,101000,0,101000
6401,5140,Varis Ali,TONK-SAWAI MADHOPUR,awami aamjan party,0,8th Pass,2796100,0,2796100
6402,1457,Varsha Govind Tidke,BHANDARA-GONDIYA,IND,0,10th Pass,294378,0,294378
6403,3720,Vasanagouda Bhandi,BAGALKOT,IND,0,12th Pass,875000,0,875000
6404,7018,Vasantha Kumar H.,KANNIYAKUMARI,INC,5,Post Graduate,2857786803,876085097,1981701706
6405,7036,Vasantha Kumar L.,KANNIYAKUMARI,IND,0,10th Pass,3423600,220000,3203600
6406,7037,Vasantheesvaran E.,KANNIYAKUMARI,IND,0,8th Pass,400000,0,400000
6407,7567,Vasanthi.M,TENKASI,AIADMK,0,Post Graduate,24014922,0,24014922
6408,1389,Vasantrao Sukhdev Dandage,BULDHANA,SP,0,Graduate,233640000,0,233640000
6409,5320,Vasava Kishorbhai Chhotubhai,SURAT,JD(U),17,10th Pass,44083000,10500000,33583000
6410,7328,Vasava Prafulbhai Devjibhai,CHHOTA UDAIPUR,JD(U),0,Doctorate,160000,0,160000
6411,7250,Vasave Amit Sheklal,NANDURBAR,BSP,0,12th Pass,51000,0,51000
6412,7378,"Vasigaran, S.A.N. Thiru",SRIPERUMBUDUR,AAP,0,12th Pass,259529,0,259529
6413,6868,Vasuki .U,CHENNAI NORTH,CPI(M),0,Graduate,20187812,3212000,16975812
6414,7884,Vattikuti Ramarao Goud,MALKAJGIRI,IND,5,Doctorate,630000,0,630000
6415,869,Ved Pal,BHIWANI-MAHENDRAGARH,BSP,6,8th Pass,70084365,4037541,66046824
6416,1347,Ved Prakash,NEW DELHI,IND,0,10th Pass,10478697,0,10478697
6417,2071,Vedparkash Bhartiya,BHIWANI-MAHENDRAGARH,IND,0,10th Pass,3378000,160000,3218000
6418,558,Veena Bharti,KARAKAT,JPS,0,8th Pass,729000,0,729000
6419,2695,Veena Devi,MUNGER,LJP,0,8th Pass,31162836,0,31162836
6420,3882,Veer Shesherao Chokhoba,BEED,IND,0,Graduate,0,0,0
6421,1074,Veerabhadrappa Kabbinad,HAVERI,IND,0,5th Pass,2500,0,2500
6422,7448,Veeramalai.A,TIRUCHIRAPPALLI,IND,0,12th Pass,3356000,0,3356000
6423,1899,Veerendrakumar,PALAKKAD,IND,0,5th Pass,835000,66000,769000
6424,7327,Vegad Nathabhai (Vegadbhai Pragnachakshu Umedvar),BHAVNAGAR,IND,0,12th Pass,80000,0,80000
6425,7608,Veilumuthukumar.P,TIRUNELVELI,IND,0,10th Pass,30000,0,30000
6426,4299,Vel.S.K,NAMAKKAL,DMDK,0,Graduate Professional,93414188,20086406,73327782
6427,6548,Velani Shantilal Karamshih,SABARKANTHA,IND,0,5th Pass,5469370,0,5469370
6428,2453,Velaram,UDAIPUR,AAP,1,Doctorate,10272231,0,10272231
6429,1860,Velayudhan K. P.,KOZHIKODE,BSP,0,10th Pass,3539300,500000,3039300
6430,7133,"Velayutham, C.",PERAMBALUR,IND,0,5th Pass,81000,0,81000
6431,7182,Velchsamy .R,RAMANATHAPURAM,IND,0,8th Pass,2750000,0,2750000
6432,7473,Velladhurai A,SIVAGANGA,Ezhuchi Tamilargal Munnetra Kazhagam,0,8th Pass,2397000,0,2397000
6433,7581,Velladurai.P.,TENKASI,IND,0,Others,788500,80000,708500
6434,5438,Velmurugan A,TIRUVANNAMALAI,IND,0,Others,50000,0,50000
6435,6454,Velthuru Mallaiah,PEDDAPALLE,Republican Paksha (Khoripa),0,10th Pass,2155000,0,2155000
6436,2634,Velu V,BANGALORE NORTH,BSP,1,8th Pass,2100000,0,2100000
6437,6280,"Velu, D.",ARAKKONAM,IND,0,8th Pass,1000000,0,1000000
6438,6279,"Velu, R.",ARAKKONAM,IND,0,10th Pass,251116,0,251116
6439,6261,"Velu, R.",ARAKKONAM,Pattali Makkal Katchi,1,Doctorate,22414897,0,22414897
6440,6281,"Velu, V.",ARAKKONAM,IND,0,12th Pass,797612,0,797612
6441,5682,Velusamy.S,NAMAKKAL,Tamil Nadu Makkal Congress,1,10th Pass,6495000,1930000,4565000
6442,6409,Venkanna Kannam,WARANGAL,Marxist Communist Party of India (United),0,12th Pass,801000,100000,701000
6443,6406,Venkanna Neerudu,WARANGAL,Bahujan Mukti Party,0,Post Graduate,4005000,13700000,0
6444,4539,Venkat Reddy Surakanti,MALKAJGIRI,Pyramid Party of India,0,Graduate Professional,2155818,0,2155818
6445,3833,Venkatesan G,DINDIGUL,IND,0,10th Pass,698182,0,698182
6446,7416,Venkatesan S,VILUPPURAM,IND,0,Graduate,210391,0,210391
6447,7415,"Venkatesan, R.",VELLORE,IND,0,10th Pass,330500,0,330500
6448,6869,Venkatesh Babu .T.G,CHENNAI NORTH,AIADMK,0,Post Graduate,37038275,804032,36234243
6449,3773,Venkatesh D T,CHIKKBALLAPUR,IND,0,Post Graduate,2500000,150000,2350000
6450,7607,Venkatesh.A,TIRUNELVELI,IND,0,Post Graduate,933000,280000,653000
6451,7417,Vennila. K,KALLAKURICHI,IND,0,10th Pass,2390900,200000,2190900
6452,4554,Venu Esampelly,WARANGAL,AIFB,0,10th Pass,12500,0,12500
6453,7890,Venu Gopal.P,HYDERABAD,BSP,0,Post Graduate,50000,0,50000
6454,7370,Venugopal P.,TIRUVALLUR,IND,0,10th Pass,262854,0,262854
6455,3323,Venugopal Shastri Tumuluri,NANDED,IND,0,Graduate Professional,5810377,180068,5630309
6456,7360,Venugopal. P. Dr.,TIRUVALLUR,AIADMK,0,Graduate Professional,28643502,1768538,26874964
6457,1987,Venus Habib,SOUTH GOA,IND,0,Graduate,4733543,0,4733543
6458,7369,Vetriselvam. K,TIRUVALLUR,IND,0,10th Pass,62000,0,62000
6459,7181,Vetrivel .S,RAMANATHAPURAM,IND,0,Graduate,30000,0,30000
6460,4462,Viajy Bharti,BANKA,Rajnaitik Vikalp Party,0,10th Pass,353558,0,353558
6461,5662,Vichare Rajan Baburao,THANE,SHS,13,10th Pass,102091612,13054217,89037395
6462,7059,"Vigneshwaran, M.",KARUR,IND,0,Graduate Professional,260000,0,260000
6463,3443,Vigyan Modi,JODHPUR,AAP,0,Others,13265789,409622,12856167
6464,5732,Vijay Bahadur Singh,LUCKNOW,Manavtawadi Samaj Party,0,Post Graduate,4122000,0,4122000
6465,5849,Vijay Bhimrao Nikam,JALGAON,IND,0,12th Pass,30500,0,30500
6466,6669,Vijay Chaudhary,JALAUN,INC,0,Post Graduate,6455485,0,6455485
6467,7394,"Vijay Elanchezian, J.",VELLORE,INC,0,Graduate Professional,9800356,0,9800356
6468,7707,Vijay Hans,JALANDHAR,Democratic Bharatiya Samaj Party,0,10th Pass,620000,0,620000
6469,7824,Vijay Inder Singla,SANGRUR,INC,0,Graduate Professional,147378890,13863761,133515129
6470,4702,Vijay Kant Mishra,DHANBAD,IND,0,12th Pass,560000,0,560000
6471,7819,Vijay Kumar,BATHINDA,IND,2,10th Pass,660000,0,660000
6472,7731,Vijay Kumar,HOSHIARPUR,SARVAJAN SAMAJ PARTY (D),0,Illiterate,861000,0,861000
6473,6243,Vijay Kumar,MADHUBANI,IND,0,12th Pass,51300,0,51300
6474,7721,Vijay Kumar,JALANDHAR,IND,0,5th Pass,32820,0,32820
6475,1316,Vijay Kumar,NORTH WEST DELHI,RPI(A),0,Graduate,5880000,0,5880000
6476,120,Vijay Kumar,JAMMU,IND,0,8th Pass,520000,50000,470000
6477,1246,Vijay Kumar Chourasiya,KODARMA,AAP,1,Graduate,3704548,620968,3083580
6478,4170,Vijay Kumar Hansdak,RAJMAHAL,JMM,1,5th Pass,6863306,0,6863306
6479,6042,Vijay Kumar Mahato,HOOGHLY,BSP,1,8th Pass,208700,0,208700
6480,4455,Vijay Kumar Mandal,ARARIA,JD(U),1,10th Pass,4326107,0,4326107
6481,3905,Vijay Kumar Patel,MAHASAMUND,IND,0,Post Graduate,3249000,0,3249000
6482,6250,Vijay Kumar Ram,SAMASTIPUR,Rajnaitik Vikalp Party,0,12th Pass,17000,0,17000
6483,2767,Vijay Kumar Sahni,PATNA SAHIB,IND,0,Graduate,7528500,0,7528500
6484,2913,Vijay Kumar Sen,BHOPAL,CPI(ML) Red Star,1,Graduate,34000,0,34000
6485,2026,Vijay Kumar Sharma,HISAR,IND,0,Post Graduate,2730250,0,2730250
6486,4262,Vijay Kumar Sharma,AKBARPUR,IND,0,Graduate,7799428,1650000,6149428
6487,6197,Vijay Kumar Singh,MADHEPURA,BJP,4,Graduate,16210739,1598602,14612137
6488,1667,Vijay Kumar Singh,GHAZIABAD,BJP,2,Doctorate,41137044,2026774,39110270
6489,6650,Vijay Kumar Tiwari,DHAURAHRA,IND,0,Post Graduate,844228,19681,824547
6490,3636,Vijay Laxman Sarode,PUNE,IND,0,12th Pass,71000,0,71000
6491,1723,Vijay Pal,BULANDSHAHR,Rashtriya Janpriya Party,0,8th Pass,159000,0,159000
6492,6624,Vijay Prakash,BANDA,IND,0,8th Pass,170000,0,170000
6493,2100,Vijay Raj,FARIDABAD,IND,0,Post Graduate,2035329,0,2035329
6494,395,Vijay Ram,NAWADA,Moolniwasi Samaj Party,1,10th Pass,221500,0,221500
6495,101,Vijay Sampla,HOSHIARPUR,BJP,0,10th Pass,15164322,4020543,11143779
6496,981,Vijay Shankar Chaubey,CHANDNI CHOWK,IND,0,12th Pass,2105641,0,2105641
6497,2899,Vijay Singh Kori,BHIND,AIFB,0,10th Pass,403800,0,403800
6498,4994,Vijay Singh Kushwaha,FATEHPUR SIKRI,Sanyukt Samajwadi Dal,0,10th Pass,200000,0,200000
6499,7049,"Vijay, J.",KARUR,IND,0,Graduate Professional,454000,0,454000
6500,1192,Vijaya Kumar,UDUPI CHIKMAGALUR,CPI,0,Others,3085000,215000,2870000
6501,6876,Vijaya Kumar .K,CHENNAI NORTH,Tamil Nadu Makkal Congress,0,12th Pass,3000000,400000,2600000
6502,2439,Vijaya Ray,CHITTORGARH,Rajasthan Vikas Party,0,Graduate,318693,0,318693
6503,7000,Vijayakumar S,ERODE,IND,0,Graduate,1025551,0,1025551
6504,7449,Vijayakumar.P,TIRUCHIRAPPALLI,IND,0,12th Pass,1072802,158660,914142
6505,1908,Vijayan Ambalakkad,ALATHUR,IND,2,10th Pass,825077,0,825077
6506,7098,Vijayan. A.K.S,NAGAPATTINAM,DMK,0,Post Graduate,28140439,3925882,24214557
6507,7243,Vijayanand Shankarrao Shinde,MUMBAI NORTH WEST,Hindusthan Nirman Dal,0,Graduate Professional,3296000,0,3296000
6508,1871,Vijayaraghavan .K,KOZHIKODE,IND,0,8th Pass,2006500,0,2006500
6509,7908,Vijaybhay N. Bhoya,DADRA & NAGAR HAVELI,JD(U),0,12th Pass,58000,16240,41760
6510,7438,Vijaykumar.Amg,TIRUCHIRAPPALLI,DMDK,0,12th Pass,119179136,17355409,101823727
6511,2446,Vijaypal,BANSWARA,BSP,0,Post Graduate,740000,0,740000
6512,383,Vijeet Kumar,AURANGABAD,IND,0,Graduate,400000,0,400000
6513,3187,Vijendra Singh,RAMPUR,Rashtriya Congress (Babu Jagjivanram),0,Literate,33048000,0,33048000
6514,432,Vikas,HISAR,IND,3,Graduate,473900,0,473900
6515,2192,Vikas Basavantappa Soppin,DHARWAD,IND,0,Graduate Professional,6039592,1379613,4659979
6516,4013,Vikas Chandra Sharma,RANCHI,CPI(ML) Red Star,0,Post Graduate,126000,0,126000
6517,2955,Vikas Sharma,GWALIOR,Bharatiya Navyuvak Party,0,10th Pass,5100000,0,5100000
6518,3397,Vikas Sudam Kusekar,SHIRUR,AIFB,0,Graduate Professional,4055000,125000,3930000
6519,3619,Vikram Ashok Sawale,OSMANABAD,AAP,0,Graduate,50891116,141639,50749477
6520,112,Vikram Usendi,KANKER,BJP,0,10th Pass,23376000,869000,22507000
6521,3703,Vikram Uttam Kasabe,SOLAPUR,IND,0,Post Graduate,99228,0,99228
6522,1570,Vikrant,JABALPUR,IND,0,10th Pass,323500,0,323500
6523,2353,Vimal,SIKAR,Jai Maha Bharath Party,0,Graduate Professional,88000,0,88000
6524,3125,Vimal Kumar,MORADABAD,AAP,0,Graduate,2456083,731000,1725083
6525,7644,Vimal Patel (Endhal),NAVSARI,IND,0,12th Pass,126000,0,126000
6526,4982,Vimla Devi,FARRUKHABAD,IND,0,10th Pass,774907,0,774907
6527,887,Vimla Shoree,BASTAR,CPI,0,Graduate Professional,1520000,200000,1320000
6528,4229,Vimla Umar,BHARATPUR,AITC,0,8th Pass,6579500,730000,5849500
6529,5532,Vimlesh,HAMIRPUR,IND,0,10th Pass,2962000,0,2962000
6530,4946,Vinay,ETAH,Bhartiya Shakti Chetna Party,0,Graduate,8558000,0,8558000
6531,1372,Vinay,NORTH EAST DELHI,Bharatiya Sarvodaya Kranti Party,0,12th Pass,4274100,0,4274100
6532,2183,Vinay Kulkarni,DHARWAD,INC,2,12th Pass,111890685,6539376,105351309
6533,3004,Vinay Kumar,SAGAR,Bhartiya Shakti Chetna Party,0,12th Pass,913873,44000,869873
6534,1571,Vinay Kumar Jain,JABALPUR,IND,0,10th Pass,32198461,1637760,30560701
6535,5729,Vinay Prakash Mishra,LUCKNOW,IND,0,Graduate,7271508,0,7271508
6536,5700,Vinayagamoorthi T,SALEM,BSP,0,10th Pass,197000,0,197000
6537,3642,Vinayak Bhaurao Raut,RATNAGIRI SINDHUDURG,SHS,5,Post Graduate,44568629,2370842,42197787
6538,6686,Vinayak Rao Tope,KANPUR,Swarajya Party Of India,0,12th Pass,1270749,18000,1252749
6539,3789,Vinayaka Prasad.H.N,KOLAR,IND,0,12th Pass,110000,0,110000
6540,1926,Vincent,CHALAKUDY,IND,0,10th Pass,4618200,1200000,3418200
6541,538,Vincent H. Pala,SHILLONG,INC,0,Graduate Professional,497108058,0,497108058
6542,4955,Vineet Kumar,ETAWAH,Ambedkar Samaj Party,0,Post Graduate,1328000,0,1328000
6543,929,Vinod Ankush Nannaware,GADCHIROLI-CHIMUR,SP,0,10th Pass,1969000,520000,1449000
6544,5663,Vinod Deepchand Gangwal,THANE,IND,1,Graduate Professional,27667168,1922750,25744418
6545,1492,Vinod Dinanath Meshram,CHANDRAPUR,IND,0,Not Given,0,0,0
6546,3645,Vinod Hanumantrao Sawant,RATNAGIRI SINDHUDURG,Akhil Bharat Hindu Mahasabha,0,10th Pass,28610000,0,28610000
6547,7656,Vinod Khanna,GURDASPUR,BJP,0,Graduate,669343376,12695306,656648070
6548,1526,Vinod Kumar,SATNA,Bhartiya Shramik Dal Socialist,0,10th Pass,260000,0,260000
6549,2309,Vinod Kumar Baghel,ALIGARH,Rashtriya Samaj Paksha,0,12th Pass,30000,0,30000
6550,4781,Vinod Kumar Bhagwan Birade,KHANDWA,RPI(A),0,Graduate,25000,0,25000
6551,6220,Vinod Kumar Boinapally,KARIMNAGAR,TRS,0,Graduate Professional,97275990,0,97275990
6552,4913,Vinod Kumar Singh,AGRA,IND,0,Post Graduate,126000,0,126000
6553,3141,Vinod Kumar Tejyan,NAGINA,Bahujan Mukti Party,2,Post Graduate,21180272,3200000,17980272
6554,1693,Vinod Kumar Tyagi,GHAZIABAD,IND,1,Post Graduate,41416138,0,41416138
6555,1263,Vinod Ram,PALAMAU,IND,0,12th Pass,1526001,0,1526001
6556,6530,Vinodbhai Pragjibhai Nagani,RAJKOT,IND,1,Graduate,3657966,555000,3102966
6557,7074,Vinothkumar.P,KRISHNAGIRI,IND,0,12th Pass,478000,0,478000
6558,7557,Vinston Anto. S,THOOTHUKKUDI,IND,0,10th Pass,668734,0,668734
6559,3104,Vipnesh,KHERI,CPI,0,Graduate Professional,207911,0,207911
6560,5244,Viren Das,BHAGALPUR,Sankhyanupati Bhagidari Party,0,Literate,3010500,0,3010500
6561,1302,Virender Mohan Vats,WEST DELHI,IND,0,Graduate,910714,300000,610714
6562,4134,Virendra Kumar Dahariya,RAIPUR,BSP,0,10th Pass,4612000,100000,4512000
6563,1572,Virendra Kumar Sharma,JABALPUR,IND,0,Graduate,380000,0,380000
6564,1361,Virendra Mayer,EAST DELHI,Samajwadi Janata Party (Rashtriya),0,Graduate,231000,0,231000
6565,3074,Virendra Pal Gupta,BADAUN,Rashtravadi Janata Party,0,8th Pass,785000,350000,435000
6566,7253,Virendra Ravaji Valvi,NANDURBAR,AAP,0,Graduate,470995,0,470995
6567,1618,Virendra Singh,MUZAFFARNAGAR,SP,2,Post Graduate,293622871,466848,293156023
6568,4221,Virendra Vidrohi,ALWAR,AAP,0,Doctorate,1178758,376527,802231
6569,7073,Virginiya Benatin Franciles,KRISHNAGIRI,IND,0,8th Pass,2545000,900000,1645000
6570,4220,Virja Nand,ALWAR,SP,0,Graduate,5255484,0,5255484
6571,1473,Vishal Arvind Bhoyar,BHANDARA-GONDIYA,IND,0,Post Graduate,124600,0,124600
6572,5665,Vishal Dinkar Salve,THANE,IND,0,Post Graduate,5272000,200000,5072000
6573,1322,Vishal Khosla,NEW DELHI,IND,0,12th Pass,489000,0,489000
6574,477,Visheshwar Prasad,KODARMA,BSP,0,8th Pass,4850000,1800000,3050000
6575,416,Vishnu Bhagwan,KURUKSHETRA,IND,1,Graduate Professional,1946070,379840,1566230
6576,488,Vishnu Dayal Ram,PALAMAU,BJP,0,Graduate,24753886,0,24753886
6577,455,Vishnu Dutt,ROHTAK,IND,0,10th Pass,1166047,80000,1086047
6578,428,Vishnu Kumar,HISAR,IND,0,Graduate Professional,31000,0,31000
6579,103,Vishnudev Sai,RAIGARH,BJP,0,10th Pass,21576220,1819686,19756534
6580,160,Vishun Chaudhary,JAMUI,SHS,0,8th Pass,190000,0,190000
6581,1539,Vishv Nath Dwivedi,REWA,IND,0,12th Pass,156000,0,156000
6582,6631,Vishvambhar Nath,BANDA,Bahujan Mukti Party,0,Post Graduate,15336700,590000,14746700
6583,5554,Vishwadeep Singh,FIROZABAD,BSP,0,Post Graduate,48629198,438000,48191198
6584,2714,Vishwajit Kumar,NALANDA,IND,0,12th Pass,3409263,0,3409263
6585,1115,Vishwanath Gotuji Jamnekar,AMRAVATI,IND,0,Graduate Professional,620000,0,620000
6586,5718,Vishwanath Kataria,KANPUR,IND,0,Graduate,265000,0,265000
6587,4684,Vishwaratan Sinha,DURG,AAP,0,Post Graduate,13759160,994273,12764887
6588,2992,Visnu Sharma,MORENA,AITC,0,10th Pass,800000,0,800000
6589,7007,Viswanathan P,KANCHEEPURAM,INC,0,Graduate,15447693,1770204,13677489
6590,7132,"Viswanathan, A.",PERAMBALUR,IND,0,10th Pass,863000,0,863000
6591,6278,"Viswanathan, P.",ARAKKONAM,IND,0,8th Pass,347702,0,347702
6592,5865,Vitthal Sahebrao Shelke,JALNA,Ambedkarite Party of India,0,Post Graduate,0,0,0
6593,7722,Vivek,JALANDHAR,IND,0,10th Pass,135500,0,135500
6594,5535,Vivek Kumar,HAMIRPUR,Rashtriya Krantikari Samajwadi Party,0,Post Graduate,1093000,0,1093000
6595,5478,Vivek Kumar Singh,BANDA,INC,5,Graduate Professional,83649102,0,83649102
6596,6651,Vivek Mishra,DHAURAHRA,IND,0,Graduate,752800,0,752800
6597,1584,Vivek Mishra (Lalu Bhaiya),BALAGHAT,Jai Maha Bharath Party,0,Graduate,245500,0,245500
6598,1973,Vivekanandan,ATTINGAL,IND,0,8th Pass,4652,0,4652
6599,753,Vivekkrishna Tankha,JABALPUR,INC,0,Graduate Professional,423720471,2277000,421443471
6600,7511,"Voltaire, M.J.",THENI,SUCI(C),0,Post Graduate,96887,0,96887
6601,6580,Vora Bhavanbhai Devajibhai,SURENDRANAGAR,IND,0,10th Pass,152000,0,152000
6602,4312,Vrahma Saran Jatav,FARRUKHABAD,IND,1,12th Pass,1359047,0,1359047
6603,4671,Vrinda Ganda,JANJGIR-CHAMPA,IND,0,Illiterate,2218300,0,2218300
6604,1470,Wadhave Damodhar Natthu,BHANDARA-GONDIYA,IND,0,10th Pass,5790000,40000,5750000
6605,3587,Wadje Panjab Shrihari,NANDED,IND,7,Graduate,65425728,17401655,48024073
6606,3682,Wagh Gangadhar Radhaji,SHIRDI,IND,0,10th Pass,1986175,0,1986175
6607,5825,Waghere Hemant Motiram,DINDORI,CPI(M),3,Graduate,830380,464940,365440
6608,3696,Waghmare Pundalik Onkari,SOLAPUR,Bahujan Mukti Party,0,10th Pass,1016000,0,1016000
6609,3394,Waghmare Sarjerao Bhika,SHIRUR,BSP,0,12th Pass,1671548,0,1671548
6610,3585,Walke Vikram Vasudeo,MADHA,IND,1,5th Pass,911000,0,911000
6611,3913,Wamanrao Bagde,RAJNANDGAON,IND,0,10th Pass,16495585,0,16495585
6612,5601,Wamanrao Madhav Sasane,RAVER,Bahujan Mukti Party,0,12th Pass,117571244,1400000,116171244
6613,5977,Wanaga Chintaman Navasha,PALGHAR,BJP,0,Graduate Professional,5809644,401000,5408644
6614,876,Wangman Lowangcha,ARUNACHAL EAST,PPA,0,Graduate,46162501,0,46162501
6615,5859,Wankhede Sharadchandra Ganapatrao,JALNA,BSP,1,Post Graduate,28995248,950000,28045248
6616,3526,Wankhede Subhash,HINGOLI,IND,0,5th Pass,1030500,0,1030500
6617,3512,Wankhede Subhash Bapurao,HINGOLI,SHS,1,10th Pass,11343000,3541000,7802000
6618,3516,Wankhede Subhash Nagorao,HINGOLI,JD(U),1,5th Pass,1776500,100000,1676500
6619,5360,Warde Rajubhai Bhimrao,NAVSARI,Bahujan Mukti Party,0,5th Pass,1029005,0,1029005
6620,3378,Ware Subhash Shankarrao,PUNE,AAP,2,Graduate Professional,4586646,0,4586646
6621,4430,Wazed Ali Choudhury,DHUBRI,INC,0,Graduate,23983914,6220000,17763914
6622,2257,Wazid Reja Osmani,SILCHAR,AITC,0,Doctorate,7384788,0,7384788
6623,7038,Wilson I.,KANNIYAKUMARI,IND,0,12th Pass,26000,0,26000
6624,3948,Y.Larance,TIRUCHIRAPPALLI,IND,0,Graduate,3197000,250000,2947000
6625,4628,Yaasmin Beg,RAIPUR,IND,0,10th Pass,200500,0,200500
6626,3634,Yadav Gangadhar Nathu,PUNE,IND,0,Post Graduate,358000,0,358000
6627,5900,Yadav Kamlesh Shobhnath,MUMBAI NORTH,SP,4,10th Pass,13642568,0,13642568
6628,4568,Yadav Parsotamgiri,BANASKANTHA,BSP,1,8th Pass,105000,0,105000
6629,2623,Yakub Shariff,CHIKKBALLAPUR,Bahujan Mukti Party,0,Post Graduate,1173400,200000,973400
6630,1060,Yamanur Kamble,BAGALKOT,BSP,1,Post Graduate,5034259,0,5034259
6631,7729,Yamini Gomar,HOSHIARPUR,AAP,0,Graduate,1223000,0,1223000
6632,573,Yashpal Sharma,JAMMU,JKPDP,0,Graduate Professional,7743691,0,7743691
6633,2837,Yashpal Yadav,HAZARIBAGH,IND,0,5th Pass,7731500,0,7731500
6634,3541,Yashwant Balkrushna Joshi,KOLHAPUR,IND,0,10th Pass,2638600,229000,2409600
6635,5998,Yashwant Jayram Gaikwad,RAIGAD,BSP,0,10th Pass,5557874,0,5557874
6636,2428,Yashwant Puri,CHITTORGARH,IND,0,Graduate Professional,1906246,0,1906246
6637,3139,Yashwant Singh,NAGINA,BJP,0,Post Graduate,34806740,0,34806740
6638,6831,Yerra Shankar Goud,MEDAK,BSP,0,Post Graduate,1550000,0,1550000
6639,2154,Yeshwanthrao,BIDAR,Bharatiya Peoples Party,0,Post Graduate,3236000,120000,3116000
6640,6899,Yogaraj. S,CHENNAI NORTH,IND,0,Graduate Professional,13105000,30000,13075000
6641,647,Yogender Ram,KODARMA,Akhil Bharatiya Jan Sangh,0,10th Pass,4765000,500000,4265000
6642,3055,Yogendra Kumar,AONLA,Akhil Bharat Hindu Mahasabha,1,10th Pass,234800,0,234800
6643,2717,Yogendra Prasad,NALANDA,Bharatiya Inqalab Party,0,12th Pass,5874500,25000,5849500
6644,459,Yogendra Singh Yadav,GURGAON,AAP,0,Post Graduate,29709151,1387505,28321646
6645,856,Yogesh,BANGALORE SOUTH,IND,0,10th Pass,25000,0,25000
6646,6700,Yogesh Chandra Bhatt,LUCKNOW,IND,0,Graduate Professional,540000,0,540000
6647,5058,Yogesh Kumar,MATHURA,BSP,2,Graduate,15890007,1873951,14016056
6648,224,Yogesh Kumar,SAHARANPUR,AAP,4,Graduate,55998531,183016,55815515
6649,1556,Yogesh Kumar Singh Ad.,SHAHDOL,SP,0,Graduate Professional,1251141,1820,1249321
6650,5181,Yogesh Motiram Kathore,BHIWANDI,Bharipa Bahujan Mahasangh,0,8th Pass,1440000,110000,1330000
6651,762,Yogesh Nanaji Samrite,BALAGHAT,BSP,1,Post Graduate,5250000,0,5250000
6652,4872,Yousub Ali Ahmed,DHUBRI,SP,0,12th Pass,6469882,80000,6389882
6653,2021,Yudhvir,HISAR,IND,0,10th Pass,675000,0,675000
6654,4010,Yugeshwar Marar Deen,RANCHI,Manav Mukti Morcha,1,Graduate Professional,7735000,0,7735000
6655,1655,Yunush,BAGHPAT,Navbharat Nirman Party,0,Literate,4810000,0,4810000
6656,6094,Yusaf Mohammad,AMRITSAR,SP,0,10th Pass,1348885,0,1348885
6657,7359,Yuvaraj.V,TIRUVALLUR,DMDK,1,10th Pass,79725701,30105940,49619761
6658,3498,Yuvraj Shivaji Kamble,HATKANANGLE,IND,0,8th Pass,975000,0,975000
6659,679,Zafar Alam,ALIGARH,SP,0,Graduate Professional,331958000,2362000,329596000
6660,3110,Zafar Ali Naqvi,KHERI,INC,0,Graduate Professional,4699334,0,4699334
6661,5616,Zagadya Purmya Pawara,RAVER,IND,1,Literate,287800,0,287800
6662,188,Zaheeda Shereen,BANGALORE CENTRAL,SUCI(C),0,Graduate Professional,587593,0,587593
6663,5523,Zainul Abdin,FATEHPUR,AAP,0,12th Pass,11350000,0,11350000
6664,461,Zakir Hussain,GURGAON,INLD,0,Graduate Professional,81039887,789903,80249984
6665,2228,Zakir Hussain,UDUPI CHIKMAGALUR,BSP,0,5th Pass,1309472,45000,1264472
6666,7629,Zala Indrajitsinh Mahendrasinh,MAHESANA,SP,0,12th Pass,232000,0,232000
6667,4853,Zameerul Hasan,RAIGANJ,AIUDF,0,Graduate,8696996,14900000,0
6668,2544,Zanzad Shalikram Shankarrao,BHANDARA-GONDIYA,IND,0,8th Pass,1140019,0,1140019
6669,4869,Zesmina Khatun,DHUBRI,AITC,0,12th Pass,390500,0,390500
6670,4786,Ziauddin Inamdar,KHANDWA,Bahujan Mukti Party,2,10th Pass,1698000,800000,898000
6671,720,Zulfikal Ali A A,ERNAKULAM,SDPI,4,Others,557800,0,557800
